rank_number,actor,contributions,percent,cumulative_sum,cumulative_percent,all_contributions
1,tkyi,12507,0.80118,12507,0.80118,1561077
2,NotMyFault,10263,0.65743,22770,1.45861,1561077
3,lemeurherve,9505,0.60887,32275,2.06748,1561077
4,pow-devops2020,8621,0.55225,40896,2.61973,1561077
5,d2lam,8204,0.52553,49100,3.14526,1561077
6,jenkinsadmin,6401,0.41004,55501,3.55530,1561077
7,slide,5373,0.34419,60874,3.89949,1561077
8,reviewbybees,5301,0.33957,66175,4.23906,1561077
9,luispollo,4794,0.30710,70969,4.54616,1561077
10,minz1027,4788,0.30671,75757,4.85287,1561077
11,jithine,4035,0.25848,79792,5.11134,1561077
12,SaschaSchwarze0,3276,0.20986,83068,5.32120,1561077
13,PuneetPunamiya,2850,0.18257,85918,5.50376,1561077
14,ikedam,2784,0.17834,88702,5.68210,1561077
15,smerle33,2524,0.16168,91226,5.84379,1561077
16,adong,2458,0.15746,93684,6.00124,1561077
17,FenrirUnbound,2283,0.14625,95967,6.14749,1561077
18,prince-chrismc,2254,0.14439,98221,6.29187,1561077
19,caseyhebebrand,2234,0.14311,100455,6.43498,1561077
20,petey,2183,0.13984,102638,6.57482,1561077
21,jithin1987,2046,0.13106,104684,6.70588,1561077
22,gounthar,1920,0.12299,106604,6.82888,1561077
23,pritamstyz4ever,1914,0.12261,108518,6.95148,1561077
24,sm43,1883,0.12062,110401,7.07210,1561077
25,kmartens27,1814,0.11620,112215,7.18831,1561077
26,fishseabowl,1607,0.10294,113822,7.29125,1561077
27,parthasl,1457,0.09333,115279,7.38458,1561077
28,klu909,1441,0.09231,116720,7.47689,1561077
29,jonesbusy,1404,0.08994,118124,7.56683,1561077
30,otaviof,1380,0.08840,119504,7.65523,1561077
31,vigneshm,1316,0.08430,120820,7.73953,1561077
32,janfaracik,1287,0.08244,122107,7.82197,1561077
33,StefanSpieker,1267,0.08116,123374,7.90313,1561077
34,cloudbees-pull-request-builder,1262,0.08084,124636,7.98398,1561077
35,betarelease,1249,0.08001,125885,8.06398,1561077
36,pratap0007,1248,0.07994,127133,8.14393,1561077
37,simonsymhoven,1213,0.07770,128346,8.22163,1561077
38,gal-yardeni,1203,0.07706,129549,8.29869,1561077
39,kumada626,1137,0.07283,130686,8.37153,1561077
40,dkjellin,1135,0.07271,131821,8.44423,1561077
41,fqueiruga,1133,0.07258,132954,8.51681,1561077
42,DaGeRe,1108,0.07098,134062,8.58779,1561077
43,krisstern,1089,0.06976,135151,8.65755,1561077
44,ranihorev,1079,0.06912,136230,8.72667,1561077
45,robinsoc,1064,0.06816,137294,8.79483,1561077
46,nkatzman,1021,0.06540,138315,8.86023,1561077
47,yoshwata,1021,0.06540,139336,8.92563,1561077
48,scaytrase,975,0.06246,140311,8.98809,1561077
49,wahapo,951,0.06092,141262,9.04901,1561077
50,ian-fox,938,0.06009,142200,9.10910,1561077
51,jer,894,0.05727,143094,9.16636,1561077
52,SM43,894,0.05727,143988,9.22363,1561077
53,tiainen,888,0.05688,144876,9.28052,1561077
54,yuichi10,868,0.05560,145744,9.33612,1561077
55,jaydeepc,856,0.05483,146600,9.39095,1561077
56,brian-armory,843,0.05400,147443,9.44495,1561077
57,mPokornyETM,797,0.05105,148240,9.49601,1561077
58,TracyRagan,783,0.05016,149023,9.54617,1561077
59,offa,782,0.05009,149805,9.59626,1561077
60,ywluogg,778,0.04984,150583,9.64610,1561077
61,allisaurus,775,0.04965,151358,9.69574,1561077
62,dasmanas,761,0.04875,152119,9.74449,1561077
63,catto,757,0.04849,152876,9.79298,1561077
64,Filbird,756,0.04843,153632,9.84141,1561077
65,erwin1,738,0.04728,154370,9.88869,1561077
66,DekusDenial,729,0.04670,155099,9.93538,1561077
67,mgrand,728,0.04663,155827,9.98202,1561077
68,stellargo,724,0.04638,156551,10.02840,1561077
69,DuMaM,713,0.04567,157264,10.07407,1561077
70,dheerajodha,711,0.04555,157975,10.11962,1561077
71,drodriguezhdez,703,0.04503,158678,10.16465,1561077
72,chrismellard,679,0.04350,159357,10.20814,1561077
73,JLLeitschuh,663,0.04247,160020,10.25062,1561077
74,liuweiGL,653,0.04183,160673,10.29245,1561077
75,ibu1224,630,0.04036,161303,10.33280,1561077
76,strangelookingnerd,624,0.03997,161927,10.37277,1561077
77,aravindmd,622,0.03984,162549,10.41262,1561077
78,pranavrc,609,0.03901,163158,10.45163,1561077
79,dennisnewel,606,0.03882,163764,10.49045,1561077
80,Erwyn,596,0.03818,164360,10.52863,1561077
81,sd-buildbot,594,0.03805,164954,10.56668,1561077
82,h1dden-da3m0n,588,0.03767,165542,10.60435,1561077
83,alyssat,582,0.03728,166124,10.64163,1561077
84,repolevedavaj,576,0.03690,166700,10.67853,1561077
85,briangleeson,570,0.03651,167270,10.71504,1561077
86,sarah-witt,566,0.03626,167836,10.75130,1561077
87,babadofar,541,0.03466,168377,10.78595,1561077
88,banusha2,539,0.03453,168916,10.82048,1561077
89,jasonmcintosh,528,0.03382,169444,10.85430,1561077
90,benpatterson,527,0.03376,169971,10.88806,1561077
91,imonteroperez,527,0.03376,170498,10.92182,1561077
92,lloydchang,527,0.03376,171025,10.95558,1561077
93,sachajw,527,0.03376,171552,10.98934,1561077
94,hervelemeur,519,0.03325,172071,11.02258,1561077
95,c00ler,515,0.03299,172586,11.05557,1561077
96,mat1e,514,0.03293,173100,11.08850,1561077
97,r3rastogi,506,0.03241,173606,11.12091,1561077
98,zachsmith1,505,0.03235,174111,11.15326,1561077
99,srekapalli,502,0.03216,174613,11.18542,1561077
100,timbrown5,500,0.03203,175113,11.21745,1561077
101,Zastai,496,0.03177,175609,11.24922,1561077
102,sakka2,478,0.03062,176087,11.27984,1561077
103,chb0github,477,0.03056,176564,11.31040,1561077
104,KalleOlaviNiemitalo,476,0.03049,177040,11.34089,1561077
105,karolh2000,476,0.03049,177516,11.37138,1561077
106,dheid,466,0.02985,177982,11.40123,1561077
107,sergetron,464,0.02972,178446,11.43095,1561077
108,Megan-Wright,463,0.02966,178909,11.46061,1561077
109,LeSuisse,460,0.02947,179369,11.49008,1561077
110,jeschkies,459,0.02940,179828,11.51948,1561077
111,spinnakerbot2,455,0.02915,180283,11.54863,1561077
112,efrisch,454,0.02908,180737,11.57771,1561077
113,ovasilko,453,0.02902,181190,11.60673,1561077
114,aHenryJard,452,0.02895,181642,11.63568,1561077
115,kkisic,447,0.02863,182089,11.66432,1561077
116,pdk27,442,0.02831,182531,11.69263,1561077
117,joelseq,441,0.02825,182972,11.72088,1561077
118,lifeofguenter,440,0.02819,183412,11.74907,1561077
119,MitaliBo,436,0.02793,183848,11.77700,1561077
120,s-yoshika,432,0.02767,184280,11.80467,1561077
121,paragbhingre,431,0.02761,184711,11.83228,1561077
122,froque,419,0.02684,185130,11.85912,1561077
123,evernat,418,0.02678,185548,11.88590,1561077
124,dbyron0,411,0.02633,185959,11.91222,1561077
125,itleigns,400,0.02562,186359,11.93785,1561077
126,yaroslavafenkin,397,0.02543,186756,11.96328,1561077
127,tomhobson,396,0.02537,187152,11.98865,1561077
128,Pldi23,394,0.02524,187546,12.01389,1561077
129,allyourbotsarebelongtous,393,0.02517,187939,12.03906,1561077
130,sugarnaoming,393,0.02517,188332,12.06424,1561077
131,sagar1312,389,0.02492,188721,12.08915,1561077
132,ldong,385,0.02466,189106,12.11382,1561077
133,Russell616,385,0.02466,189491,12.13848,1561077
134,rishabhBudhouliya,384,0.02460,189875,12.16308,1561077
135,ssogabe,384,0.02460,190259,12.18768,1561077
136,ScottyFillups,376,0.02409,190635,12.21176,1561077
137,ihcomega56,369,0.02364,191004,12.23540,1561077
138,sdrss,369,0.02364,191373,12.25904,1561077
139,multani,364,0.02332,191737,12.28235,1561077
140,xuzhang3,364,0.02332,192101,12.30567,1561077
141,dogonthehorizon,358,0.02293,192459,12.32860,1561077
142,michael-doubez,358,0.02293,192817,12.35154,1561077
143,Sig00rd,355,0.02274,193172,12.37428,1561077
144,piradeepk,351,0.02248,193523,12.39676,1561077
145,alibk0rd,343,0.02197,193866,12.41873,1561077
146,Loghijiaha,342,0.02191,194208,12.44064,1561077
147,pierretasci,339,0.02172,194547,12.46236,1561077
148,zhaoying818,339,0.02172,194886,12.48407,1561077
149,osamamagdy,338,0.02165,195224,12.50573,1561077
150,hectorhuol,335,0.02146,195559,12.52718,1561077
151,maselvaraj,335,0.02146,195894,12.54864,1561077
152,cashlalala,324,0.02075,196218,12.56940,1561077
153,nikita-bedmutha,323,0.02069,196541,12.59009,1561077
154,yelhouti,322,0.02063,196863,12.61072,1561077
155,imuqtadir,317,0.02031,197180,12.63102,1561077
156,tszmytka,313,0.02005,197493,12.65107,1561077
157,vimil,306,0.01960,197799,12.67068,1561077
158,yuege01,305,0.01954,198104,12.69021,1561077
159,magnusbaeck,302,0.01935,198406,12.70956,1561077
160,nadavye,301,0.01928,198707,12.72884,1561077
161,philippart-s,300,0.01922,199007,12.74806,1561077
162,thombergs,299,0.01915,199306,12.76721,1561077
163,efhjnw0,297,0.01903,199603,12.78624,1561077
164,JordanGS,297,0.01903,199900,12.80526,1561077
165,MartinGroscheTT,297,0.01903,200197,12.82429,1561077
166,Aki-7,294,0.01883,200491,12.84312,1561077
167,mrginglymus,294,0.01883,200785,12.86195,1561077
168,sephiroth-j,293,0.01877,201078,12.88072,1561077
169,tofanadrian3000,293,0.01877,201371,12.89949,1561077
170,nbelliot,289,0.01851,201660,12.91800,1561077
171,SylwiaBrant,289,0.01851,201949,12.93652,1561077
172,sd-buildbot-functional,288,0.01845,202237,12.95497,1561077
173,mycircleincci,284,0.01819,202521,12.97316,1561077
174,bertold,278,0.01781,202799,12.99097,1561077
175,Vandit1604,277,0.01774,203076,13.00871,1561077
176,jakalkhalili,275,0.01762,203351,13.02633,1561077
177,eduard-tita,271,0.01736,203622,13.04369,1561077
178,mrageh,271,0.01736,203893,13.06105,1561077
179,mcohen11,265,0.01698,204158,13.07802,1561077
180,pkandasamy91,263,0.01685,204421,13.09487,1561077
181,based2,257,0.01646,204678,13.11133,1561077
182,edgarulg,256,0.01640,204934,13.12773,1561077
183,ovidiupopa07,252,0.01614,205186,13.14387,1561077
184,gautamabhishek46,248,0.01589,205434,13.15976,1561077
185,jahed-snyk,248,0.01589,205682,13.17565,1561077
186,AbdulRahmanAlHamali,246,0.01576,205928,13.19141,1561077
187,dennisgu1,245,0.01569,206173,13.20710,1561077
188,gzussa,245,0.01569,206418,13.22279,1561077
189,AbhijithGanesh,244,0.01563,206662,13.23842,1561077
190,GregDritschler,244,0.01563,206906,13.25405,1561077
191,bryanateoan,243,0.01557,207149,13.26962,1561077
192,vsinghai,240,0.01537,207389,13.28499,1561077
193,ace-han,239,0.01531,207628,13.30030,1561077
194,mwinter69,238,0.01525,207866,13.31555,1561077
195,wdstar,237,0.01518,208103,13.33073,1561077
196,judovana,235,0.01505,208338,13.34579,1561077
197,Kevin-CB,235,0.01505,208573,13.36084,1561077
198,15knots,233,0.01493,208806,13.37577,1561077
199,cavissonsystems,232,0.01486,209038,13.39063,1561077
200,Roemer,228,0.01461,209266,13.40523,1561077
201,b-fisher-cb,224,0.01435,209490,13.41958,1561077
202,pedrompflopes,222,0.01422,209712,13.43380,1561077
203,ADI10HERO,219,0.01403,209931,13.44783,1561077
204,dharaghodasara,216,0.01384,210147,13.46167,1561077
205,kazuhidet,216,0.01384,210363,13.47550,1561077
206,prryb,216,0.01384,210579,13.48934,1561077
207,sbuhary,216,0.01384,210795,13.50318,1561077
208,Jagrutiti,214,0.01371,211009,13.51689,1561077
209,charchil-gupta,212,0.01358,211221,13.53047,1561077
210,jgoering41,212,0.01358,211433,13.54405,1561077
211,Chinikins,211,0.01352,211644,13.55756,1561077
212,asafg6,210,0.01345,211854,13.57102,1561077
213,zacker330,210,0.01345,212064,13.58447,1561077
214,yokawara,209,0.01339,212273,13.59786,1561077
215,jperedadnr,207,0.01326,212480,13.61112,1561077
216,zhipengwa,207,0.01326,212687,13.62438,1561077
217,mawHBT,205,0.01313,212892,13.63751,1561077
218,tyanai,205,0.01313,213097,13.65064,1561077
219,DavyJones2010,204,0.01307,213301,13.66371,1561077
220,y-oksaku,204,0.01307,213505,13.67678,1561077
221,ethangj,200,0.01281,213705,13.68959,1561077
222,lusol,200,0.01281,213905,13.70240,1561077
223,totocaca123,199,0.01275,214104,13.71515,1561077
224,rkosegi,198,0.01268,214302,13.72783,1561077
225,buildhive,197,0.01262,214499,13.74045,1561077
226,omorillo,197,0.01262,214696,13.75307,1561077
227,gusreiber,196,0.01256,214892,13.76562,1561077
228,keskad,196,0.01256,215088,13.77818,1561077
229,paladox,196,0.01256,215284,13.79074,1561077
230,ganeshborle,195,0.01249,215479,13.80323,1561077
231,ctan-atlassian,194,0.01243,215673,13.81565,1561077
232,rishi-104276,194,0.01243,215867,13.82808,1561077
233,sealights-devops,194,0.01243,216061,13.84051,1561077
234,HRMPW,193,0.01236,216254,13.85287,1561077
235,tzachs,193,0.01236,216447,13.86524,1561077
236,rchougule,192,0.01230,216639,13.87753,1561077
237,chengjoey,191,0.01224,216830,13.88977,1561077
238,aphatangade,189,0.01211,217019,13.90188,1561077
239,cari-mason,189,0.01211,217208,13.91398,1561077
240,dtbaum,189,0.01211,217397,13.92609,1561077
241,codeWithUtkarsh,188,0.01204,217585,13.93813,1561077
242,getJv,188,0.01204,217773,13.95018,1561077
243,gmcdonald,188,0.01204,217961,13.96222,1561077
244,yk634,187,0.01198,218148,13.97420,1561077
245,ericcitaire,185,0.01185,218333,13.98605,1561077
246,orjan,185,0.01185,218518,13.99790,1561077
247,svenschoenung,184,0.01179,218702,14.00969,1561077
248,meiswjn,182,0.01166,218884,14.02135,1561077
249,horodchukanton,181,0.01159,219065,14.03294,1561077
250,robertstreche,180,0.01153,219245,14.04447,1561077
251,MysticDoll,179,0.01147,219424,14.05594,1561077
252,vsilverman,179,0.01147,219603,14.06740,1561077
253,DMaxfield-BDS,178,0.01140,219781,14.07881,1561077
254,jerryzhang222,178,0.01140,219959,14.09021,1561077
255,Stericson,178,0.01140,220137,14.10161,1561077
256,weisun10,178,0.01140,220315,14.11301,1561077
257,yfangsl,177,0.01134,220492,14.12435,1561077
258,guylabs,176,0.01127,220668,14.13563,1561077
259,KocproZ,176,0.01127,220844,14.14690,1561077
260,RonVorndam,176,0.01127,221020,14.15817,1561077
261,aleon1220,175,0.01121,221195,14.16938,1561077
262,plescaevelyn,175,0.01121,221370,14.18059,1561077
263,trixmot,175,0.01121,221545,14.19180,1561077
264,ashleykleynhans,174,0.01115,221719,14.20295,1561077
265,jonsten,174,0.01115,221893,14.21410,1561077
266,NeotysPluginSupport,174,0.01115,222067,14.22524,1561077
267,outconn,173,0.01108,222240,14.23633,1561077
268,benebsiny,172,0.01102,222412,14.24734,1561077
269,eaglerainbow,172,0.01102,222584,14.25836,1561077
270,pfeuffer,171,0.01095,222755,14.26932,1561077
271,xie-rufeng,171,0.01095,222926,14.28027,1561077
272,nhojpatrick,170,0.01089,223096,14.29116,1561077
273,nicolaifsf,168,0.01076,223264,14.30192,1561077
274,clanesf,165,0.01057,223429,14.31249,1561077
275,brokenpip3,162,0.01038,223591,14.32287,1561077
276,qualys-plugins,159,0.01019,223750,14.33305,1561077
277,vihaanthora,159,0.01019,223909,14.34324,1561077
278,jha-cloudbees,158,0.01012,224067,14.35336,1561077
279,yaoxiaoqi,158,0.01012,224225,14.36348,1561077
280,InderH,157,0.01006,224382,14.37354,1561077
281,twasyl,157,0.01006,224539,14.38360,1561077
282,bigspotteddog,156,0.00999,224695,14.39359,1561077
283,cesan3,156,0.00999,224851,14.40358,1561077
284,Riliane,156,0.00999,225007,14.41357,1561077
285,cyberark-bizdev,155,0.00993,225162,14.42350,1561077
286,macghriogair,155,0.00993,225317,14.43343,1561077
287,cwellmtt,154,0.00986,225471,14.44330,1561077
288,viceice,153,0.00980,225624,14.45310,1561077
289,adivos,152,0.00974,225776,14.46284,1561077
290,akomakom,152,0.00974,225928,14.47257,1561077
291,bhavani-velivala-sn,151,0.00967,226079,14.48225,1561077
292,apoorvmahajan,149,0.00954,226228,14.49179,1561077
293,hot13399,149,0.00954,226377,14.50133,1561077
294,jameeluddin,149,0.00954,226526,14.51088,1561077
295,nodece,149,0.00954,226675,14.52042,1561077
296,bmunozm,148,0.00948,226823,14.52990,1561077
297,jay-hershkowitz,148,0.00948,226971,14.53939,1561077
298,blackduck-serv-builder,147,0.00942,227118,14.54880,1561077
299,tempora-mutantur,147,0.00942,227265,14.55822,1561077
300,jcwest,146,0.00935,227411,14.56757,1561077
301,orctom,146,0.00935,227557,14.57692,1561077
302,qasdev,146,0.00935,227703,14.58628,1561077
303,alonbl,145,0.00929,227848,14.59556,1561077
304,abergmeier,144,0.00922,227992,14.60479,1561077
305,amandel,144,0.00922,228136,14.61401,1561077
306,dgarus,144,0.00922,228280,14.62324,1561077
307,SumoSourabh,144,0.00922,228424,14.63246,1561077
308,justusbunsi,143,0.00916,228567,14.64162,1561077
309,songlongcn,143,0.00916,228710,14.65078,1561077
310,vladt,143,0.00916,228853,14.65994,1561077
311,jflinchbaugh,142,0.00910,228995,14.66904,1561077
312,kevinlul,142,0.00910,229137,14.67814,1561077
313,sayan-biswas,142,0.00910,229279,14.68723,1561077
314,frankie139506,141,0.00903,229420,14.69626,1561077
315,lafriks,141,0.00903,229561,14.70530,1561077
316,tmoreland-r7,141,0.00903,229702,14.71433,1561077
317,tylrd,140,0.00897,229842,14.72330,1561077
318,fo-code,138,0.00884,229980,14.73214,1561077
319,ombharatiya,138,0.00884,230118,14.74098,1561077
320,ReleasePraqma,137,0.00878,230255,14.74975,1561077
321,TT-S3-D1,137,0.00878,230392,14.75853,1561077
322,AlvinStanescu,136,0.00871,230528,14.76724,1561077
323,dalbar,136,0.00871,230664,14.77595,1561077
324,IvanaSh,136,0.00871,230800,14.78466,1561077
325,jdkandersson,136,0.00871,230936,14.79338,1561077
326,OronNadiv,136,0.00871,231072,14.80209,1561077
327,Cr1t-GYM,135,0.00865,231207,14.81074,1561077
328,marek-parfianowicz,135,0.00865,231342,14.81938,1561077
329,MicroNovaAG,135,0.00865,231477,14.82803,1561077
330,ali3-atlassian,134,0.00858,231611,14.83662,1561077
331,atyutyunnik,134,0.00858,231745,14.84520,1561077
332,cstarner,134,0.00858,231879,14.85378,1561077
333,fabiodcasilva,134,0.00858,232013,14.86237,1561077
334,rinrinne,134,0.00858,232147,14.87095,1561077
335,rjalander,134,0.00858,232281,14.87954,1561077
336,borntorock,133,0.00852,232414,14.88805,1561077
337,kkokufud,133,0.00852,232547,14.89657,1561077
338,billmanhillman,132,0.00846,232679,14.90503,1561077
339,chadseippel,132,0.00846,232811,14.91349,1561077
340,emptywee,132,0.00846,232943,14.92194,1561077
341,erikhakansson,132,0.00846,233075,14.93040,1561077
342,poasungoh,132,0.00846,233207,14.93885,1561077
343,SubhadraSahoo,132,0.00846,233339,14.94731,1561077
344,enarha,131,0.00839,233470,14.95570,1561077
345,kerogers-cloudbees,130,0.00833,233600,14.96403,1561077
346,Sleepy-GH,130,0.00833,233730,14.97236,1561077
347,jansohn,129,0.00826,233859,14.98062,1561077
348,mably,129,0.00826,233988,14.98888,1561077
349,evansb,128,0.00820,234116,14.99708,1561077
350,maduma,128,0.00820,234244,15.00528,1561077
351,aure-olli,127,0.00814,234371,15.01342,1561077
352,jfrog,127,0.00814,234498,15.02155,1561077
353,svanalstine,127,0.00814,234625,15.02969,1561077
354,alejdg,126,0.00807,234751,15.03776,1561077
355,dorin7bogdan,126,0.00807,234877,15.04583,1561077
356,jaredstehler,126,0.00807,235003,15.05390,1561077
357,joshuasimon-taulia,126,0.00807,235129,15.06197,1561077
358,samatdav,126,0.00807,235255,15.07004,1561077
359,Igor-Filin,125,0.00801,235380,15.07805,1561077
360,k3rnelpan1c-dev,125,0.00801,235505,15.08606,1561077
361,SilkPerformer,125,0.00801,235630,15.09407,1561077
362,vnugopal,125,0.00801,235755,15.10207,1561077
363,andipabst,123,0.00788,235878,15.10995,1561077
364,erkist,122,0.00782,236000,15.11777,1561077
365,guidograzioli,122,0.00782,236122,15.12558,1561077
366,justinskariah,122,0.00782,236244,15.13340,1561077
367,Kaixiang-AWS,122,0.00782,236366,15.14121,1561077
368,salmanmak,121,0.00775,236487,15.14896,1561077
369,shihchang,119,0.00762,236606,15.15659,1561077
370,Willem1987,118,0.00756,236724,15.16415,1561077
371,jfrogbot,117,0.00749,236841,15.17164,1561077
372,zaycodes,117,0.00749,236958,15.17914,1561077
373,eliasnorrby,116,0.00743,237074,15.18657,1561077
374,rysteboe,116,0.00743,237190,15.19400,1561077
375,yasuyuki-baba,116,0.00743,237306,15.20143,1561077
376,karamjotsingh,115,0.00737,237421,15.20879,1561077
377,mafraba,115,0.00737,237536,15.21616,1561077
378,tylercamp,115,0.00737,237651,15.22353,1561077
379,zsprints,115,0.00737,237766,15.23090,1561077
380,evahabeeballah,114,0.00730,237880,15.23820,1561077
381,jcavanagh,114,0.00730,237994,15.24550,1561077
382,curveenk,113,0.00724,238107,15.25274,1561077
383,mattsanta,113,0.00724,238220,15.25998,1561077
384,praveen4g0,113,0.00724,238333,15.26722,1561077
385,Useurmind,113,0.00724,238446,15.27445,1561077
386,cathychan,112,0.00717,238558,15.28163,1561077
387,drekbour,112,0.00717,238670,15.28880,1561077
388,mlasevich,112,0.00717,238782,15.29598,1561077
389,PoojaVishal,112,0.00717,238894,15.30315,1561077
390,alicerum,111,0.00711,239005,15.31026,1561077
391,bgermann,111,0.00711,239116,15.31737,1561077
392,guoyongzhang,111,0.00711,239227,15.32448,1561077
393,loadfocuscom,111,0.00711,239338,15.33159,1561077
394,j3t,110,0.00705,239448,15.33864,1561077
395,nemccarthy,110,0.00705,239558,15.34569,1561077
396,johanvos,109,0.00698,239667,15.35267,1561077
397,ealebed,108,0.00692,239775,15.35959,1561077
398,EasyAsABC123,108,0.00692,239883,15.36651,1561077
399,Ilaygoldman,108,0.00692,239991,15.37342,1561077
400,joker00777,108,0.00692,240099,15.38034,1561077
401,baev,107,0.00685,240206,15.38720,1561077
402,oggboy,107,0.00685,240313,15.39405,1561077
403,JordanS22,106,0.00679,240419,15.40084,1561077
404,prospero238,106,0.00679,240525,15.40763,1561077
405,rvazquezglez,105,0.00673,240630,15.41436,1561077
406,ak1394,104,0.00666,240734,15.42102,1561077
407,lenin-atlassian,104,0.00666,240838,15.42768,1561077
408,mauromorales,104,0.00666,240942,15.43434,1561077
409,ekateam,103,0.00660,241045,15.44094,1561077
410,forticontainer,103,0.00660,241148,15.44754,1561077
411,kripajoym,103,0.00660,241251,15.45414,1561077
412,arpoch,102,0.00653,241353,15.46067,1561077
413,NivKeidan,102,0.00653,241455,15.46721,1561077
414,Waschndolos,102,0.00653,241557,15.47374,1561077
415,egrozdani,101,0.00647,241658,15.48021,1561077
416,fposchner-cc,101,0.00647,241759,15.48668,1561077
417,jragula-zs,101,0.00647,241860,15.49315,1561077
418,sdorra,101,0.00647,241961,15.49962,1561077
419,justinrlee,100,0.00641,242061,15.50603,1561077
420,LyndseyBu,100,0.00641,242161,15.51243,1561077
421,mgarabed,100,0.00641,242261,15.51884,1561077
422,ridemountainpig,100,0.00641,242361,15.52524,1561077
423,rightker,100,0.00641,242461,15.53165,1561077
424,aneveux,99,0.00634,242560,15.53799,1561077
425,genesisthomas,99,0.00634,242659,15.54433,1561077
426,jorgebee65,99,0.00634,242758,15.55067,1561077
427,rahulsom,98,0.00628,242856,15.55695,1561077
428,VeereshAradhya,98,0.00628,242954,15.56323,1561077
429,0N0thing,97,0.00621,243051,15.56944,1561077
430,accelq,97,0.00621,243148,15.57566,1561077
431,carpnick,97,0.00621,243245,15.58187,1561077
432,mslusarczyk,97,0.00621,243342,15.58808,1561077
433,nitheshrayuduv,97,0.00621,243439,15.59430,1561077
434,pavel-snyk,97,0.00621,243536,15.60051,1561077
435,frerikandriessen,96,0.00615,243632,15.60666,1561077
436,OwensCode,96,0.00615,243728,15.61281,1561077
437,rollinhand,96,0.00615,243824,15.61896,1561077
438,ZhouYixun,96,0.00615,243920,15.62511,1561077
439,IantoMcGuckin,95,0.00609,244015,15.63120,1561077
440,jsupun,94,0.00602,244109,15.63722,1561077
441,MondalSayantan,94,0.00602,244203,15.64324,1561077
442,moxun1639,94,0.00602,244297,15.64926,1561077
443,chiarnglin,93,0.00596,244390,15.65522,1561077
444,Dan-Heath,93,0.00596,244483,15.66117,1561077
445,e96wic,93,0.00596,244576,15.66713,1561077
446,ialbors,93,0.00596,244669,15.67309,1561077
447,jamietanna,93,0.00596,244762,15.67905,1561077
448,rudeigerc,93,0.00596,244855,15.68500,1561077
449,sparsick,93,0.00596,244948,15.69096,1561077
450,Ladyprowess,92,0.00589,245040,15.69686,1561077
451,MaximeMazet,92,0.00589,245132,15.70275,1561077
452,shardy-lbar,92,0.00589,245224,15.70864,1561077
453,welandaz,92,0.00589,245316,15.71454,1561077
454,frieder,91,0.00583,245407,15.72036,1561077
455,mtughan,91,0.00583,245498,15.72619,1561077
456,sidmuls,91,0.00583,245589,15.73202,1561077
457,eitanas1,90,0.00577,245679,15.73779,1561077
458,famod,90,0.00577,245769,15.74355,1561077
459,spikeburton,90,0.00577,245859,15.74932,1561077
460,timsotack,90,0.00577,245949,15.75508,1561077
461,umeshwaghode,90,0.00577,246039,15.76085,1561077
462,DJViking,89,0.00570,246128,15.76655,1561077
463,lprimak,89,0.00570,246217,15.77225,1561077
464,marcuzzuu,89,0.00570,246306,15.77795,1561077
465,nikema-armory,89,0.00570,246395,15.78365,1561077
466,spomorski,89,0.00570,246484,15.78936,1561077
467,2020testuser,88,0.00564,246572,15.79499,1561077
468,agabrys,88,0.00564,246660,15.80063,1561077
469,OscarMichelH,88,0.00564,246748,15.80627,1561077
470,pavel-github,88,0.00564,246836,15.81190,1561077
471,prashantvicky,88,0.00564,246924,15.81754,1561077
472,pyieh,88,0.00564,247012,15.82318,1561077
473,sullis,88,0.00564,247100,15.82882,1561077
474,vrulevskyi,88,0.00564,247188,15.83445,1561077
475,YolandaDu1997,88,0.00564,247276,15.84009,1561077
476,jimgrund,87,0.00557,247363,15.84566,1561077
477,johnathafelix,87,0.00557,247450,15.85124,1561077
478,mseabornIBM,87,0.00557,247537,15.85681,1561077
479,ppitonak,87,0.00557,247624,15.86238,1561077
480,psiingh,87,0.00557,247711,15.86796,1561077
481,pushker001,87,0.00557,247798,15.87353,1561077
482,roehrijn,87,0.00557,247885,15.87910,1561077
483,tomasch3034,87,0.00557,247972,15.88467,1561077
484,armory-abedonik,86,0.00551,248058,15.89018,1561077
485,EliSalter-atl,86,0.00551,248144,15.89569,1561077
486,finnq,86,0.00551,248230,15.90120,1561077
487,Hrushi20,86,0.00551,248316,15.90671,1561077
488,megathaum,86,0.00551,248402,15.91222,1561077
489,morad1992,86,0.00551,248488,15.91773,1561077
490,Peaorl,86,0.00551,248574,15.92324,1561077
491,alexbrjo,85,0.00544,248659,15.92868,1561077
492,cawale,85,0.00544,248744,15.93413,1561077
493,steven-foster,85,0.00544,248829,15.93957,1561077
494,tingweichoo,85,0.00544,248914,15.94502,1561077
495,tomfrenken,85,0.00544,248999,15.95046,1561077
496,vjames-bmc,85,0.00544,249084,15.95591,1561077
497,EstherAF,84,0.00538,249168,15.96129,1561077
498,isaac-s,84,0.00538,249252,15.96667,1561077
499,kimholmes,84,0.00538,249336,15.97205,1561077
500,Langer0416,84,0.00538,249420,15.97743,1561077
501,Neetuj,84,0.00538,249504,15.98281,1561077
502,odavid,84,0.00538,249588,15.98819,1561077
503,sorin-florea,84,0.00538,249672,15.99357,1561077
504,Austry,83,0.00532,249755,15.99889,1561077
505,blanked,83,0.00532,249838,16.00421,1561077
506,BlueAndi,83,0.00532,249921,16.00952,1561077
507,DanielaS12,83,0.00532,250004,16.01484,1561077
508,inkysea,83,0.00532,250087,16.02016,1561077
509,KorusMateusz,83,0.00532,250170,16.02547,1561077
510,meliora,83,0.00532,250253,16.03079,1561077
511,XebiaLabsCI,83,0.00532,250336,16.03611,1561077
512,yungezz,83,0.00532,250419,16.04143,1561077
513,bam-hbt,82,0.00525,250501,16.04668,1561077
514,raychou1203,82,0.00525,250583,16.05193,1561077
515,hudsonadmin,81,0.00519,250664,16.05712,1561077
516,kwin,81,0.00519,250745,16.06231,1561077
517,Maxhy,81,0.00519,250826,16.06750,1561077
518,stefanbirkner,81,0.00519,250907,16.07269,1561077
519,chanseokoh,80,0.00512,250987,16.07781,1561077
520,hp77-creator,80,0.00512,251067,16.08294,1561077
521,igalg,80,0.00512,251147,16.08806,1561077
522,MithileshPawar,80,0.00512,251227,16.09318,1561077
523,tanujdevops,80,0.00512,251307,16.09831,1561077
524,yashin-luo,80,0.00512,251387,16.10343,1561077
525,arpad9,79,0.00506,251466,16.10849,1561077
526,skundrik,79,0.00506,251545,16.11355,1561077
527,tlopesPT,79,0.00506,251624,16.11862,1561077
528,bulanovk,78,0.00500,251702,16.12361,1561077
529,carlosrodlop,78,0.00500,251780,16.12861,1561077
530,geoffroyjabouley,78,0.00500,251858,16.13361,1561077
531,jgreffe,78,0.00500,251936,16.13860,1561077
532,MartinKosicky,78,0.00500,252014,16.14360,1561077
533,nsurendran1991,78,0.00500,252092,16.14859,1561077
534,pstout,78,0.00500,252170,16.15359,1561077
535,Tattoo,78,0.00500,252248,16.15859,1561077
536,ysun-atl,78,0.00500,252326,16.16358,1561077
537,pohkheng2,77,0.00493,252403,16.16852,1561077
538,thecodejunkie,77,0.00493,252480,16.17345,1561077
539,vbragin,77,0.00493,252557,16.17838,1561077
540,Zhongtang,77,0.00493,252634,16.18331,1561077
541,fishi0x01,76,0.00487,252710,16.18818,1561077
542,iwarapter,76,0.00487,252786,16.19305,1561077
543,jb-dev,76,0.00487,252862,16.19792,1561077
544,ykhandelwal913,76,0.00487,252938,16.20279,1561077
545,gdanko,75,0.00480,253013,16.20759,1561077
546,itwake,75,0.00480,253088,16.21240,1561077
547,krufab,75,0.00480,253163,16.21720,1561077
548,shillner,75,0.00480,253238,16.22201,1561077
549,thecooldrop,75,0.00480,253313,16.22681,1561077
550,adivoss,74,0.00474,253387,16.23155,1561077
551,advinst,74,0.00474,253461,16.23629,1561077
552,akostadinov,74,0.00474,253535,16.24103,1561077
553,benhpoh,74,0.00474,253609,16.24577,1561077
554,bitle,74,0.00474,253683,16.25051,1561077
555,ciradu2204,74,0.00474,253757,16.25525,1561077
556,dglugla,74,0.00474,253831,16.25999,1561077
557,ElasTestCI,74,0.00474,253905,16.26473,1561077
558,hmarkc,74,0.00474,253979,16.26947,1561077
559,jweingarten,74,0.00474,254053,16.27421,1561077
560,phoenix384,74,0.00474,254127,16.27895,1561077
561,qinyujia,74,0.00474,254201,16.28369,1561077
562,shahulsonhal,74,0.00474,254275,16.28843,1561077
563,stepanselyuk,74,0.00474,254349,16.29317,1561077
564,VirtualTim,74,0.00474,254423,16.29791,1561077
565,awittha,73,0.00468,254496,16.30259,1561077
566,Basavaraju-G,73,0.00468,254569,16.30727,1561077
567,bogdancucosel,73,0.00468,254642,16.31194,1561077
568,kiam123,73,0.00468,254715,16.31662,1561077
569,mmalicki-deviniti,73,0.00468,254788,16.32130,1561077
570,mybayern1974,73,0.00468,254861,16.32597,1561077
571,mythsunwind,72,0.00461,254933,16.33058,1561077
572,Zsolt-Lukacs22,72,0.00461,255005,16.33520,1561077
573,intlandsupport,71,0.00455,255076,16.33974,1561077
574,marniks7,71,0.00455,255147,16.34429,1561077
575,NarcisaMGalan,71,0.00455,255218,16.34884,1561077
576,otradovec,71,0.00455,255289,16.35339,1561077
577,testfairy,71,0.00455,255360,16.35794,1561077
578,afcastano,70,0.00448,255430,16.36242,1561077
579,a-st,70,0.00448,255500,16.36691,1561077
580,jcusa,70,0.00448,255570,16.37139,1561077
581,magg,70,0.00448,255640,16.37587,1561077
582,nemesisOsorio,70,0.00448,255710,16.38036,1561077
583,paul8620,70,0.00448,255780,16.38484,1561077
584,pessoarthur,70,0.00448,255850,16.38933,1561077
585,startxfr,70,0.00448,255920,16.39381,1561077
586,theKBro,70,0.00448,255990,16.39829,1561077
587,Yunir,70,0.00448,256060,16.40278,1561077
588,amygroshek,69,0.00442,256129,16.40720,1561077
589,chicofaccin,69,0.00442,256198,16.41162,1561077
590,Denis1990,69,0.00442,256267,16.41604,1561077
591,dwmarshall,69,0.00442,256336,16.42046,1561077
592,glasswalk3r,69,0.00442,256405,16.42488,1561077
593,jftsunami,69,0.00442,256474,16.42930,1561077
594,roxbot,69,0.00442,256543,16.43372,1561077
595,sramek5,69,0.00442,256612,16.43814,1561077
596,stephly07,69,0.00442,256681,16.44256,1561077
597,xihaLong,69,0.00442,256750,16.44698,1561077
598,comsi02,68,0.00436,256818,16.45133,1561077
599,knowds,68,0.00436,256886,16.45569,1561077
600,P01son6415,68,0.00436,256954,16.46005,1561077
601,rittneje,68,0.00436,257022,16.46440,1561077
602,sergio-quintero,68,0.00436,257090,16.46876,1561077
603,vilacides,68,0.00436,257158,16.47311,1561077
604,ad22,67,0.00429,257225,16.47741,1561077
605,barbasa,67,0.00429,257292,16.48170,1561077
606,clouless,67,0.00429,257359,16.48599,1561077
607,didiez,67,0.00429,257426,16.49028,1561077
608,grandvizier,67,0.00429,257493,16.49457,1561077
609,ilandn,67,0.00429,257560,16.49887,1561077
610,itaimarko,67,0.00429,257627,16.50316,1561077
611,julieheard,67,0.00429,257694,16.50745,1561077
612,kellie-freeman,67,0.00429,257761,16.51174,1561077
613,kkotula,67,0.00429,257828,16.51603,1561077
614,mmh891113,67,0.00429,257895,16.52033,1561077
615,mreichel,67,0.00429,257962,16.52462,1561077
616,ShrutiC-git,67,0.00429,258029,16.52891,1561077
617,Adakar,66,0.00423,258095,16.53314,1561077
618,andau,66,0.00423,258161,16.53736,1561077
619,cugykw,66,0.00423,258227,16.54159,1561077
620,cxDorg,66,0.00423,258293,16.54582,1561077
621,kturetzky,66,0.00423,258359,16.55005,1561077
622,meg23,66,0.00423,258425,16.55428,1561077
623,nabuskey,66,0.00423,258491,16.55850,1561077
624,nayeligarciac,66,0.00423,258557,16.56273,1561077
625,nistal97,66,0.00423,258623,16.56696,1561077
626,bpedersen2,65,0.00416,258688,16.57112,1561077
627,Code-Beast,65,0.00416,258753,16.57529,1561077
628,falkena,65,0.00416,258818,16.57945,1561077
629,gaspardpetit,65,0.00416,258883,16.58362,1561077
630,idanhauser,65,0.00416,258948,16.58778,1561077
631,jlamande,65,0.00416,259013,16.59194,1561077
632,JohnNiang,65,0.00416,259078,16.59611,1561077
633,mifitous,65,0.00416,259143,16.60027,1561077
634,xangxiong,65,0.00416,259208,16.60443,1561077
635,aabhas-sao,64,0.00410,259272,16.60853,1561077
636,Arvind644,64,0.00410,259336,16.61263,1561077
637,chillaq,64,0.00410,259400,16.61673,1561077
638,cryptomoovin,64,0.00410,259464,16.62083,1561077
639,engfelipeoliveira,64,0.00410,259528,16.62493,1561077
640,flexagon9,64,0.00410,259592,16.62903,1561077
641,mpet,64,0.00410,259656,16.63313,1561077
642,peterpd,64,0.00410,259720,16.63723,1561077
643,vbugale,64,0.00410,259784,16.64133,1561077
644,DavidStaheli,63,0.00404,259847,16.64537,1561077
645,dparapanov,63,0.00404,259910,16.64940,1561077
646,kaltepeter,63,0.00404,259973,16.65344,1561077
647,mohamedelhabib,63,0.00404,260036,16.65747,1561077
648,onecloud-sean,63,0.00404,260099,16.66151,1561077
649,pv-smartbear,63,0.00404,260162,16.66555,1561077
650,rbello,63,0.00404,260225,16.66958,1561077
651,sergiopena,63,0.00404,260288,16.67362,1561077
652,shaowenchen,63,0.00404,260351,16.67765,1561077
653,sharmapulkit04,63,0.00404,260414,16.68169,1561077
654,anxinyf,62,0.00397,260476,16.68566,1561077
655,atlassian-bamboo-agent,62,0.00397,260538,16.68963,1561077
656,takuma02141978,62,0.00397,260600,16.69360,1561077
657,Zlopez,62,0.00397,260662,16.69757,1561077
658,alandoni,61,0.00391,260723,16.70148,1561077
659,clywyk,61,0.00391,260784,16.70539,1561077
660,DanMHammer,61,0.00391,260845,16.70930,1561077
661,Go-to-bed-at-12,61,0.00391,260906,16.71321,1561077
662,imaffe,61,0.00391,260967,16.71711,1561077
663,lalitKumarHCL,61,0.00391,261028,16.72102,1561077
664,saimadineni,61,0.00391,261089,16.72493,1561077
665,urwa,61,0.00391,261150,16.72884,1561077
666,aberkIBM,60,0.00384,261210,16.73268,1561077
667,AH7,60,0.00384,261270,16.73652,1561077
668,c0d3m0nky,60,0.00384,261330,16.74037,1561077
669,cheerfyt,60,0.00384,261390,16.74421,1561077
670,christopherbaek,60,0.00384,261450,16.74805,1561077
671,EndlessTrax,60,0.00384,261510,16.75190,1561077
672,jace-ys,60,0.00384,261570,16.75574,1561077
673,jamesrobson-secondmind,60,0.00384,261630,16.75958,1561077
674,sheehan,60,0.00384,261690,16.76343,1561077
675,wenjunzhangp,60,0.00384,261750,16.76727,1561077
676,Wheedman,60,0.00384,261810,16.77111,1561077
677,aesanch2,59,0.00378,261869,16.77489,1561077
678,a-shevtsov,59,0.00378,261928,16.77867,1561077
679,ckreisl,59,0.00378,261987,16.78245,1561077
680,dbnicholson,59,0.00378,262046,16.78623,1561077
681,devlauer,59,0.00378,262105,16.79001,1561077
682,dmoduarte,59,0.00378,262164,16.79379,1561077
683,emsa23,59,0.00378,262223,16.79757,1561077
684,itavero,59,0.00378,262282,16.80135,1561077
685,Luthan95,59,0.00378,262341,16.80513,1561077
686,mabdelmoez,59,0.00378,262400,16.80891,1561077
687,Mulgish,59,0.00378,262459,16.81269,1561077
688,wowq,59,0.00378,262518,16.81647,1561077
689,ababushk,58,0.00372,262576,16.82018,1561077
690,awsiv,58,0.00372,262634,16.82390,1561077
691,cccfeng,58,0.00372,262692,16.82761,1561077
692,cxZoharby,58,0.00372,262750,16.83133,1561077
693,guido9j,58,0.00372,262808,16.83504,1561077
694,hdhaygude,58,0.00372,262866,16.83876,1561077
695,jameslafferty,58,0.00372,262924,16.84247,1561077
696,jeffreycoe,58,0.00372,262982,16.84619,1561077
697,kevydotvinu,58,0.00372,263040,16.84991,1561077
698,koraytugay,58,0.00372,263098,16.85362,1561077
699,krharsh17,58,0.00372,263156,16.85734,1561077
700,lugowskii,58,0.00372,263214,16.86105,1561077
701,norbyltd,58,0.00372,263272,16.86477,1561077
702,zoomdevplatform,58,0.00372,263330,16.86848,1561077
703,apottere,57,0.00365,263387,16.87213,1561077
704,atikhono,57,0.00365,263444,16.87579,1561077
705,atombrella,57,0.00365,263501,16.87944,1561077
706,draoullig,57,0.00365,263558,16.88309,1561077
707,emanuelez,57,0.00365,263615,16.88674,1561077
708,ferkulat,57,0.00365,263672,16.89039,1561077
709,marlovil,57,0.00365,263729,16.89404,1561077
710,orgi,57,0.00365,263786,16.89769,1561077
711,terrorbox,57,0.00365,263843,16.90134,1561077
712,tomjshore,57,0.00365,263900,16.90500,1561077
713,tphongio,57,0.00365,263957,16.90865,1561077
714,Xenogents,57,0.00365,264014,16.91230,1561077
715,CalvinTse,56,0.00359,264070,16.91589,1561077
716,cappyzawa,56,0.00359,264126,16.91947,1561077
717,dariver,56,0.00359,264182,16.92306,1561077
718,digglife,56,0.00359,264238,16.92665,1561077
719,iiro,56,0.00359,264294,16.93023,1561077
720,kamilgo,56,0.00359,264350,16.93382,1561077
721,mcamposv,56,0.00359,264406,16.93741,1561077
722,minzcmu,56,0.00359,264462,16.94100,1561077
723,mkosmala-deviniti,56,0.00359,264518,16.94458,1561077
724,mwos-sl,56,0.00359,264574,16.94817,1561077
725,prophen,56,0.00359,264630,16.95176,1561077
726,SOOS-JAlvarez,56,0.00359,264686,16.95535,1561077
727,sqlwristband,56,0.00359,264742,16.95893,1561077
728,ssc327,56,0.00359,264798,16.96252,1561077
729,takaaki7,56,0.00359,264854,16.96611,1561077
730,yuanbohan,56,0.00359,264910,16.96969,1561077
731,andreamussap,55,0.00352,264965,16.97322,1561077
732,anneqm,55,0.00352,265020,16.97674,1561077
733,chiragnaik,55,0.00352,265075,16.98026,1561077
734,CSchulz,55,0.00352,265130,16.98379,1561077
735,dneduva1,55,0.00352,265185,16.98731,1561077
736,JCzz,55,0.00352,265240,16.99083,1561077
737,matrozov,55,0.00352,265295,16.99436,1561077
738,mii-w,55,0.00352,265350,16.99788,1561077
739,rbjorklin,55,0.00352,265405,17.00140,1561077
740,seanly,55,0.00352,265460,17.00493,1561077
741,shasait,55,0.00352,265515,17.00845,1561077
742,shyamsfo,55,0.00352,265570,17.01197,1561077
743,Si-So,55,0.00352,265625,17.01550,1561077
744,veeresh1982,55,0.00352,265680,17.01902,1561077
745,AdrianLC,54,0.00346,265734,17.02248,1561077
746,AlexandruMaxim,54,0.00346,265788,17.02594,1561077
747,alfian-sken,54,0.00346,265842,17.02940,1561077
748,BirSikanderMahajan,54,0.00346,265896,17.03286,1561077
749,ChrisRo89,54,0.00346,265950,17.03632,1561077
750,cxbuild,54,0.00346,266004,17.03977,1561077
751,dali546,54,0.00346,266058,17.04323,1561077
752,dimmel82,54,0.00346,266112,17.04669,1561077
753,eheimbuch,54,0.00346,266166,17.05015,1561077
754,iqbalrohail,54,0.00346,266220,17.05361,1561077
755,jalonsoa,54,0.00346,266274,17.05707,1561077
756,kellyrob99,54,0.00346,266328,17.06053,1561077
757,mbarbero,54,0.00346,266382,17.06399,1561077
758,orgads,54,0.00346,266436,17.06745,1561077
759,QMetryDev,54,0.00346,266490,17.07091,1561077
760,raffamendes,54,0.00346,266544,17.07437,1561077
761,sangamchitmugre,54,0.00346,266598,17.07783,1561077
762,scanalesespinoza,54,0.00346,266652,17.08128,1561077
763,taisukeh,54,0.00346,266706,17.08474,1561077
764,thyldrm,54,0.00346,266760,17.08820,1561077
765,aliaandersen,53,0.00340,266813,17.09160,1561077
766,Bijnagte,53,0.00340,266866,17.09499,1561077
767,glechev,53,0.00340,266919,17.09839,1561077
768,halyph,53,0.00340,266972,17.10178,1561077
769,james-crowley,53,0.00340,267025,17.10518,1561077
770,mglazer,53,0.00340,267078,17.10857,1561077
771,mheinzerling,53,0.00340,267131,17.11197,1561077
772,mkaring,53,0.00340,267184,17.11536,1561077
773,okundzich,53,0.00340,267237,17.11876,1561077
774,PeterGerrard,53,0.00340,267290,17.12215,1561077
775,prydin,53,0.00340,267343,17.12555,1561077
776,rpalcolea,53,0.00340,267396,17.12894,1561077
777,ryan-mf,53,0.00340,267449,17.13234,1561077
778,sshelomentsev,53,0.00340,267502,17.13573,1561077
779,afavieres,52,0.00333,267554,17.13906,1561077
780,Aleromerog,52,0.00333,267606,17.14240,1561077
781,dev-dsp,52,0.00333,267658,17.14573,1561077
782,dpeterka,52,0.00333,267710,17.14906,1561077
783,emoshaya-cognito,52,0.00333,267762,17.15239,1561077
784,FooBarWidget,52,0.00333,267814,17.15572,1561077
785,jandradap,52,0.00333,267866,17.15905,1561077
786,kmccarp,52,0.00333,267918,17.16238,1561077
787,lakshmisusmitha,52,0.00333,267970,17.16571,1561077
788,mivola,52,0.00333,268022,17.16904,1561077
789,rkivisto,52,0.00333,268074,17.17238,1561077
790,tuukkamustonen,52,0.00333,268126,17.17571,1561077
791,vetal2409,52,0.00333,268178,17.17904,1561077
792,yuezhuangshi,52,0.00333,268230,17.18237,1561077
793,zhongwandong,52,0.00333,268282,17.18570,1561077
794,Acunetix,51,0.00327,268333,17.18897,1561077
795,alextu,51,0.00327,268384,17.19223,1561077
796,amine3,51,0.00327,268435,17.19550,1561077
797,bdsoss,51,0.00327,268486,17.19877,1561077
798,brody,51,0.00327,268537,17.20203,1561077
799,cpfeiffer,51,0.00327,268588,17.20530,1561077
800,gbigenios,51,0.00327,268639,17.20857,1561077
801,hoffa,51,0.00327,268690,17.21184,1561077
802,panzo,51,0.00327,268741,17.21510,1561077
803,qxo,51,0.00327,268792,17.21837,1561077
804,RecuencoJones,51,0.00327,268843,17.22164,1561077
805,sn-priya-jagyasi,51,0.00327,268894,17.22490,1561077
806,stevegal,51,0.00327,268945,17.22817,1561077
807,abioteau,50,0.00320,268995,17.23137,1561077
808,Aeon512,50,0.00320,269045,17.23458,1561077
809,bkaganyildiz,50,0.00320,269095,17.23778,1561077
810,clkkishore,50,0.00320,269145,17.24098,1561077
811,hithwen,50,0.00320,269195,17.24418,1561077
812,ialbors-pfc,50,0.00320,269245,17.24739,1561077
813,kkyiu,50,0.00320,269295,17.25059,1561077
814,kyounger,50,0.00320,269345,17.25379,1561077
815,malice00,50,0.00320,269395,17.25700,1561077
816,mariflax,50,0.00320,269445,17.26020,1561077
817,mchengat,50,0.00320,269495,17.26340,1561077
818,titirigaiulian,50,0.00320,269545,17.26661,1561077
819,Avishagp,49,0.00314,269594,17.26974,1561077
820,cpt1gl0,49,0.00314,269643,17.27288,1561077
821,dragoonis,49,0.00314,269692,17.27602,1561077
822,eshack94,49,0.00314,269741,17.27916,1561077
823,itayka,49,0.00314,269790,17.28230,1561077
824,jlrts,49,0.00314,269839,17.28544,1561077
825,JoeMerten,49,0.00314,269888,17.28858,1561077
826,langers2k,49,0.00314,269937,17.29172,1561077
827,MadsJakobsen,49,0.00314,269986,17.29485,1561077
828,mikedld,49,0.00314,270035,17.29799,1561077
829,netwolfuk,49,0.00314,270084,17.30113,1561077
830,stolp,49,0.00314,270133,17.30427,1561077
831,t0mpson,49,0.00314,270182,17.30741,1561077
832,thc202,49,0.00314,270231,17.31055,1561077
833,tlenaic,49,0.00314,270280,17.31369,1561077
834,zdmeyers,49,0.00314,270329,17.31683,1561077
835,AlexanderNikitin-Smartbear,48,0.00307,270377,17.31990,1561077
836,AyushRawat1,48,0.00307,270425,17.32298,1561077
837,ErikRehmTT,48,0.00307,270473,17.32605,1561077
838,gjabouley-invn,48,0.00307,270521,17.32913,1561077
839,guipal,48,0.00307,270569,17.33220,1561077
840,hiro0824,48,0.00307,270617,17.33528,1561077
841,janschaefer,48,0.00307,270665,17.33835,1561077
842,Lima21,48,0.00307,270713,17.34143,1561077
843,marc-tranzer,48,0.00307,270761,17.34450,1561077
844,mikefero,48,0.00307,270809,17.34757,1561077
845,NextTurn,48,0.00307,270857,17.35065,1561077
846,OldNavi,48,0.00307,270905,17.35372,1561077
847,pbendersky,48,0.00307,270953,17.35680,1561077
848,selcuksozuer,48,0.00307,271001,17.35987,1561077
849,seriousamlqz,48,0.00307,271049,17.36295,1561077
850,Archish27,47,0.00301,271096,17.36596,1561077
851,bacoboy,47,0.00301,271143,17.36897,1561077
852,cristhian-castaneda,47,0.00301,271190,17.37198,1561077
853,cxGalisp,47,0.00301,271237,17.37499,1561077
854,DanaMaxfield,47,0.00301,271284,17.37800,1561077
855,DavidRuhmann,47,0.00301,271331,17.38101,1561077
856,elhabibmed,47,0.00301,271378,17.38402,1561077
857,farahfa,47,0.00301,271425,17.38703,1561077
858,hokadiri,47,0.00301,271472,17.39005,1561077
859,julioguereca,47,0.00301,271519,17.39306,1561077
860,LauraBuzas,47,0.00301,271566,17.39607,1561077
861,Lehmann-Fabian,47,0.00301,271613,17.39908,1561077
862,marioja,47,0.00301,271660,17.40209,1561077
863,marshall777,47,0.00301,271707,17.40510,1561077
864,michaelcouck,47,0.00301,271754,17.40811,1561077
865,Onyimatics,47,0.00301,271801,17.41112,1561077
866,schisamo,47,0.00301,271848,17.41413,1561077
867,vishalhcl-5960,47,0.00301,271895,17.41714,1561077
868,wumaxd,47,0.00301,271942,17.42015,1561077
869,aelliotatemboticsdotcom,46,0.00295,271988,17.42310,1561077
870,alexf123,46,0.00295,272034,17.42605,1561077
871,asgard-r,46,0.00295,272080,17.42899,1561077
872,aufarg,46,0.00295,272126,17.43194,1561077
873,dshvedchenko,46,0.00295,272172,17.43489,1561077
874,GitHubSriramB,46,0.00295,272218,17.43783,1561077
875,Isacholm,46,0.00295,272264,17.44078,1561077
876,mgoyal2-atl,46,0.00295,272310,17.44373,1561077
877,mrebasti,46,0.00295,272356,17.44667,1561077
878,pramodc0777,46,0.00295,272402,17.44962,1561077
879,quilicicf,46,0.00295,272448,17.45257,1561077
880,rheinwein,46,0.00295,272494,17.45551,1561077
881,romil-punetha,46,0.00295,272540,17.45846,1561077
882,silvez-dh,46,0.00295,272586,17.46141,1561077
883,yhaliaw,46,0.00295,272632,17.46435,1561077
884,zexiplus,46,0.00295,272678,17.46730,1561077
885,ztbsuper,46,0.00295,272724,17.47025,1561077
886,bkhouri,45,0.00288,272769,17.47313,1561077
887,damienbiggs,45,0.00288,272814,17.47601,1561077
888,dtrebbien,45,0.00288,272859,17.47889,1561077
889,eXistence,45,0.00288,272904,17.48178,1561077
890,facewindu,45,0.00288,272949,17.48466,1561077
891,fengtan,45,0.00288,272994,17.48754,1561077
892,flozzone,45,0.00288,273039,17.49042,1561077
893,fraz3alpha,45,0.00288,273084,17.49331,1561077
894,joaori,45,0.00288,273129,17.49619,1561077
895,misery,45,0.00288,273174,17.49907,1561077
896,rockleez,45,0.00288,273219,17.50196,1561077
897,shashanksah143,45,0.00288,273264,17.50484,1561077
898,shubhamc183,45,0.00288,273309,17.50772,1561077
899,tanoda,45,0.00288,273354,17.51060,1561077
900,titosand,45,0.00288,273399,17.51349,1561077
901,trobinson-r7,45,0.00288,273444,17.51637,1561077
902,11000100111000,44,0.00282,273488,17.51919,1561077
903,aaronfay,44,0.00282,273532,17.52201,1561077
904,Absh-Day,44,0.00282,273576,17.52482,1561077
905,andreibangau99,44,0.00282,273620,17.52764,1561077
906,ankk13,44,0.00282,273664,17.53046,1561077
907,bozaro,44,0.00282,273708,17.53328,1561077
908,brianeray,44,0.00282,273752,17.53610,1561077
909,builderh2m,44,0.00282,273796,17.53892,1561077
910,DieAkuteSense,44,0.00282,273840,17.54174,1561077
911,digitalrinaldo,44,0.00282,273884,17.54455,1561077
912,djerraballi,44,0.00282,273928,17.54737,1561077
913,duyluonganh,44,0.00282,273972,17.55019,1561077
914,edif2008,44,0.00282,274016,17.55301,1561077
915,francisf,44,0.00282,274060,17.55583,1561077
916,g3n35i5,44,0.00282,274104,17.55865,1561077
917,gamma,44,0.00282,274148,17.56147,1561077
918,hello-woof,44,0.00282,274192,17.56428,1561077
919,iTMSJenkins,44,0.00282,274236,17.56710,1561077
920,ivan-levelops,44,0.00282,274280,17.56992,1561077
921,jeanblanchard,44,0.00282,274324,17.57274,1561077
922,jgriffiths1993,44,0.00282,274368,17.57556,1561077
923,jimzucker,44,0.00282,274412,17.57838,1561077
924,LeoQuote,44,0.00282,274456,17.58120,1561077
925,mrmoritz01,44,0.00282,274500,17.58401,1561077
926,pmaccamp,44,0.00282,274544,17.58683,1561077
927,rvankruistum,44,0.00282,274588,17.58965,1561077
928,sgarlick987,44,0.00282,274632,17.59247,1561077
929,Siddhesh-Ghadi,44,0.00282,274676,17.59529,1561077
930,SuperKmar,44,0.00282,274720,17.59811,1561077
931,szcn,44,0.00282,274764,17.60093,1561077
932,13567436138,43,0.00275,274807,17.60368,1561077
933,Abingcbc,43,0.00275,274850,17.60643,1561077
934,CobraFlow,43,0.00275,274893,17.60919,1561077
935,djesionek,43,0.00275,274936,17.61194,1561077
936,GwonsooLee,43,0.00275,274979,17.61470,1561077
937,HPEbot,43,0.00275,275022,17.61745,1561077
938,hrvolapeter,43,0.00275,275065,17.62021,1561077
939,JamieChe,43,0.00275,275108,17.62296,1561077
940,kpyamasaki,43,0.00275,275151,17.62572,1561077
941,ldirz80,43,0.00275,275194,17.62847,1561077
942,LizGaudet,43,0.00275,275237,17.63123,1561077
943,michaelawyu,43,0.00275,275280,17.63398,1561077
944,nagasree9,43,0.00275,275323,17.63673,1561077
945,NorseGaud,43,0.00275,275366,17.63949,1561077
946,riltsken,43,0.00275,275409,17.64224,1561077
947,scddev,43,0.00275,275452,17.64500,1561077
948,sdoxsee,43,0.00275,275495,17.64775,1561077
949,sebastienbonami,43,0.00275,275538,17.65051,1561077
950,shchukax,43,0.00275,275581,17.65326,1561077
951,Skiepp,43,0.00275,275624,17.65602,1561077
952,vijay-sapient,43,0.00275,275667,17.65877,1561077
953,vodriemf,43,0.00275,275710,17.66152,1561077
954,yogeshlonkar,43,0.00275,275753,17.66428,1561077
955,zstyblik,43,0.00275,275796,17.66703,1561077
956,95jonpet,42,0.00269,275838,17.66972,1561077
957,Alex-Vol-SV,42,0.00269,275880,17.67241,1561077
958,andreafy,42,0.00269,275922,17.67511,1561077
959,chris-h-phillips,42,0.00269,275964,17.67780,1561077
960,diorcety,42,0.00269,276006,17.68049,1561077
961,fabiotcunha28,42,0.00269,276048,17.68318,1561077
962,joebertj,42,0.00269,276090,17.68587,1561077
963,keremozben-invicti,42,0.00269,276132,17.68856,1561077
964,kprasadpvv,42,0.00269,276174,17.69125,1561077
965,MA9521,42,0.00269,276216,17.69394,1561077
966,madelaney,42,0.00269,276258,17.69663,1561077
967,michael1010,42,0.00269,276300,17.69932,1561077
968,nzin-appdirect,42,0.00269,276342,17.70201,1561077
969,pit3k,42,0.00269,276384,17.70470,1561077
970,ripclawffb,42,0.00269,276426,17.70739,1561077
971,rklaren,42,0.00269,276468,17.71008,1561077
972,shahnewazrifat,42,0.00269,276510,17.71277,1561077
973,sugonyak,42,0.00269,276552,17.71546,1561077
974,tlusk,42,0.00269,276594,17.71815,1561077
975,usmonster,42,0.00269,276636,17.72084,1561077
976,yzainee,42,0.00269,276678,17.72353,1561077
977,amoluipath,41,0.00263,276719,17.72616,1561077
978,amsin02,41,0.00263,276760,17.72879,1561077
979,evandy0,41,0.00263,276801,17.73141,1561077
980,ianwilliams1,41,0.00263,276842,17.73404,1561077
981,imvijay2007,41,0.00263,276883,17.73667,1561077
982,JordanGoasdoue,41,0.00263,276924,17.73929,1561077
983,Keerthan22,41,0.00263,276965,17.74192,1561077
984,kumbasar,41,0.00263,277006,17.74454,1561077
985,lakshmishreea122003,41,0.00263,277047,17.74717,1561077
986,Marimoiro,41,0.00263,277088,17.74980,1561077
987,McFoggy,41,0.00263,277129,17.75242,1561077
988,pjhampton,41,0.00263,277170,17.75505,1561077
989,Schattensilber,41,0.00263,277211,17.75768,1561077
990,sworisbreathing,41,0.00263,277252,17.76030,1561077
991,vtintillier,41,0.00263,277293,17.76293,1561077
992,willwh,41,0.00263,277334,17.76556,1561077
993,balldarrens,40,0.00256,277374,17.76812,1561077
994,bigscoop,40,0.00256,277414,17.77068,1561077
995,bstopp,40,0.00256,277454,17.77324,1561077
996,danielomoto,40,0.00256,277494,17.77580,1561077
997,Fatme,40,0.00256,277534,17.77837,1561077
998,gone-skiing,40,0.00256,277574,17.78093,1561077
999,isanych,40,0.00256,277614,17.78349,1561077
1000,jjohannes,40,0.00256,277654,17.78605,1561077
1001,linan607,40,0.00256,277694,17.78862,1561077
1002,Lucas-C,40,0.00256,277734,17.79118,1561077
1003,mallowlabs,40,0.00256,277774,17.79374,1561077
1004,matthiasbalke,40,0.00256,277814,17.79630,1561077
1005,meliske,40,0.00256,277854,17.79887,1561077
1006,mflis,40,0.00256,277894,17.80143,1561077
1007,mrdailey99,40,0.00256,277934,17.80399,1561077
1008,nisanharamati,40,0.00256,277974,17.80655,1561077
1009,pedrohdz,40,0.00256,278014,17.80912,1561077
1010,PhilippStraubinger,40,0.00256,278054,17.81168,1561077
1011,sams-gleb,40,0.00256,278094,17.81424,1561077
1012,soleverxu,40,0.00256,278134,17.81680,1561077
1013,sunweisheng,40,0.00256,278174,17.81936,1561077
1014,taleodor,40,0.00256,278214,17.82193,1561077
1015,alex-iotiq,39,0.00250,278253,17.82443,1561077
1016,angelman,39,0.00250,278292,17.82692,1561077
1017,beebird,39,0.00250,278331,17.82942,1561077
1018,cdbkr,39,0.00250,278370,17.83192,1561077
1019,gayathrirajendar,39,0.00250,278409,17.83442,1561077
1020,godfath3r,39,0.00250,278448,17.83692,1561077
1021,gsimwat,39,0.00250,278487,17.83941,1561077
1022,hampusjohansson1,39,0.00250,278526,17.84191,1561077
1023,henryborchers,39,0.00250,278565,17.84441,1561077
1024,holmesb,39,0.00250,278604,17.84691,1561077
1025,huuphuc,39,0.00250,278643,17.84941,1561077
1026,itsbrugu,39,0.00250,278682,17.85191,1561077
1027,kmaehashi,39,0.00250,278721,17.85440,1561077
1028,lastverb,39,0.00250,278760,17.85690,1561077
1029,msulland,39,0.00250,278799,17.85940,1561077
1030,pbuckley4192,39,0.00250,278838,17.86190,1561077
1031,wawanawna,39,0.00250,278877,17.86440,1561077
1032,wwuck,39,0.00250,278916,17.86690,1561077
1033,abannachZen,38,0.00243,278954,17.86933,1561077
1034,abishek3876,38,0.00243,278992,17.87176,1561077
1035,alex25555,38,0.00243,279030,17.87420,1561077
1036,bcornils,38,0.00243,279068,17.87663,1561077
1037,bensagi,38,0.00243,279106,17.87907,1561077
1038,bgvozdev,38,0.00243,279144,17.88150,1561077
1039,bhoffman20,38,0.00243,279182,17.88394,1561077
1040,Bortulev,38,0.00243,279220,17.88637,1561077
1041,CarlesCapdevila,38,0.00243,279258,17.88880,1561077
1042,cynthiax,38,0.00243,279296,17.89124,1561077
1043,dnadolny,38,0.00243,279334,17.89367,1561077
1044,donkaes,38,0.00243,279372,17.89611,1561077
1045,DrWadsy,38,0.00243,279410,17.89854,1561077
1046,elmsdata,38,0.00243,279448,17.90097,1561077
1047,eplodn,38,0.00243,279486,17.90341,1561077
1048,Fengtan,38,0.00243,279524,17.90584,1561077
1049,FnTm,38,0.00243,279562,17.90828,1561077
1050,hazzik,38,0.00243,279600,17.91071,1561077
1051,hectoralicea,38,0.00243,279638,17.91315,1561077
1052,jjxxs,38,0.00243,279676,17.91558,1561077
1053,johncblandii,38,0.00243,279714,17.91801,1561077
1054,Jouda-Hidri,38,0.00243,279752,17.92045,1561077
1055,klydem11,38,0.00243,279790,17.92288,1561077
1056,Mahmoudgalalz,38,0.00243,279828,17.92532,1561077
1057,mherro-oak9,38,0.00243,279866,17.92775,1561077
1058,nestoracunablanco,38,0.00243,279904,17.93019,1561077
1059,paulvi,38,0.00243,279942,17.93262,1561077
1060,pvandervelde,38,0.00243,279980,17.93505,1561077
1061,rnapoles-tktn,38,0.00243,280018,17.93749,1561077
1062,salluvada,38,0.00243,280056,17.93992,1561077
1063,SmallTestHQ,38,0.00243,280094,17.94236,1561077
1064,stevebillings,38,0.00243,280132,17.94479,1561077
1065,stochmial,38,0.00243,280170,17.94722,1561077
1066,tanmoyguha-hcl,38,0.00243,280208,17.94966,1561077
1067,vaibhavjain2,38,0.00243,280246,17.95209,1561077
1068,vlsi,38,0.00243,280284,17.95453,1561077
1069,Waterstraal,38,0.00243,280322,17.95696,1561077
1070,ziheng,38,0.00243,280360,17.95940,1561077
1071,zzguang520,38,0.00243,280398,17.96183,1561077
1072,AayushSaini101,37,0.00237,280435,17.96420,1561077
1073,alexsedova,37,0.00237,280472,17.96657,1561077
1074,bastiandoetsch,37,0.00237,280509,17.96894,1561077
1075,bittrance,37,0.00237,280546,17.97131,1561077
1076,brianjmurrell,37,0.00237,280583,17.97368,1561077
1077,d3camp0s,37,0.00237,280620,17.97605,1561077
1078,djansons-atlassian,37,0.00237,280657,17.97842,1561077
1079,dpd90,37,0.00237,280694,17.98079,1561077
1080,EugeneLesnov,37,0.00237,280731,17.98316,1561077
1081,ghannamz,37,0.00237,280768,17.98553,1561077
1082,gutschet,37,0.00237,280805,17.98790,1561077
1083,Harguer,37,0.00237,280842,17.99027,1561077
1084,harikumarks,37,0.00237,280879,17.99264,1561077
1085,hinman55,37,0.00237,280916,17.99501,1561077
1086,hk-vmg,37,0.00237,280953,17.99738,1561077
1087,hoshsadiq,37,0.00237,280990,17.99975,1561077
1088,imoutsatsos,37,0.00237,281027,18.00212,1561077
1089,insightvmci-r7,37,0.00237,281064,18.00449,1561077
1090,ivanphdz,37,0.00237,281101,18.00686,1561077
1091,jcrben,37,0.00237,281138,18.00923,1561077
1092,joppa27,37,0.00237,281175,18.01160,1561077
1093,josephakayesi,37,0.00237,281212,18.01397,1561077
1094,juanpabloprado,37,0.00237,281249,18.01634,1561077
1095,jwillemsen,37,0.00237,281286,18.01871,1561077
1096,kevinfealey,37,0.00237,281323,18.02108,1561077
1097,krische,37,0.00237,281360,18.02345,1561077
1098,oyvindlr,37,0.00237,281397,18.02582,1561077
1099,qacwnfq,37,0.00237,281434,18.02819,1561077
1100,ramapokuri,37,0.00237,281471,18.03056,1561077
1101,red8888,37,0.00237,281508,18.03293,1561077
1102,ritikbanger,37,0.00237,281545,18.03531,1561077
1103,robincsmith,37,0.00237,281582,18.03768,1561077
1104,ryneal,37,0.00237,281619,18.04005,1561077
1105,sldevopsd,37,0.00237,281656,18.04242,1561077
1106,slim-patchy,37,0.00237,281693,18.04479,1561077
1107,synhal,37,0.00237,281730,18.04716,1561077
1108,tneer,37,0.00237,281767,18.04953,1561077
1109,aasat,36,0.00231,281803,18.05183,1561077
1110,akhil97,36,0.00231,281839,18.05414,1561077
1111,anupmpatil,36,0.00231,281875,18.05644,1561077
1112,bahetiamit,36,0.00231,281911,18.05875,1561077
1113,balazstarint,36,0.00231,281947,18.06106,1561077
1114,ChrisCanCompute,36,0.00231,281983,18.06336,1561077
1115,gcuisinier,36,0.00231,282019,18.06567,1561077
1116,HEZI0427,36,0.00231,282055,18.06797,1561077
1117,imdurgadas,36,0.00231,282091,18.07028,1561077
1118,itisaby,36,0.00231,282127,18.07259,1561077
1119,jippi,36,0.00231,282163,18.07489,1561077
1120,jparsai,36,0.00231,282199,18.07720,1561077
1121,jppetrakis,36,0.00231,282235,18.07951,1561077
1122,Larzack,36,0.00231,282271,18.08181,1561077
1123,Opa-,36,0.00231,282307,18.08412,1561077
1124,proxxz,36,0.00231,282343,18.08642,1561077
1125,rathaya,36,0.00231,282379,18.08873,1561077
1126,rjaiswal180,36,0.00231,282415,18.09104,1561077
1127,rkeithhill,36,0.00231,282451,18.09334,1561077
1128,samjoe9998,36,0.00231,282487,18.09565,1561077
1129,skalle,36,0.00231,282523,18.09795,1561077
1130,stephenliang,36,0.00231,282559,18.10026,1561077
1131,swesteme,36,0.00231,282595,18.10257,1561077
1132,taechonkim,36,0.00231,282631,18.10487,1561077
1133,wuillaum,36,0.00231,282667,18.10718,1561077
1134,x10an14,36,0.00231,282703,18.10948,1561077
1135,aleEspinosaM,35,0.00224,282738,18.11173,1561077
1136,alikrc,35,0.00224,282773,18.11397,1561077
1137,Andne,35,0.00224,282808,18.11621,1561077
1138,anenviousguest,35,0.00224,282843,18.11845,1561077
1139,apogrebnyak,35,0.00224,282878,18.12069,1561077
1140,candrews,35,0.00224,282913,18.12294,1561077
1141,ccHanibal,35,0.00224,282948,18.12518,1561077
1142,danilina-wsib,35,0.00224,282983,18.12742,1561077
1143,delanAtMergebase,35,0.00224,283018,18.12966,1561077
1144,DreierF,35,0.00224,283053,18.13191,1561077
1145,dwest-netflix,35,0.00224,283088,18.13415,1561077
1146,gbonnefille,35,0.00224,283123,18.13639,1561077
1147,hatati,35,0.00224,283158,18.13863,1561077
1148,ilons,35,0.00224,283193,18.14087,1561077
1149,itaibh,35,0.00224,283228,18.14312,1561077
1150,leonard84,35,0.00224,283263,18.14536,1561077
1151,madhusarma,35,0.00224,283298,18.14760,1561077
1152,majdmah,35,0.00224,283333,18.14984,1561077
1153,MindaugasLaganeckas,35,0.00224,283368,18.15208,1561077
1154,miniOrangeDev,35,0.00224,283403,18.15433,1561077
1155,reveurguy,35,0.00224,283438,18.15657,1561077
1156,stevenzimmer,35,0.00224,283473,18.15881,1561077
1157,stuposluns,35,0.00224,283508,18.16105,1561077
1158,Wilkhu90,35,0.00224,283543,18.16329,1561077
1159,xwz123,35,0.00224,283578,18.16554,1561077
1160,xxyy,35,0.00224,283613,18.16778,1561077
1161,yeulih,35,0.00224,283648,18.17002,1561077
1162,yude98,35,0.00224,283683,18.17226,1561077
1163,zacharyljones,35,0.00224,283718,18.17450,1561077
1164,zztalker,35,0.00224,283753,18.17675,1561077
1165,956081712,34,0.00218,283787,18.17892,1561077
1166,ckadner,34,0.00218,283821,18.18110,1561077
1167,ckearney-r7,34,0.00218,283855,18.18328,1561077
1168,CzapBran,34,0.00218,283889,18.18546,1561077
1169,defensics-oss,34,0.00218,283923,18.18764,1561077
1170,dmart,34,0.00218,283957,18.18981,1561077
1171,emkaysathyan,34,0.00218,283991,18.19199,1561077
1172,estarter,34,0.00218,284025,18.19417,1561077
1173,foxtrot9,34,0.00218,284059,18.19635,1561077
1174,gregjones,34,0.00218,284093,18.19853,1561077
1175,guptaprakhariitr,34,0.00218,284127,18.20070,1561077
1176,hawky-4s-,34,0.00218,284161,18.20288,1561077
1177,ianfixes,34,0.00218,284195,18.20506,1561077
1178,IBA-mainframe-dev,34,0.00218,284229,18.20724,1561077
1179,JanGu-TT,34,0.00218,284263,18.20942,1561077
1180,jsmith-cb,34,0.00218,284297,18.21159,1561077
1181,lzeee,34,0.00218,284331,18.21377,1561077
1182,margaritalm,34,0.00218,284365,18.21595,1561077
1183,meowlomoDevelopment,34,0.00218,284399,18.21813,1561077
1184,mpfeiffermway,34,0.00218,284433,18.22031,1561077
1185,mthak,34,0.00218,284467,18.22248,1561077
1186,nishpa214,34,0.00218,284501,18.22466,1561077
1187,olegfeferman,34,0.00218,284535,18.22684,1561077
1188,randomnoise,34,0.00218,284569,18.22902,1561077
1189,RCFans,34,0.00218,284603,18.23120,1561077
1190,shruthi-venkateswaran,34,0.00218,284637,18.23337,1561077
1191,sofyai,34,0.00218,284671,18.23555,1561077
1192,srehmanproov,34,0.00218,284705,18.23773,1561077
1193,vjda,34,0.00218,284739,18.23991,1561077
1194,vovtz,34,0.00218,284773,18.24209,1561077
1195,zhan9san,34,0.00218,284807,18.24426,1561077
1196,andrewvaughanj,33,0.00211,284840,18.24638,1561077
1197,arunpandurangan,33,0.00211,284873,18.24849,1561077
1198,benh222,33,0.00211,284906,18.25061,1561077
1199,bthompson0,33,0.00211,284939,18.25272,1561077
1200,cjbush,33,0.00211,284972,18.25483,1561077
1201,deepanshnagaria,33,0.00211,285005,18.25695,1561077
1202,esuc4se,33,0.00211,285038,18.25906,1561077
1203,fowlie,33,0.00211,285071,18.26117,1561077
1204,GeorgeCimpoies,33,0.00211,285104,18.26329,1561077
1205,gregberns,33,0.00211,285137,18.26540,1561077
1206,hamzaamin1,33,0.00211,285170,18.26752,1561077
1207,IdanAtzmon,33,0.00211,285203,18.26963,1561077
1208,itfsw,33,0.00211,285236,18.27174,1561077
1209,jbrejner,33,0.00211,285269,18.27386,1561077
1210,j-luong,33,0.00211,285302,18.27597,1561077
1211,junibutler,33,0.00211,285335,18.27809,1561077
1212,mateuszpodraza,33,0.00211,285368,18.28020,1561077
1213,MCMicS,33,0.00211,285401,18.28231,1561077
1214,msymons,33,0.00211,285434,18.28443,1561077
1215,naveennvrgup,33,0.00211,285467,18.28654,1561077
1216,ndsistsys,33,0.00211,285500,18.28866,1561077
1217,PayBas,33,0.00211,285533,18.29077,1561077
1218,philsttr,33,0.00211,285566,18.29288,1561077
1219,pteichner,33,0.00211,285599,18.29500,1561077
1220,raghunandanbs,33,0.00211,285632,18.29711,1561077
1221,reethikprasad,33,0.00211,285665,18.29923,1561077
1222,RoyalSloth,33,0.00211,285698,18.30134,1561077
1223,russdeluca,33,0.00211,285731,18.30345,1561077
1224,ruthnaebeck,33,0.00211,285764,18.30557,1561077
1225,sankethpb,33,0.00211,285797,18.30768,1561077
1226,sergueik,33,0.00211,285830,18.30980,1561077
1227,shamlymhd,33,0.00211,285863,18.31191,1561077
1228,silent-snowman,33,0.00211,285896,18.31402,1561077
1229,theirix,33,0.00211,285929,18.31614,1561077
1230,tmajumda1,33,0.00211,285962,18.31825,1561077
1231,westarne,33,0.00211,285995,18.32036,1561077
1232,yatin-panw,33,0.00211,286028,18.32248,1561077
1233,yrsurya,33,0.00211,286061,18.32459,1561077
1234,aiotcms,32,0.00205,286093,18.32664,1561077
1235,alhuizenga,32,0.00205,286125,18.32869,1561077
1236,anafke,32,0.00205,286157,18.33074,1561077
1237,andrei-bitca-dc,32,0.00205,286189,18.33279,1561077
1238,ankurkumarz,32,0.00205,286221,18.33484,1561077
1239,assisblf,32,0.00205,286253,18.33689,1561077
1240,axmetishe,32,0.00205,286285,18.33894,1561077
1241,azurebatch,32,0.00205,286317,18.34099,1561077
1242,bbrina,32,0.00205,286349,18.34304,1561077
1243,bertjwregeer,32,0.00205,286381,18.34509,1561077
1244,chrisalbrecht,32,0.00205,286413,18.34714,1561077
1245,cpwc,32,0.00205,286445,18.34919,1561077
1246,dmitryyu,32,0.00205,286477,18.35124,1561077
1247,dorismeixing,32,0.00205,286509,18.35329,1561077
1248,emizell,32,0.00205,286541,18.35534,1561077
1249,goganchic,32,0.00205,286573,18.35739,1561077
1250,guitcastro,32,0.00205,286605,18.35944,1561077
1251,gulyaev13,32,0.00205,286637,18.36149,1561077
1252,hitesh22,32,0.00205,286669,18.36354,1561077
1253,hschaeidt,32,0.00205,286701,18.36559,1561077
1254,isparkes,32,0.00205,286733,18.36764,1561077
1255,jkomoda,32,0.00205,286765,18.36969,1561077
1256,karthikjeeyar,32,0.00205,286797,18.37174,1561077
1257,kevinjswinton,32,0.00205,286829,18.37379,1561077
1258,lknite,32,0.00205,286861,18.37584,1561077
1259,lmwang,32,0.00205,286893,18.37789,1561077
1260,mattiasb,32,0.00205,286925,18.37994,1561077
1261,metri,32,0.00205,286957,18.38199,1561077
1262,MichaelManz,32,0.00205,286989,18.38404,1561077
1263,migger,32,0.00205,287021,18.38609,1561077
1264,msldn,32,0.00205,287053,18.38814,1561077
1265,nigelarmstrong-bc,32,0.00205,287085,18.39019,1561077
1266,opx3,32,0.00205,287117,18.39224,1561077
1267,papi83dm,32,0.00205,287149,18.39429,1561077
1268,peppelan,32,0.00205,287181,18.39634,1561077
1269,rajesh-testsigma,32,0.00205,287213,18.39839,1561077
1270,rbadillo,32,0.00205,287245,18.40044,1561077
1271,rompic,32,0.00205,287277,18.40249,1561077
1272,ryu1kn,32,0.00205,287309,18.40454,1561077
1273,sirigithub,32,0.00205,287341,18.40659,1561077
1274,soasta-ltyler,32,0.00205,287373,18.40864,1561077
1275,tdraebing,32,0.00205,287405,18.41069,1561077
1276,TedGelpi,32,0.00205,287437,18.41274,1561077
1277,toranainc,32,0.00205,287469,18.41479,1561077
1278,UlrichEckhardt,32,0.00205,287501,18.41684,1561077
1279,vaimr,32,0.00205,287533,18.41889,1561077
1280,vdoo-connected-trust-oper,32,0.00205,287565,18.42094,1561077
1281,waciumawanjohi,32,0.00205,287597,18.42299,1561077
1282,williamlfish,32,0.00205,287629,18.42504,1561077
1283,Z3r0Sum,32,0.00205,287661,18.42709,1561077
1284,6543,31,0.00199,287692,18.42907,1561077
1285,aditya-qualys,31,0.00199,287723,18.43106,1561077
1286,Artmorse,31,0.00199,287754,18.43304,1561077
1287,ayushk048-Ajmera,31,0.00199,287785,18.43503,1561077
1288,bmaehr,31,0.00199,287816,18.43701,1561077
1289,bplump,31,0.00199,287847,18.43900,1561077
1290,cburroughs,31,0.00199,287878,18.44099,1561077
1291,colourmeamused,31,0.00199,287909,18.44297,1561077
1292,davidho0403,31,0.00199,287940,18.44496,1561077
1293,ec2ainun,31,0.00199,287971,18.44694,1561077
1294,ederst,31,0.00199,288002,18.44893,1561077
1295,estebangarcia,31,0.00199,288033,18.45092,1561077
1296,GAyan17,31,0.00199,288064,18.45290,1561077
1297,GitHub-Action,31,0.00199,288095,18.45489,1561077
1298,haleyw,31,0.00199,288126,18.45687,1561077
1299,harshitvasu,31,0.00199,288157,18.45886,1561077
1300,jdelnano,31,0.00199,288188,18.46084,1561077
1301,JustABunchOfCode,31,0.00199,288219,18.46283,1561077
1302,leandro-lucarella-sociomantic,31,0.00199,288250,18.46482,1561077
1303,MarioFuchsTT,31,0.00199,288281,18.46680,1561077
1304,Max-Serra,31,0.00199,288312,18.46879,1561077
1305,michaelgrosser,31,0.00199,288343,18.47077,1561077
1306,mortenkri,31,0.00199,288374,18.47276,1561077
1307,moshavnik,31,0.00199,288405,18.47475,1561077
1308,mum-viadee,31,0.00199,288436,18.47673,1561077
1309,nekator,31,0.00199,288467,18.47872,1561077
1310,nitz88,31,0.00199,288498,18.48070,1561077
1311,onemanbucket,31,0.00199,288529,18.48269,1561077
1312,peRFectBeliever,31,0.00199,288560,18.48467,1561077
1313,Peter-Darton-i2,31,0.00199,288591,18.48666,1561077
1314,peter-poki,31,0.00199,288622,18.48865,1561077
1315,qabuild,31,0.00199,288653,18.49063,1561077
1316,robertdavis789,31,0.00199,288684,18.49262,1561077
1317,Sauraus,31,0.00199,288715,18.49460,1561077
1318,shengyu,31,0.00199,288746,18.49659,1561077
1319,sixtyeight,31,0.00199,288777,18.49858,1561077
1320,Skisocks,31,0.00199,288808,18.50056,1561077
1321,SOFYDEVELOPER,31,0.00199,288839,18.50255,1561077
1322,vluoto,31,0.00199,288870,18.50453,1561077
1323,ximbal,31,0.00199,288901,18.50652,1561077
1324,abdulbasitkay,30,0.00192,288931,18.50844,1561077
1325,abhargav-mw,30,0.00192,288961,18.51036,1561077
1326,adriengentil,30,0.00192,288991,18.51228,1561077
1327,agiletestware,30,0.00192,289021,18.51421,1561077
1328,alanromo,30,0.00192,289051,18.51613,1561077
1329,allancth,30,0.00192,289081,18.51805,1561077
1330,askalski85,30,0.00192,289111,18.51997,1561077
1331,Bananeweizen,30,0.00192,289141,18.52189,1561077
1332,bartoliniii,30,0.00192,289171,18.52381,1561077
1333,batje,30,0.00192,289201,18.52574,1561077
1334,BenjaminMalley,30,0.00192,289231,18.52766,1561077
1335,bggpoort,30,0.00192,289261,18.52958,1561077
1336,bharatpandiri,30,0.00192,289291,18.53150,1561077
1337,bromps,30,0.00192,289321,18.53342,1561077
1338,burcadoruciprian,30,0.00192,289351,18.53534,1561077
1339,chandanikumari,30,0.00192,289381,18.53727,1561077
1340,chz8494,30,0.00192,289411,18.53919,1561077
1341,ddimitrioglo,30,0.00192,289441,18.54111,1561077
1342,diridari,30,0.00192,289471,18.54303,1561077
1343,fhrbek,30,0.00192,289501,18.54495,1561077
1344,h0nIg,30,0.00192,289531,18.54688,1561077
1345,Holmistr,30,0.00192,289561,18.54880,1561077
1346,identifysun,30,0.00192,289591,18.55072,1561077
1347,idokaplan,30,0.00192,289621,18.55264,1561077
1348,ikemonn,30,0.00192,289651,18.55456,1561077
1349,ilpianista,30,0.00192,289681,18.55648,1561077
1350,IvoMiller,30,0.00192,289711,18.55841,1561077
1351,JayDVector,30,0.00192,289741,18.56033,1561077
1352,jfrabaute,30,0.00192,289771,18.56225,1561077
1353,jhahn-r7,30,0.00192,289801,18.56417,1561077
1354,jpmaida,30,0.00192,289831,18.56609,1561077
1355,liuxiaopiao,30,0.00192,289861,18.56801,1561077
1356,lpasteau,30,0.00192,289891,18.56994,1561077
1357,madchap,30,0.00192,289921,18.57186,1561077
1358,mgiamberardino,30,0.00192,289951,18.57378,1561077
1359,narayanan,30,0.00192,289981,18.57570,1561077
1360,neethapai,30,0.00192,290011,18.57762,1561077
1361,nthienan,30,0.00192,290041,18.57954,1561077
1362,patrickpichler,30,0.00192,290071,18.58147,1561077
1363,Portshift-Admin,30,0.00192,290101,18.58339,1561077
1364,Preyfix,30,0.00192,290131,18.58531,1561077
1365,ravichander82,30,0.00192,290161,18.58723,1561077
1366,raylax,30,0.00192,290191,18.58915,1561077
1367,renaud-yahoo,30,0.00192,290221,18.59108,1561077
1368,retoo,30,0.00192,290251,18.59300,1561077
1369,Ryudo302,30,0.00192,290281,18.59492,1561077
1370,snagdev4,30,0.00192,290311,18.59684,1561077
1371,stephanreiter,30,0.00192,290341,18.59876,1561077
1372,Suirtimed,30,0.00192,290371,18.60068,1561077
1373,torrescd,30,0.00192,290401,18.60261,1561077
1374,wisdomcdh,30,0.00192,290431,18.60453,1561077
1375,wsoula,30,0.00192,290461,18.60645,1561077
1376,xGhOsTkiLLeRx,30,0.00192,290491,18.60837,1561077
1377,yinanfang,30,0.00192,290521,18.61029,1561077
1378,Young-Zen,30,0.00192,290551,18.61221,1561077
1379,Ahmed-Sellami,29,0.00186,290580,18.61407,1561077
1380,akrasnov-drv,29,0.00186,290609,18.61593,1561077
1381,aleksas,29,0.00186,290638,18.61779,1561077
1382,alien-ike,29,0.00186,290667,18.61965,1561077
1383,andreizet,29,0.00186,290696,18.62150,1561077
1384,andrew-elliott,29,0.00186,290725,18.62336,1561077
1385,andrewhoplife,29,0.00186,290754,18.62522,1561077
1386,anxk,29,0.00186,290783,18.62708,1561077
1387,bachue,29,0.00186,290812,18.62893,1561077
1388,ca-stefan-cordes,29,0.00186,290841,18.63079,1561077
1389,CathalOConnorRH,29,0.00186,290870,18.63265,1561077
1390,chhex,29,0.00186,290899,18.63451,1561077
1391,cocoon-project,29,0.00186,290928,18.63636,1561077
1392,diegolovison,29,0.00186,290957,18.63822,1561077
1393,elyzion,29,0.00186,290986,18.64008,1561077
1394,gerrnot,29,0.00186,291015,18.64194,1561077
1395,glauco,29,0.00186,291044,18.64380,1561077
1396,jhasse,29,0.00186,291073,18.64565,1561077
1397,johnlongo,29,0.00186,291102,18.64751,1561077
1398,krotte1,29,0.00186,291131,18.64937,1561077
1399,krulls,29,0.00186,291160,18.65123,1561077
1400,kymair,29,0.00186,291189,18.65308,1561077
1401,limeman40,29,0.00186,291218,18.65494,1561077
1402,marian-r,29,0.00186,291247,18.65680,1561077
1403,mikesalvia,29,0.00186,291276,18.65866,1561077
1404,mochacat,29,0.00186,291305,18.66051,1561077
1405,muppet3000,29,0.00186,291334,18.66237,1561077
1406,nathandines,29,0.00186,291363,18.66423,1561077
1407,pawoolley,29,0.00186,291392,18.66609,1561077
1408,pfhyxs0,29,0.00186,291421,18.66795,1561077
1409,piomis,29,0.00186,291450,18.66980,1561077
1410,renaud-vmg,29,0.00186,291479,18.67166,1561077
1411,rnkhouse,29,0.00186,291508,18.67352,1561077
1412,shacharbz,29,0.00186,291537,18.67538,1561077
1413,shaulvalero1308,29,0.00186,291566,18.67723,1561077
1414,skumar7322,29,0.00186,291595,18.67909,1561077
1415,snalvi,29,0.00186,291624,18.68095,1561077
1416,sravankumar777,29,0.00186,291653,18.68281,1561077
1417,ssmiech,29,0.00186,291682,18.68466,1561077
1418,sstubbs,29,0.00186,291711,18.68652,1561077
1419,Stetchy,29,0.00186,291740,18.68838,1561077
1420,stevef1uk,29,0.00186,291769,18.69024,1561077
1421,testsigma-eng,29,0.00186,291798,18.69210,1561077
1422,tkisme,29,0.00186,291827,18.69395,1561077
1423,VitaliyaIoffe,29,0.00186,291856,18.69581,1561077
1424,weisslj,29,0.00186,291885,18.69767,1561077
1425,wlad031,29,0.00186,291914,18.69953,1561077
1426,abhilashjoseph,28,0.00179,291942,18.70132,1561077
1427,a-rothwell,28,0.00179,291970,18.70311,1561077
1428,buzzdeee,28,0.00179,291998,18.70491,1561077
1429,castnightlybuild,28,0.00179,292026,18.70670,1561077
1430,cegganesh84,28,0.00179,292054,18.70849,1561077
1431,chicks-net,28,0.00179,292082,18.71029,1561077
1432,chinhodado,28,0.00179,292110,18.71208,1561077
1433,cwholmes,28,0.00179,292138,18.71388,1561077
1434,danche,28,0.00179,292166,18.71567,1561077
1435,dblessing,28,0.00179,292194,18.71746,1561077
1436,dbrougham,28,0.00179,292222,18.71926,1561077
1437,dellgreen,28,0.00179,292250,18.72105,1561077
1438,diegoperini,28,0.00179,292278,18.72284,1561077
1439,ElijahLynn,28,0.00179,292306,18.72464,1561077
1440,etiennebec,28,0.00179,292334,18.72643,1561077
1441,fredcooke,28,0.00179,292362,18.72822,1561077
1442,GunArm,28,0.00179,292390,18.73002,1561077
1443,Gyanesha,28,0.00179,292418,18.73181,1561077
1444,httpsOmkar,28,0.00179,292446,18.73361,1561077
1445,jleon33,28,0.00179,292474,18.73540,1561077
1446,jlosito,28,0.00179,292502,18.73719,1561077
1447,johnlabor,28,0.00179,292530,18.73899,1561077
1448,jpigree,28,0.00179,292558,18.74078,1561077
1449,KrapivinAndrey,28,0.00179,292586,18.74257,1561077
1450,LarrySul,28,0.00179,292614,18.74437,1561077
1451,lgfausak,28,0.00179,292642,18.74616,1561077
1452,mamh2021,28,0.00179,292670,18.74795,1561077
1453,marklagendijk,28,0.00179,292698,18.74975,1561077
1454,markrekveld,28,0.00179,292726,18.75154,1561077
1455,mboudreau,28,0.00179,292754,18.75334,1561077
1456,mjosephd,28,0.00179,292782,18.75513,1561077
1457,mtcolman,28,0.00179,292810,18.75692,1561077
1458,nekoimi,28,0.00179,292838,18.75872,1561077
1459,nevermindr,28,0.00179,292866,18.76051,1561077
1460,nurupo,28,0.00179,292894,18.76230,1561077
1461,radkin,28,0.00179,292922,18.76410,1561077
1462,RedTo,28,0.00179,292950,18.76589,1561077
1463,rfarrjr,28,0.00179,292978,18.76768,1561077
1464,rmalchow,28,0.00179,293006,18.76948,1561077
1465,robinverduijn,28,0.00179,293034,18.77127,1561077
1466,samisalamiws,28,0.00179,293062,18.77307,1561077
1467,shenxianpeng,28,0.00179,293090,18.77486,1561077
1468,ShimiTaNaka,28,0.00179,293118,18.77665,1561077
1469,ssathi,28,0.00179,293146,18.77845,1561077
1470,sudiptob2,28,0.00179,293174,18.78024,1561077
1471,syamaraj,28,0.00179,293202,18.78203,1561077
1472,VisiontechGitHub,28,0.00179,293230,18.78383,1561077
1473,webminster,28,0.00179,293258,18.78562,1561077
1474,wener-tiobe,28,0.00179,293286,18.78741,1561077
1475,aendter,27,0.00173,293313,18.78914,1561077
1476,AlessandroMenti,27,0.00173,293340,18.79087,1561077
1477,alfador1,27,0.00173,293367,18.79260,1561077
1478,anxolerd,27,0.00173,293394,18.79433,1561077
1479,apetres,27,0.00173,293421,18.79606,1561077
1480,ArielExperitest,27,0.00173,293448,18.79779,1561077
1481,avdv,27,0.00173,293475,18.79952,1561077
1482,bbara,27,0.00173,293502,18.80125,1561077
1483,bgreen1005,27,0.00173,293529,18.80298,1561077
1484,buddhikac96,27,0.00173,293556,18.80471,1561077
1485,bverkron,27,0.00173,293583,18.80644,1561077
1486,callum-p,27,0.00173,293610,18.80817,1561077
1487,danielGz,27,0.00173,293637,18.80990,1561077
1488,DanielWeber,27,0.00173,293664,18.81163,1561077
1489,duranserkan,27,0.00173,293691,18.81336,1561077
1490,dylanjohnsonsfo,27,0.00173,293718,18.81509,1561077
1491,eddie4941,27,0.00173,293745,18.81682,1561077
1492,Fargk,27,0.00173,293772,18.81855,1561077
1493,freaker2k7,27,0.00173,293799,18.82028,1561077
1494,grebit,27,0.00173,293826,18.82201,1561077
1495,hchakrouun,27,0.00173,293853,18.82374,1561077
1496,Hellspam,27,0.00173,293880,18.82546,1561077
1497,i-dipanshu,27,0.00173,293907,18.82719,1561077
1498,ironcerocloudbees,27,0.00173,293934,18.82892,1561077
1499,Juboy,27,0.00173,293961,18.83065,1561077
1500,kailunc,27,0.00173,293988,18.83238,1561077
1501,KasperHeyndrickx,27,0.00173,294015,18.83411,1561077
1502,katsadim,27,0.00173,294042,18.83584,1561077
1503,kcloutie,27,0.00173,294069,18.83757,1561077
1504,KreAch3R,27,0.00173,294096,18.83930,1561077
1505,manongxiaoyun,27,0.00173,294123,18.84103,1561077
1506,menski,27,0.00173,294150,18.84276,1561077
1507,mkochofenough,27,0.00173,294177,18.84449,1561077
1508,mobangjack,27,0.00173,294204,18.84622,1561077
1509,nickveenhof,27,0.00173,294231,18.84795,1561077
1510,philowest,27,0.00173,294258,18.84968,1561077
1511,rajkdale,27,0.00173,294285,18.85141,1561077
1512,redlab,27,0.00173,294312,18.85314,1561077
1513,rinckm,27,0.00173,294339,18.85487,1561077
1514,ryanberger-az,27,0.00173,294366,18.85660,1561077
1515,sachinmaske,27,0.00173,294393,18.85833,1561077
1516,sdumitriu,27,0.00173,294420,18.86006,1561077
1517,SomaliRaven,27,0.00173,294447,18.86179,1561077
1518,Soumya-UB,27,0.00173,294474,18.86352,1561077
1519,thilina27,27,0.00173,294501,18.86524,1561077
1520,TinyCyber,27,0.00173,294528,18.86697,1561077
1521,tonyg4864,27,0.00173,294555,18.86870,1561077
1522,ugatenio,27,0.00173,294582,18.87043,1561077
1523,vikulin,27,0.00173,294609,18.87216,1561077
1524,vladshep,27,0.00173,294636,18.87389,1561077
1525,vvitayau,27,0.00173,294663,18.87562,1561077
1526,vzamoragbmc,27,0.00173,294690,18.87735,1561077
1527,wzur-r3,27,0.00173,294717,18.87908,1561077
1528,zhongjun2,27,0.00173,294744,18.88081,1561077
1529,agoyal-sfdc,26,0.00167,294770,18.88248,1561077
1530,ampuscas,26,0.00167,294796,18.88414,1561077
1531,arturo-seijas,26,0.00167,294822,18.88581,1561077
1532,bibi520,26,0.00167,294848,18.88747,1561077
1533,chestery,26,0.00167,294874,18.88914,1561077
1534,ciurescuraul,26,0.00167,294900,18.89080,1561077
1535,cx-muhammed,26,0.00167,294926,18.89247,1561077
1536,dmourati,26,0.00167,294952,18.89414,1561077
1537,dnyaneshnagre,26,0.00167,294978,18.89580,1561077
1538,faisal-hameed,26,0.00167,295004,18.89747,1561077
1539,fedepell,26,0.00167,295030,18.89913,1561077
1540,francoiscampbell,26,0.00167,295056,18.90080,1561077
1541,fsfshijm,26,0.00167,295082,18.90246,1561077
1542,g-k-r,26,0.00167,295108,18.90413,1561077
1543,glenpgillman,26,0.00167,295134,18.90579,1561077
1544,gomid,26,0.00167,295160,18.90746,1561077
1545,greenkiwi,26,0.00167,295186,18.90912,1561077
1546,guysmoilov,26,0.00167,295212,18.91079,1561077
1547,HeikoBoettger,26,0.00167,295238,18.91246,1561077
1548,jeffherald,26,0.00167,295264,18.91412,1561077
1549,joesenova,26,0.00167,295290,18.91579,1561077
1550,justinklemm,26,0.00167,295316,18.91745,1561077
1551,jzyang,26,0.00167,295342,18.91912,1561077
1552,luodongjia,26,0.00167,295368,18.92078,1561077
1553,masterhard,26,0.00167,295394,18.92245,1561077
1554,MatthiasHer,26,0.00167,295420,18.92411,1561077
1555,mfuchs,26,0.00167,295446,18.92578,1561077
1556,mmoll,26,0.00167,295472,18.92745,1561077
1557,mpkorstanje,26,0.00167,295498,18.92911,1561077
1558,mzhan-cc,26,0.00167,295524,18.93078,1561077
1559,Nagarajj,26,0.00167,295550,18.93244,1561077
1560,neaguandrei101,26,0.00167,295576,18.93411,1561077
1561,om-gupta,26,0.00167,295602,18.93577,1561077
1562,preyankababu,26,0.00167,295628,18.93744,1561077
1563,prietyc123,26,0.00167,295654,18.93910,1561077
1564,rjackson64840,26,0.00167,295680,18.94077,1561077
1565,robross0606,26,0.00167,295706,18.94244,1561077
1566,ryuzee,26,0.00167,295732,18.94410,1561077
1567,squalou,26,0.00167,295758,18.94577,1561077
1568,st8f,26,0.00167,295784,18.94743,1561077
1569,sturman,26,0.00167,295810,18.94910,1561077
1570,tknerr,26,0.00167,295836,18.95076,1561077
1571,Turiok,26,0.00167,295862,18.95243,1561077
1572,vancanhuit,26,0.00167,295888,18.95409,1561077
1573,vgallissot,26,0.00167,295914,18.95576,1561077
1574,vladaurosh,26,0.00167,295940,18.95742,1561077
1575,yashre-bh,26,0.00167,295966,18.95909,1561077
1576,adrianblynch,25,0.00160,295991,18.96069,1561077
1577,benfletcher,25,0.00160,296016,18.96229,1561077
1578,chawlabhishek,25,0.00160,296041,18.96389,1561077
1579,chr0n1x,25,0.00160,296066,18.96550,1561077
1580,ChrisA89,25,0.00160,296091,18.96710,1561077
1581,compharry,25,0.00160,296116,18.96870,1561077
1582,Crocmagnon,25,0.00160,296141,18.97030,1561077
1583,DaMutz,25,0.00160,296166,18.97190,1561077
1584,DarrenN,25,0.00160,296191,18.97350,1561077
1585,dcsobral,25,0.00160,296216,18.97511,1561077
1586,denebolar,25,0.00160,296241,18.97671,1561077
1587,dg424,25,0.00160,296266,18.97831,1561077
1588,dkozubik,25,0.00160,296291,18.97991,1561077
1589,Elisedlund-ericsson,25,0.00160,296316,18.98151,1561077
1590,F1ashhimself,25,0.00160,296341,18.98311,1561077
1591,fgs-dbudwin,25,0.00160,296366,18.98471,1561077
1592,Fixmetal,25,0.00160,296391,18.98632,1561077
1593,gabo89,25,0.00160,296416,18.98792,1561077
1594,hemuke,25,0.00160,296441,18.98952,1561077
1595,hWorblehat,25,0.00160,296466,18.99112,1561077
1596,itow0001,25,0.00160,296491,18.99272,1561077
1597,janisliepins,25,0.00160,296516,18.99432,1561077
1598,kkapelon,25,0.00160,296541,18.99592,1561077
1599,mattiassluis,25,0.00160,296566,18.99753,1561077
1600,MikeKroell,25,0.00160,296591,18.99913,1561077
1601,mkumar-quest,25,0.00160,296616,19.00073,1561077
1602,MohammadRahaman,25,0.00160,296641,19.00233,1561077
1603,ngg,25,0.00160,296666,19.00393,1561077
1604,prince-panwar,25,0.00160,296691,19.00553,1561077
1605,pzygielo,25,0.00160,296716,19.00713,1561077
1606,r-andrew-dev,25,0.00160,296741,19.00874,1561077
1607,raphaelquati,25,0.00160,296766,19.01034,1561077
1608,ricardojdsilva87,25,0.00160,296791,19.01194,1561077
1609,ryan-dyer-sp,25,0.00160,296816,19.01354,1561077
1610,saifqasa123,25,0.00160,296841,19.01514,1561077
1611,sandrinr,25,0.00160,296866,19.01674,1561077
1612,sisao,25,0.00160,296891,19.01834,1561077
1613,sodul,25,0.00160,296916,19.01995,1561077
1614,somejavadev,25,0.00160,296941,19.02155,1561077
1615,sshepel,25,0.00160,296966,19.02315,1561077
1616,swashbuck1r,25,0.00160,296991,19.02475,1561077
1617,thommy101,25,0.00160,297016,19.02635,1561077
1618,TinyZzh,25,0.00160,297041,19.02795,1561077
1619,tomerc,25,0.00160,297066,19.02955,1561077
1620,unicolet,25,0.00160,297091,19.03116,1561077
1621,VPapazyan,25,0.00160,297116,19.03276,1561077
1622,wadadli,25,0.00160,297141,19.03436,1561077
1623,weiiwang01,25,0.00160,297166,19.03596,1561077
1624,wenzlaff,25,0.00160,297191,19.03756,1561077
1625,wuzhihui1123,25,0.00160,297216,19.03916,1561077
1626,yshi-parasoft,25,0.00160,297241,19.04076,1561077
1627,amoussawi,24,0.00154,297265,19.04230,1561077
1628,ashish-thakur07,24,0.00154,297289,19.04384,1561077
1629,ba11b0y,24,0.00154,297313,19.04538,1561077
1630,babusekaran,24,0.00154,297337,19.04691,1561077
1631,c0debreaker,24,0.00154,297361,19.04845,1561077
1632,ccaspanello,24,0.00154,297385,19.04999,1561077
1633,celiawa,24,0.00154,297409,19.05153,1561077
1634,ciciya-lal,24,0.00154,297433,19.05306,1561077
1635,coignetp,24,0.00154,297457,19.05460,1561077
1636,corngood,24,0.00154,297481,19.05614,1561077
1637,csms,24,0.00154,297505,19.05768,1561077
1638,danielakua,24,0.00154,297529,19.05921,1561077
1639,Darshan174,24,0.00154,297553,19.06075,1561077
1640,DreamPWJ,24,0.00154,297577,19.06229,1561077
1641,dsteiert,24,0.00154,297601,19.06383,1561077
1642,dulvac,24,0.00154,297625,19.06536,1561077
1643,EvilBeaver,24,0.00154,297649,19.06690,1561077
1644,ggsklias,24,0.00154,297673,19.06844,1561077
1645,goettl79,24,0.00154,297697,19.06998,1561077
1646,guga4ka,24,0.00154,297721,19.07151,1561077
1647,hund030,24,0.00154,297745,19.07305,1561077
1648,ite-klass,24,0.00154,297769,19.07459,1561077
1649,JoC0de,24,0.00154,297793,19.07613,1561077
1650,jprinet,24,0.00154,297817,19.07766,1561077
1651,khalkie,24,0.00154,297841,19.07920,1561077
1652,klocwork-perforce,24,0.00154,297865,19.08074,1561077
1653,korablin,24,0.00154,297889,19.08227,1561077
1654,kudos-dude,24,0.00154,297913,19.08381,1561077
1655,kxepal,24,0.00154,297937,19.08535,1561077
1656,larshvile,24,0.00154,297961,19.08689,1561077
1657,lkraider,24,0.00154,297985,19.08842,1561077
1658,LuisPiedra,24,0.00154,298009,19.08996,1561077
1659,martijnburger,24,0.00154,298033,19.09150,1561077
1660,martin-patsov,24,0.00154,298057,19.09304,1561077
1661,maskedpirate,24,0.00154,298081,19.09457,1561077
1662,MoOyeg,24,0.00154,298105,19.09611,1561077
1663,msmagnanijr,24,0.00154,298129,19.09765,1561077
1664,MxKilian,24,0.00154,298153,19.09919,1561077
1665,ndimiduk,24,0.00154,298177,19.10072,1561077
1666,nerddelphi,24,0.00154,298201,19.10226,1561077
1667,nhmathis,24,0.00154,298225,19.10380,1561077
1668,nicky-king,24,0.00154,298249,19.10534,1561077
1669,nirud,24,0.00154,298273,19.10687,1561077
1670,parajanoff,24,0.00154,298297,19.10841,1561077
1671,pashcan,24,0.00154,298321,19.10995,1561077
1672,pavanstarmanwar,24,0.00154,298345,19.11149,1561077
1673,PhilippHomann,24,0.00154,298369,19.11302,1561077
1674,pieterza,24,0.00154,298393,19.11456,1561077
1675,polarbizzle,24,0.00154,298417,19.11610,1561077
1676,qunayu,24,0.00154,298441,19.11763,1561077
1677,raghavgarg098,24,0.00154,298465,19.11917,1561077
1678,reitzmichnicht,24,0.00154,298489,19.12071,1561077
1679,riccardoelasticbox,24,0.00154,298513,19.12225,1561077
1680,solvingj,24,0.00154,298537,19.12378,1561077
1681,stevesoaress,24,0.00154,298561,19.12532,1561077
1682,sudhirbatchu9383,24,0.00154,298585,19.12686,1561077
1683,synomtv,24,0.00154,298609,19.12840,1561077
1684,tiansworld,24,0.00154,298633,19.12993,1561077
1685,tylersmith34,24,0.00154,298657,19.13147,1561077
1686,VamanKulkarni,24,0.00154,298681,19.13301,1561077
1687,wattdave,24,0.00154,298705,19.13455,1561077
1688,zakswindow,24,0.00154,298729,19.13608,1561077
1689,11Mike11,23,0.00147,298752,19.13756,1561077
1690,abeeskau,23,0.00147,298775,19.13903,1561077
1691,Abhishekverma2002,23,0.00147,298798,19.14050,1561077
1693,amendelsohn,23,0.00147,298844,19.14345,1561077
1694,anandcpadiya,23,0.00147,298867,19.14492,1561077
1695,andrewballantyne,23,0.00147,298890,19.14640,1561077
1696,aphill70,23,0.00147,298913,19.14787,1561077
1697,Arne2,23,0.00147,298936,19.14934,1561077
1698,BillBensing,23,0.00147,298959,19.15082,1561077
1699,brycahta,23,0.00147,298982,19.15229,1561077
1700,bzzitsme,23,0.00147,299005,19.15376,1561077
1701,chrischu,23,0.00147,299028,19.15524,1561077
1702,cobexer,23,0.00147,299051,19.15671,1561077
1703,crenan,23,0.00147,299074,19.15818,1561077
1704,creste,23,0.00147,299097,19.15966,1561077
1705,crussell52,23,0.00147,299120,19.16113,1561077
1706,crwd-etatarevic,23,0.00147,299143,19.16260,1561077
1707,darkphoenix17,23,0.00147,299166,19.16408,1561077
1708,das7pad,23,0.00147,299189,19.16555,1561077
1709,ddovbii,23,0.00147,299212,19.16702,1561077
1710,disposab1e,23,0.00147,299235,19.16850,1561077
1711,DmitrySolodovnyk,23,0.00147,299258,19.16997,1561077
1712,dsaydon90,23,0.00147,299281,19.17144,1561077
1713,dskrvk,23,0.00147,299304,19.17292,1561077
1714,eaceaser,23,0.00147,299327,19.17439,1561077
1715,feg545,23,0.00147,299350,19.17586,1561077
1716,francoisfreitag,23,0.00147,299373,19.17734,1561077
1717,g-dx,23,0.00147,299396,19.17881,1561077
1718,hamidgholami,23,0.00147,299419,19.18028,1561077
1719,HCloward,23,0.00147,299442,19.18176,1561077
1720,hikkyXII,23,0.00147,299465,19.18323,1561077
1721,jalaziz,23,0.00147,299488,19.18470,1561077
1722,jbergknoff-rival,23,0.00147,299511,19.18618,1561077
1723,jensvdh,23,0.00147,299534,19.18765,1561077
1724,jmdesprez,23,0.00147,299557,19.18912,1561077
1725,joellord,23,0.00147,299580,19.19060,1561077
1726,josiahhaswell,23,0.00147,299603,19.19207,1561077
1727,KiranSatyaRaj,23,0.00147,299626,19.19354,1561077
1728,LarryNorth,23,0.00147,299649,19.19502,1561077
1729,laurentiucocanu,23,0.00147,299672,19.19649,1561077
1730,lukaskirner,23,0.00147,299695,19.19796,1561077
1731,lyenliang,23,0.00147,299718,19.19944,1561077
1732,magn2,23,0.00147,299741,19.20091,1561077
1733,maneeshmehra,23,0.00147,299764,19.20238,1561077
1734,manojbison,23,0.00147,299787,19.20386,1561077
1735,mayitbeegh,23,0.00147,299810,19.20533,1561077
1736,mbidewell,23,0.00147,299833,19.20680,1561077
1737,MrMYHuang,23,0.00147,299856,19.20828,1561077
1738,NilmaPeiris,23,0.00147,299879,19.20975,1561077
1739,npotluri-rh,23,0.00147,299902,19.21122,1561077
1740,nwton,23,0.00147,299925,19.21270,1561077
1741,ottlinger,23,0.00147,299948,19.21417,1561077
1742,ptzafrir,23,0.00147,299971,19.21564,1561077
1743,Rahaman148,23,0.00147,299994,19.21712,1561077
1744,ramimmadi,23,0.00147,300017,19.21859,1561077
1745,rishisaraf11,23,0.00147,300040,19.22006,1561077
1746,RodEsp,23,0.00147,300063,19.22154,1561077
1747,rohithmone-lt,23,0.00147,300086,19.22301,1561077
1748,ro-kr,23,0.00147,300109,19.22448,1561077
1749,rrijkse,23,0.00147,300132,19.22596,1561077
1750,sjaakvaak,23,0.00147,300155,19.22743,1561077
1751,Srinivasan0311,23,0.00147,300178,19.22890,1561077
1752,thorntonryan,23,0.00147,300201,19.23038,1561077
1753,tsonev7,23,0.00147,300224,19.23185,1561077
1754,vektory79,23,0.00147,300247,19.23332,1561077
1755,vidhithacker31,23,0.00147,300270,19.23480,1561077
1756,wutingbupt,23,0.00147,300293,19.23627,1561077
1757,xB-2048,23,0.00147,300316,19.23774,1561077
1758,yejingtao,23,0.00147,300339,19.23922,1561077
1759,ygge,23,0.00147,300362,19.24069,1561077
1760,2012ucp1544,22,0.00141,300384,19.24210,1561077
1761,acunetix360dev,22,0.00141,300406,19.24351,1561077
1762,ajp-lqx,22,0.00141,300428,19.24492,1561077
1763,alannix-lw,22,0.00141,300450,19.24633,1561077
1764,AlexejK,22,0.00141,300472,19.24774,1561077
1765,alexeyOnGitHub,22,0.00141,300494,19.24915,1561077
1766,anandbhagwat,22,0.00141,300516,19.25056,1561077
1767,AndreaCrotti,22,0.00141,300538,19.25197,1561077
1768,andytinkham,22,0.00141,300560,19.25337,1561077
1769,antdking,22,0.00141,300582,19.25478,1561077
1770,ao-apps,22,0.00141,300604,19.25619,1561077
1771,aravindmetku,22,0.00141,300626,19.25760,1561077
1772,arunvel1988,22,0.00141,300648,19.25901,1561077
1773,Asgoret,22,0.00141,300670,19.26042,1561077
1774,bbreijer,22,0.00141,300692,19.26183,1561077
1775,bhecquet,22,0.00141,300714,19.26324,1561077
1776,bmaximuml,22,0.00141,300736,19.26465,1561077
1777,bootstraponline,22,0.00141,300758,19.26606,1561077
1778,bsmoyers,22,0.00141,300780,19.26747,1561077
1779,cah-lawrence-kaufman,22,0.00141,300802,19.26888,1561077
1780,ciprianmorosanu,22,0.00141,300824,19.27029,1561077
1781,damienfinck,22,0.00141,300846,19.27170,1561077
1782,datallah,22,0.00141,300868,19.27310,1561077
1783,dblanchette,22,0.00141,300890,19.27451,1561077
1784,delabiejochen,22,0.00141,300912,19.27592,1561077
1785,dwighthubbard,22,0.00141,300934,19.27733,1561077
1786,ebrahim-moshaya,22,0.00141,300956,19.27874,1561077
1787,error418,22,0.00141,300978,19.28015,1561077
1788,eugenyk,22,0.00141,301000,19.28156,1561077
1789,GavinF17,22,0.00141,301022,19.28297,1561077
1790,gblikegroupon,22,0.00141,301044,19.28438,1561077
1791,ggeorgiev,22,0.00141,301066,19.28579,1561077
1792,glavoie,22,0.00141,301088,19.28720,1561077
1793,goat023,22,0.00141,301110,19.28861,1561077
1794,gsapkal,22,0.00141,301132,19.29002,1561077
1795,hostedvideorn,22,0.00141,301154,19.29143,1561077
1796,issc29,22,0.00141,301176,19.29283,1561077
1797,jaheikki,22,0.00141,301198,19.29424,1561077
1798,jasoncoffman,22,0.00141,301220,19.29565,1561077
1799,jkolash,22,0.00141,301242,19.29706,1561077
1800,JKrag,22,0.00141,301264,19.29847,1561077
1801,jonaslind,22,0.00141,301286,19.29988,1561077
1802,jonatin,22,0.00141,301308,19.30129,1561077
1803,jtdawso,22,0.00141,301330,19.30270,1561077
1804,karenlynch,22,0.00141,301352,19.30411,1561077
1805,kenrachynski,22,0.00141,301374,19.30552,1561077
1806,leemeador,22,0.00141,301396,19.30693,1561077
1807,lineville,22,0.00141,301418,19.30834,1561077
1808,luisgonzalex,22,0.00141,301440,19.30975,1561077
1809,lukasova,22,0.00141,301462,19.31116,1561077
1810,lukzeg,22,0.00141,301484,19.31256,1561077
1811,marcusphi,22,0.00141,301506,19.31397,1561077
1812,masooh,22,0.00141,301528,19.31538,1561077
1813,mazimkhan,22,0.00141,301550,19.31679,1561077
1814,mgaunin,22,0.00141,301572,19.31820,1561077
1815,mschmidae,22,0.00141,301594,19.31961,1561077
1816,nullify005,22,0.00141,301616,19.32102,1561077
1817,oahayder,22,0.00141,301638,19.32243,1561077
1818,popasquat89,22,0.00141,301660,19.32384,1561077
1819,PrathamAditya,22,0.00141,301682,19.32525,1561077
1820,quasarea,22,0.00141,301704,19.32666,1561077
1821,rbini,22,0.00141,301726,19.32807,1561077
1822,roadrunner2,22,0.00141,301748,19.32948,1561077
1823,rpau,22,0.00141,301770,19.33089,1561077
1824,rudolph9,22,0.00141,301792,19.33229,1561077
1825,rushins,22,0.00141,301814,19.33370,1561077
1826,rutviklhase,22,0.00141,301836,19.33511,1561077
1827,sboyd-synopsys,22,0.00141,301858,19.33652,1561077
1828,Simplify3x,22,0.00141,301880,19.33793,1561077
1829,snorlaX-sleeps,22,0.00141,301902,19.33934,1561077
1830,spirentitestdevter,22,0.00141,301924,19.34075,1561077
1831,spstarr,22,0.00141,301946,19.34216,1561077
1832,stevengssns,22,0.00141,301968,19.34357,1561077
1833,SunBlack,22,0.00141,301990,19.34498,1561077
1834,suryanarayanan,22,0.00141,302012,19.34639,1561077
1835,ugurkany,22,0.00141,302034,19.34780,1561077
1836,uvoigt,22,0.00141,302056,19.34921,1561077
1837,vide,22,0.00141,302078,19.35061,1561077
1838,vidyajothiraman,22,0.00141,302100,19.35202,1561077
1839,WakeupTsai,22,0.00141,302122,19.35343,1561077
1840,whaph,22,0.00141,302144,19.35484,1561077
1841,yaming116,22,0.00141,302166,19.35625,1561077
1842,young-s-park,22,0.00141,302188,19.35766,1561077
1843,yzhan289,22,0.00141,302210,19.35907,1561077
1844,0xcfff,21,0.00135,302231,19.36042,1561077
1845,AceMedia,21,0.00135,302252,19.36176,1561077
1846,aditi-rajawat,21,0.00135,302273,19.36311,1561077
1847,adjika,21,0.00135,302294,19.36445,1561077
1848,ahmed-musallam,21,0.00135,302315,19.36580,1561077
1849,ajrussellsap,21,0.00135,302336,19.36714,1561077
1850,AkroutiHamza,21,0.00135,302357,19.36849,1561077
1851,alitet01,21,0.00135,302378,19.36983,1561077
1852,amhaskePTC,21,0.00135,302399,19.37118,1561077
1853,amoreno-sonatype,21,0.00135,302420,19.37252,1561077
1854,bagipro,21,0.00135,302441,19.37387,1561077
1855,base698,21,0.00135,302462,19.37521,1561077
1856,bphinz,21,0.00135,302483,19.37656,1561077
1857,calvinpark,21,0.00135,302504,19.37790,1561077
1858,celamb4,21,0.00135,302525,19.37925,1561077
1859,CharlieTLe,21,0.00135,302546,19.38059,1561077
1860,darkalia,21,0.00135,302567,19.38194,1561077
1861,daviddyball,21,0.00135,302588,19.38328,1561077
1862,dimabru,21,0.00135,302609,19.38463,1561077
1863,DJCoding,21,0.00135,302630,19.38598,1561077
1864,doc-olliday,21,0.00135,302651,19.38732,1561077
1865,domdop,21,0.00135,302672,19.38867,1561077
1866,enkicoma,21,0.00135,302693,19.39001,1561077
1867,Fiouz,21,0.00135,302714,19.39136,1561077
1868,guillermo-varela,21,0.00135,302735,19.39270,1561077
1869,gurumaia,21,0.00135,302756,19.39405,1561077
1870,Horst-Krause,21,0.00135,302777,19.39539,1561077
1871,HSDeshpande,21,0.00135,302798,19.39674,1561077
1872,isaacsatish,21,0.00135,302819,19.39808,1561077
1873,itaior,21,0.00135,302840,19.39943,1561077
1874,itay-kirshenboim,21,0.00135,302861,19.40077,1561077
1875,ivarmu,21,0.00135,302882,19.40212,1561077
1876,jasonkshar,21,0.00135,302903,19.40346,1561077
1877,Javailabe,21,0.00135,302924,19.40481,1561077
1878,jbq,21,0.00135,302945,19.40615,1561077
1879,jfroche,21,0.00135,302966,19.40750,1561077
1880,jorgenpt,21,0.00135,302987,19.40884,1561077
1881,kanhadharmikk,21,0.00135,303008,19.41019,1561077
1882,karlomendozaarmory,21,0.00135,303029,19.41153,1561077
1883,kauppfbi,21,0.00135,303050,19.41288,1561077
1884,keesj-exset,21,0.00135,303071,19.41422,1561077
1885,kenji21,21,0.00135,303092,19.41557,1561077
1886,khneal,21,0.00135,303113,19.41692,1561077
1887,kurddt,21,0.00135,303134,19.41826,1561077
1888,lcharlois-neotys,21,0.00135,303155,19.41961,1561077
1889,lion7,21,0.00135,303176,19.42095,1561077
1890,matthack,21,0.00135,303197,19.42230,1561077
1891,maxjeffos,21,0.00135,303218,19.42364,1561077
1892,melbit-michaelw,21,0.00135,303239,19.42499,1561077
1893,melt7777,21,0.00135,303260,19.42633,1561077
1894,michaelhuettermann,21,0.00135,303281,19.42768,1561077
1895,Minipada,21,0.00135,303302,19.42902,1561077
1896,MLBMatt,21,0.00135,303323,19.43037,1561077
1897,mxandeco,21,0.00135,303344,19.43171,1561077
1898,nickb-carallon,21,0.00135,303365,19.43306,1561077
1899,phaser,21,0.00135,303386,19.43440,1561077
1900,prudhvishankar,21,0.00135,303407,19.43575,1561077
1901,romainx,21,0.00135,303428,19.43709,1561077
1902,sai-tirunagiri,21,0.00135,303449,19.43844,1561077
1903,silbernm,21,0.00135,303470,19.43978,1561077
1904,Spliterash,21,0.00135,303491,19.44113,1561077
1905,stisti,21,0.00135,303512,19.44247,1561077
1906,sumitkharche,21,0.00135,303533,19.44382,1561077
1907,sushdive,21,0.00135,303554,19.44517,1561077
1908,SusmithaGU,21,0.00135,303575,19.44651,1561077
1909,tdurova,21,0.00135,303596,19.44786,1561077
1910,th3morg,21,0.00135,303617,19.44920,1561077
1911,thomaschandler,21,0.00135,303638,19.45055,1561077
1912,tinexw,21,0.00135,303659,19.45189,1561077
1913,tomonight,21,0.00135,303680,19.45324,1561077
1914,toyPoodle,21,0.00135,303701,19.45458,1561077
1915,troyhart,21,0.00135,303722,19.45593,1561077
1916,tsparber,21,0.00135,303743,19.45727,1561077
1917,urvashigupta7,21,0.00135,303764,19.45862,1561077
1918,vikrambollu,21,0.00135,303785,19.45996,1561077
1919,vrnvikas,21,0.00135,303806,19.46131,1561077
1920,windocks-github,21,0.00135,303827,19.46265,1561077
1921,wythel,21,0.00135,303848,19.46400,1561077
1922,yoshi314,21,0.00135,303869,19.46534,1561077
1923,zaza,21,0.00135,303890,19.46669,1561077
1924,a93ushakov,20,0.00128,303910,19.46797,1561077
1925,abramobagnara,20,0.00128,303930,19.46925,1561077
1926,acrewdson,20,0.00128,303950,19.47053,1561077
1927,actions,20,0.00128,303970,19.47181,1561077
1928,ahpook,20,0.00128,303990,19.47309,1561077
1929,Aju100,20,0.00128,304010,19.47438,1561077
1930,akilantech,20,0.00128,304030,19.47566,1561077
1931,AlanFoster,20,0.00128,304050,19.47694,1561077
1932,alb-i986,20,0.00128,304070,19.47822,1561077
1933,amritp55,20,0.00128,304090,19.47950,1561077
1934,antgel,20,0.00128,304110,19.48078,1561077
1935,antoinell,20,0.00128,304130,19.48206,1561077
1936,antoniobeyah,20,0.00128,304150,19.48334,1561077
1937,AntonLiakhovich,20,0.00128,304170,19.48463,1561077
1938,ashmeer7,20,0.00128,304190,19.48591,1561077
1939,away168,20,0.00128,304210,19.48719,1561077
1940,bfaulk96,20,0.00128,304230,19.48847,1561077
1941,bob-rohan,20,0.00128,304250,19.48975,1561077
1942,CarbonCopy4V,20,0.00128,304270,19.49103,1561077
1943,csharmath,20,0.00128,304290,19.49231,1561077
1944,ctataryn,20,0.00128,304310,19.49359,1561077
1945,ctran,20,0.00128,304330,19.49487,1561077
1946,demaniak,20,0.00128,304350,19.49616,1561077
1947,demonfiddler,20,0.00128,304370,19.49744,1561077
1948,DivyeshChandra,20,0.00128,304390,19.49872,1561077
1949,DMEvanCT,20,0.00128,304410,19.50000,1561077
1950,Downright-Development,20,0.00128,304430,19.50128,1561077
1951,ervansetiawan,20,0.00128,304450,19.50256,1561077
1952,eviweb,20,0.00128,304470,19.50384,1561077
1953,excalibur,20,0.00128,304490,19.50512,1561077
1954,fabMrc,20,0.00128,304510,19.50640,1561077
1955,fabric8cd,20,0.00128,304530,19.50769,1561077
1956,far-blue,20,0.00128,304550,19.50897,1561077
1957,gonzalochief,20,0.00128,304570,19.51025,1561077
1958,hak33m16,20,0.00128,304590,19.51153,1561077
1959,Hickstone,20,0.00128,304610,19.51281,1561077
1960,jasonopslevel,20,0.00128,304630,19.51409,1561077
1961,jeannich,20,0.00128,304650,19.51537,1561077
1962,jeffkhull,20,0.00128,304670,19.51665,1561077
1963,jjonly,20,0.00128,304690,19.51794,1561077
1964,Johdeath,20,0.00128,304710,19.51922,1561077
1965,jpthiery,20,0.00128,304730,19.52050,1561077
1966,kapoorlakshya,20,0.00128,304750,19.52178,1561077
1967,kevinric,20,0.00128,304770,19.52306,1561077
1968,krishnakumar6893,20,0.00128,304790,19.52434,1561077
1969,kvish,20,0.00128,304810,19.52562,1561077
1970,langleyd,20,0.00128,304830,19.52690,1561077
1971,lelandsindttouchnet,20,0.00128,304850,19.52818,1561077
1972,liketic,20,0.00128,304870,19.52947,1561077
1973,lilley2412,20,0.00128,304890,19.53075,1561077
1974,lin-hua-cheng,20,0.00128,304910,19.53203,1561077
1975,llecaroz,20,0.00128,304930,19.53331,1561077
1976,lucatoldo,20,0.00128,304950,19.53459,1561077
1977,mahmoud-ashi,20,0.00128,304970,19.53587,1561077
1978,makropod,20,0.00128,304990,19.53715,1561077
1979,manishgo,20,0.00128,305010,19.53843,1561077
1980,MatthewAry,20,0.00128,305030,19.53972,1561077
1981,mbaitelman,20,0.00128,305050,19.54100,1561077
1982,mcascone,20,0.00128,305070,19.54228,1561077
1983,mrinal1209,20,0.00128,305090,19.54356,1561077
1984,mvecha,20,0.00128,305110,19.54484,1561077
1985,Mykyta,20,0.00128,305130,19.54612,1561077
1986,mymarche,20,0.00128,305150,19.54740,1561077
1987,narendrabtechcse,20,0.00128,305170,19.54868,1561077
1988,nhtzr,20,0.00128,305190,19.54996,1561077
1989,nileshladda,20,0.00128,305210,19.55125,1561077
1990,outjoker,20,0.00128,305230,19.55253,1561077
1991,pooja-singh-appscan,20,0.00128,305250,19.55381,1561077
1992,primoz-p,20,0.00128,305270,19.55509,1561077
1993,raballew,20,0.00128,305290,19.55637,1561077
1994,rahuldimri,20,0.00128,305310,19.55765,1561077
1995,rborer,20,0.00128,305330,19.55893,1561077
1996,reddwarf69,20,0.00128,305350,19.56021,1561077
1997,reinaldojohnson1,20,0.00128,305370,19.56150,1561077
1998,ricklagerweij,20,0.00128,305390,19.56278,1561077
1999,ryanpei,20,0.00128,305410,19.56406,1561077
2000,s1apped,20,0.00128,305430,19.56534,1561077
2001,Sergio-Mira,20,0.00128,305450,19.56662,1561077
2002,snooyen,20,0.00128,305470,19.56790,1561077
2003,spbkelt,20,0.00128,305490,19.56918,1561077
2004,sseale,20,0.00128,305510,19.57046,1561077
2005,stub42,20,0.00128,305530,19.57174,1561077
2006,sumakumardey,20,0.00128,305550,19.57303,1561077
2007,superboum,20,0.00128,305570,19.57431,1561077
2008,svilenvul,20,0.00128,305590,19.57559,1561077
2009,talvi,20,0.00128,305610,19.57687,1561077
2010,tgelpi-gmail,20,0.00128,305630,19.57815,1561077
2011,ThStock,20,0.00128,305650,19.57943,1561077
2012,tps193,20,0.00128,305670,19.58071,1561077
2013,trash-80,20,0.00128,305690,19.58199,1561077
2014,vasiliy-briginets,20,0.00128,305710,19.58327,1561077
2015,Vishalghyv,20,0.00128,305730,19.58456,1561077
2016,vochithanh,20,0.00128,305750,19.58584,1561077
2017,winklerm,20,0.00128,305770,19.58712,1561077
2018,wwpass,20,0.00128,305790,19.58840,1561077
2019,yakirk,20,0.00128,305810,19.58968,1561077
2020,Yatheesh-Rai,20,0.00128,305830,19.59096,1561077
2021,y-takaha5hi,20,0.00128,305850,19.59224,1561077
2022,zeedeveloper,20,0.00128,305870,19.59352,1561077
2023,abudavis,19,0.00122,305889,19.59474,1561077
2024,ag0783,19,0.00122,305908,19.59596,1561077
2025,ahmei0,19,0.00122,305927,19.59718,1561077
2026,alchen99,19,0.00122,305946,19.59839,1561077
2027,A-MSG,19,0.00122,305965,19.59961,1561077
2028,apolovyi,19,0.00122,305984,19.60083,1561077
2029,balihb,19,0.00122,306003,19.60204,1561077
2030,beyond-code-github,19,0.00122,306022,19.60326,1561077
2031,bjones14,19,0.00122,306041,19.60448,1561077
2032,Blahartinger,19,0.00122,306060,19.60570,1561077
2033,blakmajk,19,0.00122,306079,19.60691,1561077
2034,blesuer,19,0.00122,306098,19.60813,1561077
2035,bncbhm,19,0.00122,306117,19.60935,1561077
2036,borgstrom,19,0.00122,306136,19.61056,1561077
2037,Bwvolleyball,19,0.00122,306155,19.61178,1561077
2038,clickboo,19,0.00122,306174,19.61300,1561077
2039,crshnburn,19,0.00122,306193,19.61422,1561077
2040,csturiale,19,0.00122,306212,19.61543,1561077
2041,damoxc,19,0.00122,306231,19.61665,1561077
2042,dapak,19,0.00122,306250,19.61787,1561077
2043,deepaannjohn,19,0.00122,306269,19.61908,1561077
2044,dhandapani-hd,19,0.00122,306288,19.62030,1561077
2045,diogo-duarte-rg,19,0.00122,306307,19.62152,1561077
2046,dysinger,19,0.00122,306326,19.62273,1561077
2047,EcHoOfInSaNiTy,19,0.00122,306345,19.62395,1561077
2048,EliaBracciSumo,19,0.00122,306364,19.62517,1561077
2049,Eric-Fontana-Bose,19,0.00122,306383,19.62639,1561077
2050,erikcas,19,0.00122,306402,19.62760,1561077
2051,eserbin,19,0.00122,306421,19.62882,1561077
2052,fbyrne,19,0.00122,306440,19.63004,1561077
2053,forgedhallpass,19,0.00122,306459,19.63125,1561077
2054,Gabbyr,19,0.00122,306478,19.63247,1561077
2055,gitwillian,19,0.00122,306497,19.63369,1561077
2056,gojenkuser,19,0.00122,306516,19.63491,1561077
2057,haykbaluyan,19,0.00122,306535,19.63612,1561077
2058,impact-maker,19,0.00122,306554,19.63734,1561077
2059,jaguilar-atl,19,0.00122,306573,19.63856,1561077
2060,jakauppila,19,0.00122,306592,19.63977,1561077
2061,jaydeeps-sacumen,19,0.00122,306611,19.64099,1561077
2062,jerrinot,19,0.00122,306630,19.64221,1561077
2063,joel-f-brown,19,0.00122,306649,19.64343,1561077
2064,jostyee,19,0.00122,306668,19.64464,1561077
2065,justinbarry,19,0.00122,306687,19.64586,1561077
2066,Kentalot,19,0.00122,306706,19.64708,1561077
2067,kleini,19,0.00122,306725,19.64829,1561077
2068,kristian,19,0.00122,306744,19.64951,1561077
2069,lessonz,19,0.00122,306763,19.65073,1561077
2070,lluu,19,0.00122,306782,19.65195,1561077
2071,lubosmichalic,19,0.00122,306801,19.65316,1561077
2072,lukej7,19,0.00122,306820,19.65438,1561077
2073,M0J0isback,19,0.00122,306839,19.65560,1561077
2074,maheshwarishikha,19,0.00122,306858,19.65681,1561077
2075,mark-reiche,19,0.00122,306877,19.65803,1561077
2076,mattjalexander,19,0.00122,306896,19.65925,1561077
2077,mcaulifn,19,0.00122,306915,19.66047,1561077
2078,mduesterhoeft,19,0.00122,306934,19.66168,1561077
2079,mike-serchenia,19,0.00122,306953,19.66290,1561077
2080,m-jin,19,0.00122,306972,19.66412,1561077
2081,M-r-A,19,0.00122,306991,19.66533,1561077
2082,mterzo,19,0.00122,307010,19.66655,1561077
2083,mzaikin,19,0.00122,307029,19.66777,1561077
2084,nagenderRawat,19,0.00122,307048,19.66898,1561077
2085,neomatrix369,19,0.00122,307067,19.67020,1561077
2086,Nexus457,19,0.00122,307086,19.67142,1561077
2087,Nicolas-M,19,0.00122,307105,19.67264,1561077
2088,nightowlengineer,19,0.00122,307124,19.67385,1561077
2089,niharikavy,19,0.00122,307143,19.67507,1561077
2090,nithril,19,0.00122,307162,19.67629,1561077
2091,nohasaid,19,0.00122,307181,19.67750,1561077
2092,Nuh,19,0.00122,307200,19.67872,1561077
2093,omehegan-cb,19,0.00122,307219,19.67994,1561077
2094,oserna3,19,0.00122,307238,19.68116,1561077
2095,pavgust,19,0.00122,307257,19.68237,1561077
2096,pdkreid,19,0.00122,307276,19.68359,1561077
2097,phietala,19,0.00122,307295,19.68481,1561077
2098,porterja31,19,0.00122,307314,19.68602,1561077
2099,qalinn,19,0.00122,307333,19.68724,1561077
2100,Rechi,19,0.00122,307352,19.68846,1561077
2101,rene00,19,0.00122,307371,19.68968,1561077
2102,riso,19,0.00122,307390,19.69089,1561077
2103,rolandomihaivlad,19,0.00122,307409,19.69211,1561077
2104,rwtsoftware,19,0.00122,307428,19.69333,1561077
2105,sabberworm,19,0.00122,307447,19.69454,1561077
2106,SAi0401,19,0.00122,307466,19.69576,1561077
2107,saikirankv,19,0.00122,307485,19.69698,1561077
2108,saravanakkumar,19,0.00122,307504,19.69820,1561077
2109,SbSpider,19,0.00122,307523,19.69941,1561077
2110,shivaylamba,19,0.00122,307542,19.70063,1561077
2111,sshiv5768,19,0.00122,307561,19.70185,1561077
2112,sujay2306,19,0.00122,307580,19.70306,1561077
2113,takashiharano,19,0.00122,307599,19.70428,1561077
2114,tburow,19,0.00122,307618,19.70550,1561077
2115,tedivm,19,0.00122,307637,19.70672,1561077
2116,TheDigitalNinja,19,0.00122,307656,19.70793,1561077
2117,TheJefe,19,0.00122,307675,19.70915,1561077
2118,thienlh,19,0.00122,307694,19.71037,1561077
2119,tiny-dancer,19,0.00122,307713,19.71158,1561077
2120,valdemon,19,0.00122,307732,19.71280,1561077
2121,vmrvictor,19,0.00122,307751,19.71402,1561077
2122,vochicong,19,0.00122,307770,19.71524,1561077
2123,volans-,19,0.00122,307789,19.71645,1561077
2124,wouter-admiraal-sonarsource,19,0.00122,307808,19.71767,1561077
2125,xabierlaiseca,19,0.00122,307827,19.71889,1561077
2126,xframium,19,0.00122,307846,19.72010,1561077
2127,yrumax,19,0.00122,307865,19.72132,1561077
2128,yubangxi,19,0.00122,307884,19.72254,1561077
2129,Zintow,19,0.00122,307903,19.72375,1561077
2130,zmeggyesi,19,0.00122,307922,19.72497,1561077
2131,adinhtdsibm,18,0.00115,307940,19.72612,1561077
2132,Akavith,18,0.00115,307958,19.72728,1561077
2133,AlbanAndrieu,18,0.00115,307976,19.72843,1561077
2134,AlexanderStohr,18,0.00115,307994,19.72958,1561077
2135,AlexanderYeremeyev,18,0.00115,308012,19.73074,1561077
2136,alexjfisher,18,0.00115,308030,19.73189,1561077
2137,alexmolev,18,0.00115,308048,19.73304,1561077
2138,amitmindstix,18,0.00115,308066,19.73420,1561077
2139,AndrewsBot,18,0.00115,308084,19.73535,1561077
2140,Angelin01,18,0.00115,308102,19.73650,1561077
2141,aoyz86,18,0.00115,308120,19.73766,1561077
2142,apmalla,18,0.00115,308138,19.73881,1561077
2143,ashnazg,18,0.00115,308156,19.73996,1561077
2144,awiddersheim,18,0.00115,308174,19.74111,1561077
2145,ayashjorden,18,0.00115,308192,19.74227,1561077
2146,badamowicz,18,0.00115,308210,19.74342,1561077
2147,baobeizuoshoubuli,18,0.00115,308228,19.74457,1561077
2148,berni2288,18,0.00115,308246,19.74573,1561077
2149,bholden-r7,18,0.00115,308264,19.74688,1561077
2150,bvboca,18,0.00115,308282,19.74803,1561077
2151,chenbh,18,0.00115,308300,19.74919,1561077
2152,chook,18,0.00115,308318,19.75034,1561077
2153,chrishiner,18,0.00115,308336,19.75149,1561077
2154,chrissy25,18,0.00115,308354,19.75265,1561077
2155,coltrey,18,0.00115,308372,19.75380,1561077
2156,covert8,18,0.00115,308390,19.75495,1561077
2157,danielpalstra,18,0.00115,308408,19.75610,1561077
2158,DhruviThakkar210,18,0.00115,308426,19.75726,1561077
2159,djaara,18,0.00115,308444,19.75841,1561077
2160,dsakilesh,18,0.00115,308462,19.75956,1561077
2161,dspalmer99,18,0.00115,308480,19.76072,1561077
2162,elkh510,18,0.00115,308498,19.76187,1561077
2163,Eriten,18,0.00115,308516,19.76302,1561077
2164,esproul,18,0.00115,308534,19.76418,1561077
2165,flair0303,18,0.00115,308552,19.76533,1561077
2166,franciscoruiz,18,0.00115,308570,19.76648,1561077
2167,freefood89,18,0.00115,308588,19.76763,1561077
2168,getrostt,18,0.00115,308606,19.76879,1561077
2169,ginoh,18,0.00115,308624,19.76994,1561077
2170,gomesp,18,0.00115,308642,19.77109,1561077
2171,Graham42,18,0.00115,308660,19.77225,1561077
2172,haidaraM,18,0.00115,308678,19.77340,1561077
2173,harniman,18,0.00115,308696,19.77455,1561077
2174,harsh-ps-2003,18,0.00115,308714,19.77571,1561077
2175,heisian,18,0.00115,308732,19.77686,1561077
2176,hibes,18,0.00115,308750,19.77801,1561077
2177,icereed,18,0.00115,308768,19.77917,1561077
2178,igreenfield,18,0.00115,308786,19.78032,1561077
2179,jamesggraf,18,0.00115,308804,19.78147,1561077
2180,jdstone-loansnap,18,0.00115,308822,19.78262,1561077
2181,jecafarelli,18,0.00115,308840,19.78378,1561077
2182,jgeorgeson,18,0.00115,308858,19.78493,1561077
2183,jhonDoe15,18,0.00115,308876,19.78608,1561077
2184,jpcollins,18,0.00115,308894,19.78724,1561077
2185,kchoy-sfdc,18,0.00115,308912,19.78839,1561077
2186,kxtran,18,0.00115,308930,19.78954,1561077
2187,larsskj,18,0.00115,308948,19.79070,1561077
2188,LawYard,18,0.00115,308966,19.79185,1561077
2189,leiyanggz,18,0.00115,308984,19.79300,1561077
2190,lhupfeldt,18,0.00115,309002,19.79415,1561077
2191,llhhbc,18,0.00115,309020,19.79531,1561077
2192,loelala,18,0.00115,309038,19.79646,1561077
2193,lonefreak,18,0.00115,309056,19.79761,1561077
2194,lorieqhd,18,0.00115,309074,19.79877,1561077
2195,MarkMcCulloh,18,0.00115,309092,19.79992,1561077
2196,markus-jf,18,0.00115,309110,19.80107,1561077
2197,martinmine,18,0.00115,309128,19.80223,1561077
2198,mathieusama,18,0.00115,309146,19.80338,1561077
2199,mattdlh,18,0.00115,309164,19.80453,1561077
2200,mayank146009,18,0.00115,309182,19.80569,1561077
2201,mdealer,18,0.00115,309200,19.80684,1561077
2202,mecseid,18,0.00115,309218,19.80799,1561077
2203,michaelPf85,18,0.00115,309236,19.80914,1561077
2204,mikee805,18,0.00115,309254,19.81030,1561077
2205,ModuloM,18,0.00115,309272,19.81145,1561077
2206,mrflow,18,0.00115,309290,19.81260,1561077
2207,mrothroc,18,0.00115,309308,19.81376,1561077
2208,msneeden,18,0.00115,309326,19.81491,1561077
2209,neakor,18,0.00115,309344,19.81606,1561077
2210,nilium,18,0.00115,309362,19.81722,1561077
2211,oliverlockwood,18,0.00115,309380,19.81837,1561077
2212,OmkarBorhade98,18,0.00115,309398,19.81952,1561077
2213,omkar-dsd,18,0.00115,309416,19.82068,1561077
2214,Osipion,18,0.00115,309434,19.82183,1561077
2215,otaviomedeirossb,18,0.00115,309452,19.82298,1561077
2216,oxygenxo,18,0.00115,309470,19.82413,1561077
2217,patope,18,0.00115,309488,19.82529,1561077
2218,psyhomb,18,0.00115,309506,19.82644,1561077
2219,pulphix,18,0.00115,309524,19.82759,1561077
2220,razvan-ig,18,0.00115,309542,19.82875,1561077
2221,rcomanne,18,0.00115,309560,19.82990,1561077
2222,rejahrehim,18,0.00115,309578,19.83105,1561077
2223,rolaca11,18,0.00115,309596,19.83221,1561077
2224,rourke750,18,0.00115,309614,19.83336,1561077
2225,ryanwoodsmall,18,0.00115,309632,19.83451,1561077
2226,samskiter,18,0.00115,309650,19.83566,1561077
2227,sayap,18,0.00115,309668,19.83682,1561077
2228,sbrassely,18,0.00115,309686,19.83797,1561077
2229,serhiykrupka,18,0.00115,309704,19.83912,1561077
2230,srikns,18,0.00115,309722,19.84028,1561077
2231,stefichjo,18,0.00115,309740,19.84143,1561077
2232,Stikus,18,0.00115,309758,19.84258,1561077
2233,stoesselt,18,0.00115,309776,19.84374,1561077
2234,SyambasivaAutonomiq,18,0.00115,309794,19.84489,1561077
2235,syntonyze,18,0.00115,309812,19.84604,1561077
2236,teroniemisto,18,0.00115,309830,19.84720,1561077
2237,tomvopat,18,0.00115,309848,19.84835,1561077
2238,wmcbroomd2d,18,0.00115,309866,19.84950,1561077
2239,YuTingLiu,18,0.00115,309884,19.85065,1561077
2240,zackpollard,18,0.00115,309902,19.85181,1561077
2241,zyoutz-r7,18,0.00115,309920,19.85296,1561077
2242,2pai,17,0.00109,309937,19.85405,1561077
2243,62mkv,17,0.00109,309954,19.85514,1561077
2244,alanfung,17,0.00109,309971,19.85623,1561077
2245,almiroshnich,17,0.00109,309988,19.85732,1561077
2246,alphabettispaghetti,17,0.00109,310005,19.85841,1561077
2247,AMCBridgeDevTeam,17,0.00109,310022,19.85949,1561077
2248,andriopoulou-danai,17,0.00109,310039,19.86058,1561077
2249,AntoineFr,17,0.00109,310056,19.86167,1561077
2250,arickchow,17,0.00109,310073,19.86276,1561077
2251,assertion,17,0.00109,310090,19.86385,1561077
2252,AvihayTsayeg,17,0.00109,310107,19.86494,1561077
2253,BrianBerzins,17,0.00109,310124,19.86603,1561077
2254,CB-GuangyaoXie,17,0.00109,310141,19.86712,1561077
2255,cbohiptest,17,0.00109,310158,19.86821,1561077
2256,cdobbyn,17,0.00109,310175,19.86930,1561077
2257,cgrigel,17,0.00109,310192,19.87038,1561077
2258,chickenkiller,17,0.00109,310209,19.87147,1561077
2259,choeffer,17,0.00109,310226,19.87256,1561077
2260,Chris9224,17,0.00109,310243,19.87365,1561077
2261,cjo9900,17,0.00109,310260,19.87474,1561077
2262,DavidGereb,17,0.00109,310277,19.87583,1561077
2263,David-Villeneuve,17,0.00109,310294,19.87692,1561077
2264,degetel-lijian,17,0.00109,310311,19.87801,1561077
2265,dhs-rec,17,0.00109,310328,19.87910,1561077
2266,don-vip,17,0.00109,310345,19.88019,1561077
2267,doterme,17,0.00109,310362,19.88127,1561077
2268,drorventura,17,0.00109,310379,19.88236,1561077
2269,drriguz,17,0.00109,310396,19.88345,1561077
2270,dubrsl,17,0.00109,310413,19.88454,1561077
2271,eboumendil,17,0.00109,310430,19.88563,1561077
2272,ErikVerheul,17,0.00109,310447,19.88672,1561077
2273,estheryouhana,17,0.00109,310464,19.88781,1561077
2274,FaHeymann,17,0.00109,310481,19.88890,1561077
2275,fruch,17,0.00109,310498,19.88999,1561077
2276,fugkco,17,0.00109,310515,19.89108,1561077
2277,gitolicious,17,0.00109,310532,19.89216,1561077
2278,gmccue,17,0.00109,310549,19.89325,1561077
2279,gokula-krishna-dev,17,0.00109,310566,19.89434,1561077
2280,gsgs-libin,17,0.00109,310583,19.89543,1561077
2281,gxueatlassian,17,0.00109,310600,19.89652,1561077
2282,herau,17,0.00109,310617,19.89761,1561077
2283,HieuBui419,17,0.00109,310634,19.89870,1561077
2284,hilafish,17,0.00109,310651,19.89979,1561077
2285,ignaciofuertes,17,0.00109,310668,19.90088,1561077
2286,ilavender,17,0.00109,310685,19.90197,1561077
2287,JackuB,17,0.00109,310702,19.90305,1561077
2288,jan-molak,17,0.00109,310719,19.90414,1561077
2289,jawlitkp,17,0.00109,310736,19.90523,1561077
2290,jbpitts,17,0.00109,310753,19.90632,1561077
2291,jbyers,17,0.00109,310770,19.90741,1561077
2292,jiff-infrastructure,17,0.00109,310787,19.90850,1561077
2293,jjudd,17,0.00109,310804,19.90959,1561077
2294,jonathanamartin,17,0.00109,310821,19.91068,1561077
2295,julian-alarcon,17,0.00109,310838,19.91177,1561077
2296,justfalter,17,0.00109,310855,19.91286,1561077
2297,katsuhara,17,0.00109,310872,19.91394,1561077
2298,khushishikhu,17,0.00109,310889,19.91503,1561077
2299,kirillbilchenko,17,0.00109,310906,19.91612,1561077
2300,kkkon,17,0.00109,310923,19.91721,1561077
2301,knylander,17,0.00109,310940,19.91830,1561077
2302,krishnakvall,17,0.00109,310957,19.91939,1561077
2303,kycheng,17,0.00109,310974,19.92048,1561077
2304,lkisac,17,0.00109,310991,19.92157,1561077
2305,loafyloaf,17,0.00109,311008,19.92266,1561077
2306,maafy6,17,0.00109,311025,19.92374,1561077
2307,marcjay,17,0.00109,311042,19.92483,1561077
2308,memphis88,17,0.00109,311059,19.92592,1561077
2309,mikepain,17,0.00109,311076,19.92701,1561077
2310,minitux,17,0.00109,311093,19.92810,1561077
2311,minudika,17,0.00109,311110,19.92919,1561077
2312,mitkama,17,0.00109,311127,19.93028,1561077
2313,MKajzik,17,0.00109,311144,19.93137,1561077
2314,mmshaikh88,17,0.00109,311161,19.93246,1561077
2315,mostynb,17,0.00109,311178,19.93355,1561077
2316,njtman,17,0.00109,311195,19.93463,1561077
2317,nlk35,17,0.00109,311212,19.93572,1561077
2318,nubody,17,0.00109,311229,19.93681,1561077
2319,oozturkinvicti,17,0.00109,311246,19.93790,1561077
2320,pancudaniel7,17,0.00109,311263,19.93899,1561077
2321,pathob,17,0.00109,311280,19.94008,1561077
2322,pgeorgiev333,17,0.00109,311297,19.94117,1561077
2323,phayes-r7,17,0.00109,311314,19.94226,1561077
2324,R3d-Dragon,17,0.00109,311331,19.94335,1561077
2325,renhao-0518,17,0.00109,311348,19.94444,1561077
2326,riceluxs1t,17,0.00109,311365,19.94552,1561077
2327,ricksbrown,17,0.00109,311382,19.94661,1561077
2328,rjakubco,17,0.00109,311399,19.94770,1561077
2329,rmkanda,17,0.00109,311416,19.94879,1561077
2330,rsennewald,17,0.00109,311433,19.94988,1561077
2331,sagayd,17,0.00109,311450,19.95097,1561077
2332,sandeeps2,17,0.00109,311467,19.95206,1561077
2333,serpentblade,17,0.00109,311484,19.95315,1561077
2334,sfhardman,17,0.00109,311501,19.95424,1561077
2335,sig-saraf,17,0.00109,311518,19.95533,1561077
2336,sirosen,17,0.00109,311535,19.95641,1561077
2337,sll552,17,0.00109,311552,19.95750,1561077
2338,Spitfire1900,17,0.00109,311569,19.95859,1561077
2339,stefanandres,17,0.00109,311586,19.95968,1561077
2340,ston1th,17,0.00109,311603,19.96077,1561077
2341,SuperTux88,17,0.00109,311620,19.96186,1561077
2342,SusmithaGundu,17,0.00109,311637,19.96295,1561077
2343,tequillaz,17,0.00109,311654,19.96404,1561077
2344,thesvistun,17,0.00109,311671,19.96513,1561077
2345,thorveshubham,17,0.00109,311688,19.96622,1561077
2346,tkelley-eg,17,0.00109,311705,19.96730,1561077
2347,tkgregory,17,0.00109,311722,19.96839,1561077
2348,tlazebnyk,17,0.00109,311739,19.96948,1561077
2349,tmeltser,17,0.00109,311756,19.97057,1561077
2350,tomatofrommars,17,0.00109,311773,19.97166,1561077
2351,tommilligan,17,0.00109,311790,19.97275,1561077
2352,vapdrs,17,0.00109,311807,19.97384,1561077
2353,vatine,17,0.00109,311824,19.97493,1561077
2354,wenjunxiao,17,0.00109,311841,19.97602,1561077
2355,yabberyabber,17,0.00109,311858,19.97711,1561077
2356,ybai2sc,17,0.00109,311875,19.97819,1561077
2357,ymartin59,17,0.00109,311892,19.97928,1561077
2358,abdullahranginwala,16,0.00102,311908,19.98031,1561077
2359,adrianiacob22,16,0.00102,311924,19.98133,1561077
2360,adrianpowell,16,0.00102,311940,19.98236,1561077
2361,agmt5989,16,0.00102,311956,19.98338,1561077
2362,aheubusch,16,0.00102,311972,19.98441,1561077
2363,ahippo,16,0.00102,311988,19.98543,1561077
2364,ahmetrehaseker,16,0.00102,312004,19.98646,1561077
2365,airycanon,16,0.00102,312020,19.98748,1561077
2366,ajaijoy-bmc,16,0.00102,312036,19.98851,1561077
2367,ajalexander,16,0.00102,312052,19.98953,1561077
2368,akiellor,16,0.00102,312068,19.99056,1561077
2369,alperkokmen,16,0.00102,312084,19.99158,1561077
2370,amezin,16,0.00102,312100,19.99261,1561077
2371,anandbagmar,16,0.00102,312116,19.99363,1561077
2372,andreabettich,16,0.00102,312132,19.99466,1561077
2373,AndreGCX,16,0.00102,312148,19.99568,1561077
2374,angelcervilla,16,0.00102,312164,19.99671,1561077
2375,ankitjain200292,16,0.00102,312180,19.99773,1561077
2376,anthonywoo,16,0.00102,312196,19.99876,1561077
2377,ArnauSistach,16,0.00102,312212,19.99978,1561077
2378,ashu16815,16,0.00102,312228,20.00081,1561077
2379,atreadway,16,0.00102,312244,20.00183,1561077
2380,babinin,16,0.00102,312260,20.00286,1561077
2381,ballab1,16,0.00102,312276,20.00388,1561077
2382,bartdevriendt,16,0.00102,312292,20.00491,1561077
2383,becitsthere,16,0.00102,312308,20.00593,1561077
2384,bemeyert,16,0.00102,312324,20.00696,1561077
2385,benkeil,16,0.00102,312340,20.00798,1561077
2386,benvandenberg,16,0.00102,312356,20.00901,1561077
2387,bjornmonnens,16,0.00102,312372,20.01003,1561077
2388,brianwolfe,16,0.00102,312388,20.01106,1561077
2389,burnMyDread,16,0.00102,312404,20.01208,1561077
2390,cezkuj,16,0.00102,312420,20.01311,1561077
2391,chenhuahuan,16,0.00102,312436,20.01413,1561077
2392,chris5287,16,0.00102,312452,20.01516,1561077
2393,christapley,16,0.00102,312468,20.01618,1561077
2394,DaFloWaDa,16,0.00102,312484,20.01721,1561077
2395,danile42,16,0.00102,312500,20.01823,1561077
2396,darkrasid,16,0.00102,312516,20.01926,1561077
2397,darktempla,16,0.00102,312532,20.02028,1561077
2398,dennisjlee,16,0.00102,312548,20.02131,1561077
2399,derekatkins,16,0.00102,312564,20.02233,1561077
2400,desertblackeagle,16,0.00102,312580,20.02336,1561077
2401,digulla,16,0.00102,312596,20.02438,1561077
2402,dmateja,16,0.00102,312612,20.02541,1561077
2403,ehaselwanter,16,0.00102,312628,20.02643,1561077
2404,eisig,16,0.00102,312644,20.02746,1561077
2405,eivindt,16,0.00102,312660,20.02848,1561077
2406,ejsuncy,16,0.00102,312676,20.02951,1561077
2407,faucherb94,16,0.00102,312692,20.03053,1561077
2408,gavrielk,16,0.00102,312708,20.03156,1561077
2409,gcolin,16,0.00102,312724,20.03258,1561077
2410,gcontini,16,0.00102,312740,20.03361,1561077
2411,geekchow,16,0.00102,312756,20.03463,1561077
2412,gibbsjosh,16,0.00102,312772,20.03565,1561077
2413,GingerBuffalo,16,0.00102,312788,20.03668,1561077
2414,gnuhub,16,0.00102,312804,20.03770,1561077
2415,Goodsmileduck,16,0.00102,312820,20.03873,1561077
2416,guleng,16,0.00102,312836,20.03975,1561077
2417,HadesArchitect,16,0.00102,312852,20.04078,1561077
2418,hartzell,16,0.00102,312868,20.04180,1561077
2419,hasansimsekinvicti,16,0.00102,312884,20.04283,1561077
2420,heinemann-cqse,16,0.00102,312900,20.04385,1561077
2421,ijschwabacher,16,0.00102,312916,20.04488,1561077
2422,imalik-rms,16,0.00102,312932,20.04590,1561077
2423,jaibapna,16,0.00102,312948,20.04693,1561077
2424,jcroall,16,0.00102,312964,20.04795,1561077
2425,jinjie2088,16,0.00102,312980,20.04898,1561077
2426,jkugler,16,0.00102,312996,20.05000,1561077
2427,joaquinclearmetal,16,0.00102,313012,20.05103,1561077
2428,joeyslalom,16,0.00102,313028,20.05205,1561077
2429,johan1252,16,0.00102,313044,20.05308,1561077
2430,johnmshields,16,0.00102,313060,20.05410,1561077
2431,JohnTheodore,16,0.00102,313076,20.05513,1561077
2432,josephbrueggen,16,0.00102,313092,20.05615,1561077
2433,juliohm1978,16,0.00102,313108,20.05718,1561077
2434,kabhiibm,16,0.00102,313124,20.05820,1561077
2435,karlhenselin,16,0.00102,313140,20.05923,1561077
2436,Kaushik-Iyer,16,0.00102,313156,20.06025,1561077
2437,krabik,16,0.00102,313172,20.06128,1561077
2438,LMojica,16,0.00102,313188,20.06230,1561077
2439,loganmzz,16,0.00102,313204,20.06333,1561077
2440,LorMun,16,0.00102,313220,20.06435,1561077
2441,luckoseabraham,16,0.00102,313236,20.06538,1561077
2442,majinghe,16,0.00102,313252,20.06640,1561077
2443,MatthewQueenan,16,0.00102,313268,20.06743,1561077
2444,melodous,16,0.00102,313284,20.06845,1561077
2445,mike10010100,16,0.00102,313300,20.06948,1561077
2446,miles-w-3,16,0.00102,313316,20.07050,1561077
2447,mklein0,16,0.00102,313332,20.07153,1561077
2448,mordf,16,0.00102,313348,20.07255,1561077
2449,msloes,16,0.00102,313364,20.07358,1561077
2450,namloc2001,16,0.00102,313380,20.07460,1561077
2451,Nek-,16,0.00102,313396,20.07563,1561077
2452,niclet,16,0.00102,313412,20.07665,1561077
2453,Nuru,16,0.00102,313428,20.07768,1561077
2454,OlgaMaciaszek,16,0.00102,313444,20.07870,1561077
2455,oolfloo,16,0.00102,313460,20.07973,1561077
2456,oradwell,16,0.00102,313476,20.08075,1561077
2457,pascal-hofmann,16,0.00102,313492,20.08178,1561077
2458,patelronak,16,0.00102,313508,20.08280,1561077
2459,PatrikSchalin,16,0.00102,313524,20.08383,1561077
2460,perrinz,16,0.00102,313540,20.08485,1561077
2461,poovaraj,16,0.00102,313556,20.08588,1561077
2462,POPSuL,16,0.00102,313572,20.08690,1561077
2463,pyssling,16,0.00102,313588,20.08793,1561077
2464,qkniazi,16,0.00102,313604,20.08895,1561077
2465,ram4444,16,0.00102,313620,20.08998,1561077
2466,ramakrishnaraov,16,0.00102,313636,20.09100,1561077
2467,Razzeee,16,0.00102,313652,20.09203,1561077
2468,reversefold,16,0.00102,313668,20.09305,1561077
2469,rhadman,16,0.00102,313684,20.09408,1561077
2470,RSO,16,0.00102,313700,20.09510,1561077
2471,sarveshhh,16,0.00102,313716,20.09613,1561077
2472,sevennt,16,0.00102,313732,20.09715,1561077
2473,sfarbota,16,0.00102,313748,20.09818,1561077
2474,Shasthri,16,0.00102,313764,20.09920,1561077
2475,shazy792,16,0.00102,313780,20.10023,1561077
2476,shivabommakanti03,16,0.00102,313796,20.10125,1561077
2477,SimonMatthews-BP,16,0.00102,313812,20.10228,1561077
2478,SimonStJG,16,0.00102,313828,20.10330,1561077
2479,simonychoy,16,0.00102,313844,20.10433,1561077
2480,smokris,16,0.00102,313860,20.10535,1561077
2481,s-morita-being,16,0.00102,313876,20.10638,1561077
2482,somaathetechster,16,0.00102,313892,20.10740,1561077
2483,sorend,16,0.00102,313908,20.10843,1561077
2484,srnjak,16,0.00102,313924,20.10945,1561077
2485,stsully,16,0.00102,313940,20.11048,1561077
2486,tanelso2,16,0.00102,313956,20.11150,1561077
2487,tik-son,16,0.00102,313972,20.11252,1561077
2488,tmilligan-skytap,16,0.00102,313988,20.11355,1561077
2489,ttodua,16,0.00102,314004,20.11457,1561077
2490,uny,16,0.00102,314020,20.11560,1561077
2491,usrleon,16,0.00102,314036,20.11662,1561077
2492,valiksb,16,0.00102,314052,20.11765,1561077
2493,waciuma4pivotal,16,0.00102,314068,20.11867,1561077
2494,wisemao,16,0.00102,314084,20.11970,1561077
2495,wl2776,16,0.00102,314100,20.12072,1561077
2496,wumpz,16,0.00102,314116,20.12175,1561077
2497,Xaseron,16,0.00102,314132,20.12277,1561077
2498,yannickpulver,16,0.00102,314148,20.12380,1561077
2499,zentoaku,16,0.00102,314164,20.12482,1561077
2500,zippolyte,16,0.00102,314180,20.12585,1561077
2501,zrashwani,16,0.00102,314196,20.12687,1561077
2502,1100101,15,0.00096,314211,20.12783,1561077
2503,1215904405a,15,0.00096,314226,20.12880,1561077
2504,4killo,15,0.00096,314241,20.12976,1561077
2505,aairey,15,0.00096,314256,20.13072,1561077
2506,aajimal,15,0.00096,314271,20.13168,1561077
2507,aakashkanvinde,15,0.00096,314286,20.13264,1561077
2508,adityakalia,15,0.00096,314301,20.13360,1561077
2509,adriantirea,15,0.00096,314316,20.13456,1561077
2510,AgileAOTeam,15,0.00096,314331,20.13552,1561077
2511,ahsannaseem,15,0.00096,314346,20.13648,1561077
2512,alatalo,15,0.00096,314361,20.13744,1561077
2513,alexey-pelykh,15,0.00096,314376,20.13840,1561077
2514,alex-ko-dev,15,0.00096,314391,20.13937,1561077
2515,alinpa,15,0.00096,314406,20.14033,1561077
2516,ampledata,15,0.00096,314421,20.14129,1561077
2517,amyjohnston,15,0.00096,314436,20.14225,1561077
2518,AngryGami,15,0.00096,314451,20.14321,1561077
2519,arunpnetskope,15,0.00096,314466,20.14417,1561077
2520,bartoszkaczkowski,15,0.00096,314481,20.14513,1561077
2521,bebehei,15,0.00096,314496,20.14609,1561077
2522,bharathvenkatrajan,15,0.00096,314511,20.14705,1561077
2523,bhubert,15,0.00096,314526,20.14801,1561077
2524,binkkatal,15,0.00096,314541,20.14897,1561077
2525,Booooooger,15,0.00096,314556,20.14993,1561077
2526,briceburg,15,0.00096,314571,20.15090,1561077
2527,Bryksin,15,0.00096,314586,20.15186,1561077
2528,Cervator,15,0.00096,314601,20.15282,1561077
2529,chrisliu529,15,0.00096,314616,20.15378,1561077
2530,cj-taylor,15,0.00096,314631,20.15474,1561077
2531,contactsaurabh,15,0.00096,314646,20.15570,1561077
2532,cottsay,15,0.00096,314661,20.15666,1561077
2533,ctennis,15,0.00096,314676,20.15762,1561077
2534,danai-andriopoulou,15,0.00096,314691,20.15858,1561077
2535,danalbu,15,0.00096,314706,20.15954,1561077
2536,DanielHouston,15,0.00096,314721,20.16050,1561077
2537,db0,15,0.00096,314736,20.16147,1561077
2538,dbeezt,15,0.00096,314751,20.16243,1561077
2539,dbreheret,15,0.00096,314766,20.16339,1561077
2540,dbut023,15,0.00096,314781,20.16435,1561077
2541,denisscapinrecalde,15,0.00096,314796,20.16531,1561077
2542,derekmiller,15,0.00096,314811,20.16627,1561077
2543,derrickgw,15,0.00096,314826,20.16723,1561077
2544,DevNovalys,15,0.00096,314841,20.16819,1561077
2545,dlujic,15,0.00096,314856,20.16915,1561077
2546,eddyhub,15,0.00096,314871,20.17011,1561077
2547,elupus,15,0.00096,314886,20.17107,1561077
2548,exi,15,0.00096,314901,20.17204,1561077
2549,Farix1337,15,0.00096,314916,20.17300,1561077
2550,fordperfect78,15,0.00096,314931,20.17396,1561077
2551,foxhound91,15,0.00096,314946,20.17492,1561077
2552,GaelicGamer,15,0.00096,314961,20.17588,1561077
2553,garyduan,15,0.00096,314976,20.17684,1561077
2554,grayaii,15,0.00096,314991,20.17780,1561077
2555,grv87,15,0.00096,315006,20.17876,1561077
2556,gwynjudd,15,0.00096,315021,20.17972,1561077
2557,halestock,15,0.00096,315036,20.18068,1561077
2558,hangchan,15,0.00096,315051,20.18164,1561077
2559,haocheng,15,0.00096,315066,20.18260,1561077
2560,HeidiRechek,15,0.00096,315081,20.18357,1561077
2561,helenelau,15,0.00096,315096,20.18453,1561077
2562,helver,15,0.00096,315111,20.18549,1561077
2563,hiradha,15,0.00096,315126,20.18645,1561077
2564,hoff121324,15,0.00096,315141,20.18741,1561077
2565,holly-cummins,15,0.00096,315156,20.18837,1561077
2566,hybmg57,15,0.00096,315171,20.18933,1561077
2567,ian-twilightcoder,15,0.00096,315186,20.19029,1561077
2568,ja98200wilcox,15,0.00096,315201,20.19125,1561077
2569,jacobhjkim,15,0.00096,315216,20.19221,1561077
2570,jaekunchoi,15,0.00096,315231,20.19317,1561077
2571,jaggs6,15,0.00096,315246,20.19414,1561077
2572,jasonkuster,15,0.00096,315261,20.19510,1561077
2573,jdonald,15,0.00096,315276,20.19606,1561077
2574,jgramoll,15,0.00096,315291,20.19702,1561077
2575,jhammell,15,0.00096,315306,20.19798,1561077
2576,jinzishuai,15,0.00096,315321,20.19894,1561077
2577,jitendar-singh,15,0.00096,315336,20.19990,1561077
2578,johnny-b-goode,15,0.00096,315351,20.20086,1561077
2579,Jonny-vb,15,0.00096,315366,20.20182,1561077
2580,jSchnitzer1,15,0.00096,315381,20.20278,1561077
2581,juliole,15,0.00096,315396,20.20374,1561077
2582,KaKeimei,15,0.00096,315411,20.20470,1561077
2583,KamikaZeeFu,15,0.00096,315426,20.20567,1561077
2584,katsew,15,0.00096,315441,20.20663,1561077
2585,kcbaltz,15,0.00096,315456,20.20759,1561077
2586,kei-yamazaki,15,0.00096,315471,20.20855,1561077
2587,kflavin,15,0.00096,315486,20.20951,1561077
2588,KishoreMandyam,15,0.00096,315501,20.21047,1561077
2589,knatch,15,0.00096,315516,20.21143,1561077
2590,kopax,15,0.00096,315531,20.21239,1561077
2591,krolol,15,0.00096,315546,20.21335,1561077
2592,ktraister,15,0.00096,315561,20.21431,1561077
2593,kvdz,15,0.00096,315576,20.21527,1561077
2594,larrycai,15,0.00096,315591,20.21624,1561077
2595,learnteds,15,0.00096,315606,20.21720,1561077
2596,lelik9,15,0.00096,315621,20.21816,1561077
2597,lenaing,15,0.00096,315636,20.21912,1561077
2598,Letty5411,15,0.00096,315651,20.22008,1561077
2599,LokiNightray,15,0.00096,315666,20.22104,1561077
2600,martens-d,15,0.00096,315681,20.22200,1561077
2601,mathias-nyman,15,0.00096,315696,20.22296,1561077
2602,mathurpranjal,15,0.00096,315711,20.22392,1561077
2603,medwards,15,0.00096,315726,20.22488,1561077
2604,meirvdoo,15,0.00096,315741,20.22584,1561077
2605,mgoreckaParasoft,15,0.00096,315756,20.22680,1561077
2606,MichalFoksa,15,0.00096,315771,20.22777,1561077
2607,Minreaux,15,0.00096,315786,20.22873,1561077
2608,missingcharacter,15,0.00096,315801,20.22969,1561077
2609,mi-wang,15,0.00096,315816,20.23065,1561077
2610,MorganGeek,15,0.00096,315831,20.23161,1561077
2611,mramanathan,15,0.00096,315846,20.23257,1561077
2612,mrvcmrvc,15,0.00096,315861,20.23353,1561077
2613,NagleZhang,15,0.00096,315876,20.23449,1561077
2614,nanoninja-formation,15,0.00096,315891,20.23545,1561077
2615,nebuk4d,15,0.00096,315906,20.23641,1561077
2616,netflixgithub,15,0.00096,315921,20.23737,1561077
2617,nitrogear,15,0.00096,315936,20.23834,1561077
2618,noni73,15,0.00096,315951,20.23930,1561077
2619,notaturkey,15,0.00096,315966,20.24026,1561077
2620,orevial,15,0.00096,315981,20.24122,1561077
2621,ouaibsky,15,0.00096,315996,20.24218,1561077
2622,pacchii,15,0.00096,316011,20.24314,1561077
2623,paloaltonetworks-kpena,15,0.00096,316026,20.24410,1561077
2624,pemmasanikrishna,15,0.00096,316041,20.24506,1561077
2625,Pesa,15,0.00096,316056,20.24602,1561077
2626,pespinel,15,0.00096,316071,20.24698,1561077
2627,peterhauke,15,0.00096,316086,20.24794,1561077
2628,phebe-vickers,15,0.00096,316101,20.24891,1561077
2629,ph-One,15,0.00096,316116,20.24987,1561077
2630,pjrt,15,0.00096,316131,20.25083,1561077
2631,placydo,15,0.00096,316146,20.25179,1561077
2632,ptrsny,15,0.00096,316161,20.25275,1561077
2633,pwielgolaski,15,0.00096,316176,20.25371,1561077
2634,qguantwer,15,0.00096,316191,20.25467,1561077
2635,Quaiks,15,0.00096,316206,20.25563,1561077
2636,raspy,15,0.00096,316221,20.25659,1561077
2637,redfive,15,0.00096,316236,20.25755,1561077
2638,rhotau,15,0.00096,316251,20.25851,1561077
2639,rhutchison,15,0.00096,316266,20.25947,1561077
2640,RiederAlex,15,0.00096,316281,20.26044,1561077
2641,rishu2403,15,0.00096,316296,20.26140,1561077
2642,robbert229,15,0.00096,316311,20.26236,1561077
2643,rodriguezsergio,15,0.00096,316326,20.26332,1561077
2644,SaarthakMaini,15,0.00096,316341,20.26428,1561077
2645,Sagar2366,15,0.00096,316356,20.26524,1561077
2646,Sam123ben,15,0.00096,316371,20.26620,1561077
2647,sarabesh,15,0.00096,316386,20.26716,1561077
2648,scadu,15,0.00096,316401,20.26812,1561077
2649,sdhoka,15,0.00096,316416,20.26908,1561077
2650,sethjackson,15,0.00096,316431,20.27004,1561077
2651,sgleske-ias,15,0.00096,316446,20.27101,1561077
2652,s-lal,15,0.00096,316461,20.27197,1561077
2653,soenkekueper,15,0.00096,316476,20.27293,1561077
2654,syed-ali96,15,0.00096,316491,20.27389,1561077
2655,sysadmin4j,15,0.00096,316506,20.27485,1561077
2656,t25garg,15,0.00096,316521,20.27581,1561077
2657,thanhqle,15,0.00096,316536,20.27677,1561077
2658,thesam,15,0.00096,316551,20.27773,1561077
2659,thomasnemer,15,0.00096,316566,20.27869,1561077
2660,tkleiber,15,0.00096,316581,20.27965,1561077
2661,tnguyen14,15,0.00096,316596,20.28061,1561077
2662,torioLuz,15,0.00096,316611,20.28157,1561077
2663,tterrag1098,15,0.00096,316626,20.28254,1561077
2664,ttsalonen,15,0.00096,316641,20.28350,1561077
2665,vb-linetco,15,0.00096,316656,20.28446,1561077
2666,vhegde2017,15,0.00096,316671,20.28542,1561077
2667,ViliusS,15,0.00096,316686,20.28638,1561077
2668,vzabawski,15,0.00096,316701,20.28734,1561077
2669,wawrzek,15,0.00096,316716,20.28830,1561077
2670,wkazunori,15,0.00096,316731,20.28926,1561077
2671,xtofl,15,0.00096,316746,20.29022,1561077
2672,yeoldegrove,15,0.00096,316761,20.29118,1561077
2673,zeyangli,15,0.00096,316776,20.29214,1561077
2674,zkay,15,0.00096,316791,20.29311,1561077
2675,7FM,14,0.00090,316805,20.29400,1561077
2676,aadeshpa,14,0.00090,316819,20.29490,1561077
2677,aakavalevich,14,0.00090,316833,20.29580,1561077
2678,abe21412,14,0.00090,316847,20.29669,1561077
2679,adamlazz,14,0.00090,316861,20.29759,1561077
2680,AfiMaameDufie,14,0.00090,316875,20.29849,1561077
2681,aivaniuk,14,0.00090,316889,20.29938,1561077
2682,alexeygrigorovaurea,14,0.00090,316903,20.30028,1561077
2683,AlexRukhlin,14,0.00090,316917,20.30118,1561077
2684,amino19,14,0.00090,316931,20.30207,1561077
2685,AnalogJ,14,0.00090,316945,20.30297,1561077
2686,anilkumarpasupuleti,14,0.00090,316959,20.30387,1561077
2687,ant1dot,14,0.00090,316973,20.30476,1561077
2688,anttipitkanen,14,0.00090,316987,20.30566,1561077
2689,anup13kumar,14,0.00090,317001,20.30656,1561077
2690,arnosthavelka,14,0.00090,317015,20.30745,1561077
2691,artkrz,14,0.00090,317029,20.30835,1561077
2692,athilaelhuno,14,0.00090,317043,20.30925,1561077
2693,awick,14,0.00090,317057,20.31014,1561077
2694,balous,14,0.00090,317071,20.31104,1561077
2695,baruKreddy,14,0.00090,317085,20.31194,1561077
2696,ben-manes,14,0.00090,317099,20.31284,1561077
2697,bhardwajankur3,14,0.00090,317113,20.31373,1561077
2698,bhaskar-chenchu,14,0.00090,317127,20.31463,1561077
2699,bhram999,14,0.00090,317141,20.31553,1561077
2700,bigon,14,0.00090,317155,20.31642,1561077
2701,bingshiao,14,0.00090,317169,20.31732,1561077
2702,BradPatras,14,0.00090,317183,20.31822,1561077
2703,bradq,14,0.00090,317197,20.31911,1561077
2704,brec,14,0.00090,317211,20.32001,1561077
2705,brovoca,14,0.00090,317225,20.32091,1561077
2706,carbonetes,14,0.00090,317239,20.32180,1561077
2707,carlosgv87,14,0.00090,317253,20.32270,1561077
2708,CatherineKiiru,14,0.00090,317267,20.32360,1561077
2709,cbek,14,0.00090,317281,20.32449,1561077
2710,Chenyfg,14,0.00090,317295,20.32539,1561077
2711,claytopiccinin,14,0.00090,317309,20.32629,1561077
2712,codiophile,14,0.00090,317323,20.32718,1561077
2713,conf,14,0.00090,317337,20.32808,1561077
2714,corey2604,14,0.00090,317351,20.32898,1561077
2715,courtarro,14,0.00090,317365,20.32987,1561077
2716,cschoell,14,0.00090,317379,20.33077,1561077
2717,dancb10,14,0.00090,317393,20.33167,1561077
2718,daniele-xp,14,0.00090,317407,20.33257,1561077
2719,daniel-pottenger,14,0.00090,317421,20.33346,1561077
2720,danseo-reisys,14,0.00090,317435,20.33436,1561077
2721,darius-m,14,0.00090,317449,20.33526,1561077
2722,dbroady1,14,0.00090,317463,20.33615,1561077
2723,dermotcanniffe,14,0.00090,317477,20.33705,1561077
2724,dgoetsch,14,0.00090,317491,20.33795,1561077
2725,dongyy,14,0.00090,317505,20.33884,1561077
2726,driverpt,14,0.00090,317519,20.33974,1561077
2727,dylanbernhardt,14,0.00090,317533,20.34064,1561077
2728,edmundcraske,14,0.00090,317547,20.34153,1561077
2729,edwardmlyte,14,0.00090,317561,20.34243,1561077
2730,ehmke,14,0.00090,317575,20.34333,1561077
2731,emelianrus,14,0.00090,317589,20.34422,1561077
2732,Epsilon-B,14,0.00090,317603,20.34512,1561077
2733,fbonerandi,14,0.00090,317617,20.34602,1561077
2734,fragpit,14,0.00090,317631,20.34691,1561077
2735,FredrikSeidl,14,0.00090,317645,20.34781,1561077
2736,frydaykg,14,0.00090,317659,20.34871,1561077
2737,fsimmend,14,0.00090,317673,20.34960,1561077
2738,fslev,14,0.00090,317687,20.35050,1561077
2739,garyyang85,14,0.00090,317701,20.35140,1561077
2740,gclayburg,14,0.00090,317715,20.35230,1561077
2741,Gogs008,14,0.00090,317729,20.35319,1561077
2742,guillaumelecerf,14,0.00090,317743,20.35409,1561077
2743,gulyas-istvan-netlock-hu,14,0.00090,317757,20.35499,1561077
2744,haidouks,14,0.00090,317771,20.35588,1561077
2745,hidehitof,14,0.00090,317785,20.35678,1561077
2746,Hildebrand-Ritense,14,0.00090,317799,20.35768,1561077
2747,hodgesmr,14,0.00090,317813,20.35857,1561077
2748,ibexmonj,14,0.00090,317827,20.35947,1561077
2749,imakowski,14,0.00090,317841,20.36037,1561077
2750,IncredibleLou,14,0.00090,317855,20.36126,1561077
2751,inidona,14,0.00090,317869,20.36216,1561077
2752,ivkrishna-mf,14,0.00090,317883,20.36306,1561077
2753,james-powis,14,0.00090,317897,20.36395,1561077
2754,jaydee864,14,0.00090,317911,20.36485,1561077
2755,jbaldassari,14,0.00090,317925,20.36575,1561077
2756,jbaranov,14,0.00090,317939,20.36664,1561077
2757,jiakalita,14,0.00090,317953,20.36754,1561077
2758,jieryn,14,0.00090,317967,20.36844,1561077
2759,jmhga44a,14,0.00090,317981,20.36933,1561077
2760,joshhale,14,0.00090,317995,20.37023,1561077
2761,josholadele,14,0.00090,318009,20.37113,1561077
2762,juro994,14,0.00090,318023,20.37203,1561077
2763,kakumara,14,0.00090,318037,20.37292,1561077
2764,kalpshekhar,14,0.00090,318051,20.37382,1561077
2765,kaosmonk,14,0.00090,318065,20.37472,1561077
2766,kevlarjacket,14,0.00090,318079,20.37561,1561077
2767,ko28,14,0.00090,318093,20.37651,1561077
2768,krasilnikov-dmitriy,14,0.00090,318107,20.37741,1561077
2769,larrysingleton,14,0.00090,318121,20.37830,1561077
2770,lavaliere,14,0.00090,318135,20.37920,1561077
2771,lcmrvk,14,0.00090,318149,20.38010,1561077
2772,leelasharma,14,0.00090,318163,20.38099,1561077
2773,LegallGuillaume,14,0.00090,318177,20.38189,1561077
2774,lgemeinhardt,14,0.00090,318191,20.38279,1561077
2775,liaogz82,14,0.00090,318205,20.38368,1561077
2776,LinkMJB,14,0.00090,318219,20.38458,1561077
2777,lioramilbaum,14,0.00090,318233,20.38548,1561077
2778,loispostula,14,0.00090,318247,20.38637,1561077
2779,longc,14,0.00090,318261,20.38727,1561077
2780,longping-t,14,0.00090,318275,20.38817,1561077
2781,lookis,14,0.00090,318289,20.38906,1561077
2782,Lord-Y,14,0.00090,318303,20.38996,1561077
2783,luisalves00,14,0.00090,318317,20.39086,1561077
2784,luka5,14,0.00090,318331,20.39176,1561077
2785,lukmy,14,0.00090,318345,20.39265,1561077
2786,lupalby,14,0.00090,318359,20.39355,1561077
2787,MaitreyaBuddha,14,0.00090,318373,20.39445,1561077
2788,marcoreni,14,0.00090,318387,20.39534,1561077
2789,marktisham,14,0.00090,318401,20.39624,1561077
2790,markusdlugi,14,0.00090,318415,20.39714,1561077
2791,marsdalesa,14,0.00090,318429,20.39803,1561077
2792,martingrosche,14,0.00090,318443,20.39893,1561077
2793,martinm82,14,0.00090,318457,20.39983,1561077
2794,mathieu-pousse,14,0.00090,318471,20.40072,1561077
2795,mattigot,14,0.00090,318485,20.40162,1561077
2796,mausspb,14,0.00090,318499,20.40252,1561077
2797,McDingl,14,0.00090,318513,20.40341,1561077
2798,mederel,14,0.00090,318527,20.40431,1561077
2799,meenachauhan,14,0.00090,318541,20.40521,1561077
2800,merlindam,14,0.00090,318555,20.40610,1561077
2801,mikaelmh,14,0.00090,318569,20.40700,1561077
2802,minkjj,14,0.00090,318583,20.40790,1561077
2803,mkemmerz,14,0.00090,318597,20.40879,1561077
2804,mkrzywanski,14,0.00090,318611,20.40969,1561077
2805,mmalicki,14,0.00090,318625,20.41059,1561077
2806,moertel,14,0.00090,318639,20.41149,1561077
2807,MorrisJobke,14,0.00090,318653,20.41238,1561077
2808,msven,14,0.00090,318667,20.41328,1561077
2809,munnyraht,14,0.00090,318681,20.41418,1561077
2810,n360speed,14,0.00090,318695,20.41507,1561077
2811,nahumtimerman,14,0.00090,318709,20.41597,1561077
2812,nneul,14,0.00090,318723,20.41687,1561077
2813,nvoxland,14,0.00090,318737,20.41776,1561077
2814,nzmsv,14,0.00090,318751,20.41866,1561077
2815,Or-Geva,14,0.00090,318765,20.41956,1561077
2816,pampadams,14,0.00090,318779,20.42045,1561077
2817,patricklangsonos,14,0.00090,318793,20.42135,1561077
2818,paul-uz,14,0.00090,318807,20.42225,1561077
2819,pixman20,14,0.00090,318821,20.42314,1561077
2820,pwillis-els,14,0.00090,318835,20.42404,1561077
2821,pwlae,14,0.00090,318849,20.42494,1561077
2822,rakewill,14,0.00090,318863,20.42583,1561077
2823,rast1025,14,0.00090,318877,20.42673,1561077
2824,rda1ton,14,0.00090,318891,20.42763,1561077
2825,ricoli,14,0.00090,318905,20.42852,1561077
2826,rochana-atapattu,14,0.00090,318919,20.42942,1561077
2827,roncemer,14,0.00090,318933,20.43032,1561077
2828,ronvelzeboer,14,0.00090,318947,20.43122,1561077
2829,rpanak-generalbytes,14,0.00090,318961,20.43211,1561077
2830,ryanthws,14,0.00090,318975,20.43301,1561077
2831,Salecto-Devops,14,0.00090,318989,20.43391,1561077
2832,samatha-kankipati,14,0.00090,319003,20.43480,1561077
2833,savujevi,14,0.00090,319017,20.43570,1561077
2834,saxonww,14,0.00090,319031,20.43660,1561077
2835,scottashipp,14,0.00090,319045,20.43749,1561077
2836,SeanTurner026,14,0.00090,319059,20.43839,1561077
2837,sekmarco,14,0.00090,319073,20.43929,1561077
2838,sergeychipiga,14,0.00090,319087,20.44018,1561077
2839,sha9963,14,0.00090,319101,20.44108,1561077
2840,sheepdreamofandroids,14,0.00090,319115,20.44198,1561077
2841,shuknk8s,14,0.00090,319129,20.44287,1561077
2842,siddharthkaushal90,14,0.00090,319143,20.44377,1561077
2843,SirCmpwn,14,0.00090,319157,20.44467,1561077
2844,smhc,14,0.00090,319171,20.44556,1561077
2845,smootoo,14,0.00090,319185,20.44646,1561077
2846,SOFYAIOFFICIAL,14,0.00090,319199,20.44736,1561077
2847,sonyafenge,14,0.00090,319213,20.44825,1561077
2848,Spenser309,14,0.00090,319227,20.44915,1561077
2849,SteveDonie,14,0.00090,319241,20.45005,1561077
2850,sumo-apps-team,14,0.00090,319255,20.45095,1561077
2851,svijee,14,0.00090,319269,20.45184,1561077
2852,thehustler088,14,0.00090,319283,20.45274,1561077
2853,thomasleveil,14,0.00090,319297,20.45364,1561077
2854,timoinstana,14,0.00090,319311,20.45453,1561077
2855,tiyberius,14,0.00090,319325,20.45543,1561077
2856,tomk3003,14,0.00090,319339,20.45633,1561077
2857,tommysdk,14,0.00090,319353,20.45722,1561077
2858,tonaim,14,0.00090,319367,20.45812,1561077
2859,tploss,14,0.00090,319381,20.45902,1561077
2860,TrueDub,14,0.00090,319395,20.45991,1561077
2861,tschaible,14,0.00090,319409,20.46081,1561077
2862,u5surf,14,0.00090,319423,20.46171,1561077
2863,valsinats42,14,0.00090,319437,20.46260,1561077
2864,veita,14,0.00090,319451,20.46350,1561077
2865,ViceIce,14,0.00090,319465,20.46440,1561077
2866,vikashkmr31,14,0.00090,319479,20.46529,1561077
2867,viradan,14,0.00090,319493,20.46619,1561077
2868,volo-zyko,14,0.00090,319507,20.46709,1561077
2869,vwbusguy,14,0.00090,319521,20.46798,1561077
2870,Vynce,14,0.00090,319535,20.46888,1561077
2871,wei-lee,14,0.00090,319549,20.46978,1561077
2872,xino12,14,0.00090,319563,20.47068,1561077
2873,xkapil,14,0.00090,319577,20.47157,1561077
2874,xxBedy,14,0.00090,319591,20.47247,1561077
2875,yoerg,14,0.00090,319605,20.47337,1561077
2876,yrodiere,14,0.00090,319619,20.47426,1561077
2877,ysahil97,14,0.00090,319633,20.47516,1561077
2878,zakcrawford,14,0.00090,319647,20.47606,1561077
2879,zentavr,14,0.00090,319661,20.47695,1561077
2880,zhaoamong,14,0.00090,319675,20.47785,1561077
2881,zuzuviewer,14,0.00090,319689,20.47875,1561077
2882,321ravi,13,0.00083,319702,20.47958,1561077
2883,abhinaybyrisetty,13,0.00083,319715,20.48041,1561077
2884,adamjk-dev,13,0.00083,319728,20.48124,1561077
2885,adamwolf,13,0.00083,319741,20.48208,1561077
2886,adjavaherian,13,0.00083,319754,20.48291,1561077
2887,adoblas,13,0.00083,319767,20.48374,1561077
2888,AjeetGupta,13,0.00083,319780,20.48458,1561077
2889,AlexPykavy,13,0.00083,319793,20.48541,1561077
2890,allanlewis,13,0.00083,319806,20.48624,1561077
2891,amedee,13,0.00083,319819,20.48707,1561077
2892,amiteshchandra,13,0.00083,319832,20.48791,1561077
2893,AndreyLevchenko,13,0.00083,319845,20.48874,1561077
2894,andynelson,13,0.00083,319858,20.48957,1561077
2895,aolrich323,13,0.00083,319871,20.49041,1561077
2896,ari,13,0.00083,319884,20.49124,1561077
2897,art-of-dom,13,0.00083,319897,20.49207,1561077
2898,assaflavie,13,0.00083,319910,20.49290,1561077
2899,astoltz,13,0.00083,319923,20.49374,1561077
2900,atrigueiro,13,0.00083,319936,20.49457,1561077
2901,bashbers,13,0.00083,319949,20.49540,1561077
2902,basmith322,13,0.00083,319962,20.49623,1561077
2903,bboehmke,13,0.00083,319975,20.49707,1561077
2904,bborbe,13,0.00083,319988,20.49790,1561077
2905,ben-gineer,13,0.00083,320001,20.49873,1561077
2906,bensnet1,13,0.00083,320014,20.49957,1561077
2907,bernhardcygan,13,0.00083,320027,20.50040,1561077
2908,bglee,13,0.00083,320040,20.50123,1561077
2909,bhaktibhoj,13,0.00083,320053,20.50206,1561077
2910,blueoceandeploy,13,0.00083,320066,20.50290,1561077
2911,bobcode99,13,0.00083,320079,20.50373,1561077
2912,BogdanLivadariu,13,0.00083,320092,20.50456,1561077
2913,bracketttc,13,0.00083,320105,20.50539,1561077
2914,BurkHufnagel,13,0.00083,320118,20.50623,1561077
2915,carlosrodf,13,0.00083,320131,20.50706,1561077
2916,charanbir,13,0.00083,320144,20.50789,1561077
2917,charliezang,13,0.00083,320157,20.50873,1561077
2918,chathsuom,13,0.00083,320170,20.50956,1561077
2919,chiselwright,13,0.00083,320183,20.51039,1561077
2920,chrisaaaaa,13,0.00083,320196,20.51122,1561077
2921,chris-overend,13,0.00083,320209,20.51206,1561077
2922,cnicolov,13,0.00083,320222,20.51289,1561077
2923,csogilvie,13,0.00083,320235,20.51372,1561077
2924,cxadmin,13,0.00083,320248,20.51456,1561077
2925,dafangc-amazon,13,0.00083,320261,20.51539,1561077
2926,davidhart82,13,0.00083,320274,20.51622,1561077
2927,davissp14,13,0.00083,320287,20.51705,1561077
2928,ddooley77,13,0.00083,320300,20.51789,1561077
2929,dgetzlaf,13,0.00083,320313,20.51872,1561077
2930,diogopcx,13,0.00083,320326,20.51955,1561077
2931,DirkRichter,13,0.00083,320339,20.52038,1561077
2932,Dispader,13,0.00083,320352,20.52122,1561077
2933,djtecha,13,0.00083,320365,20.52205,1561077
2934,dolfinsbizou,13,0.00083,320378,20.52288,1561077
2935,dongdan39,13,0.00083,320391,20.52372,1561077
2936,dove-young,13,0.00083,320404,20.52455,1561077
2937,dperezro,13,0.00083,320417,20.52538,1561077
2938,drwoods,13,0.00083,320430,20.52621,1561077
2939,dsolovyev,13,0.00083,320443,20.52705,1561077
2940,dtheobald,13,0.00083,320456,20.52788,1561077
2941,dwilliams-armory,13,0.00083,320469,20.52871,1561077
2942,EastWoodYang,13,0.00083,320482,20.52954,1561077
2943,EduJGURJC,13,0.00083,320495,20.53038,1561077
2944,eskobaba,13,0.00083,320508,20.53121,1561077
2945,firmsoil,13,0.00083,320521,20.53204,1561077
2946,fonsecas72,13,0.00083,320534,20.53288,1561077
2947,frendos,13,0.00083,320547,20.53371,1561077
2948,funtastix,13,0.00083,320560,20.53454,1561077
2949,fxnn,13,0.00083,320573,20.53537,1561077
2950,geerligs,13,0.00083,320586,20.53621,1561077
2951,ge-vi,13,0.00083,320599,20.53704,1561077
2952,ginosubscriptions,13,0.00083,320612,20.53787,1561077
2953,GordonJess,13,0.00083,320625,20.53871,1561077
2954,gorkat,13,0.00083,320638,20.53954,1561077
2955,Gotier,13,0.00083,320651,20.54037,1561077
2956,Gozke,13,0.00083,320664,20.54120,1561077
2957,gregorymfoster,13,0.00083,320677,20.54204,1561077
2958,grogersxyz,13,0.00083,320690,20.54287,1561077
2959,guss77,13,0.00083,320703,20.54370,1561077
2960,GustavoBezerra,13,0.00083,320716,20.54453,1561077
2961,guyv,13,0.00083,320729,20.54537,1561077
2962,hcansiz,13,0.00083,320742,20.54620,1561077
2963,Hemali91,13,0.00083,320755,20.54703,1561077
2964,hieule2ntq,13,0.00083,320768,20.54787,1561077
2965,IamGabrielWu,13,0.00083,320781,20.54870,1561077
2966,ibauersachs,13,0.00083,320794,20.54953,1561077
2967,idiamant,13,0.00083,320807,20.55036,1561077
2968,idstein,13,0.00083,320820,20.55120,1561077
2969,Ippo343,13,0.00083,320833,20.55203,1561077
2970,jakeegan10,13,0.00083,320846,20.55286,1561077
2971,jamesbeedy,13,0.00083,320859,20.55369,1561077
2972,jbdelpech,13,0.00083,320872,20.55453,1561077
2973,jensamberg,13,0.00083,320885,20.55536,1561077
2974,jerbia,13,0.00083,320898,20.55619,1561077
2975,jernst,13,0.00083,320911,20.55703,1561077
2976,JKlintholm,13,0.00083,320924,20.55786,1561077
2977,jlong,13,0.00083,320937,20.55869,1561077
2978,jlordiales,13,0.00083,320950,20.55952,1561077
2979,jmcampanini,13,0.00083,320963,20.56036,1561077
2980,jochenberger,13,0.00083,320976,20.56119,1561077
2981,jon-schuck-MA,13,0.00083,320989,20.56202,1561077
2982,jpbriend,13,0.00083,321002,20.56286,1561077
2983,jsdevel,13,0.00083,321015,20.56369,1561077
2984,kad-vriese1,13,0.00083,321028,20.56452,1561077
2985,kaitea,13,0.00083,321041,20.56535,1561077
2986,khebbie,13,0.00083,321054,20.56619,1561077
2987,Kilomoana83,13,0.00083,321067,20.56702,1561077
2988,kleph,13,0.00083,321080,20.56785,1561077
2989,kobayashi,13,0.00083,321093,20.56868,1561077
2990,ktaborski,13,0.00083,321106,20.56952,1561077
2991,kumarshorav11,13,0.00083,321119,20.57035,1561077
2992,leechungkyu,13,0.00083,321132,20.57118,1561077
2993,lehlen,13,0.00083,321145,20.57202,1561077
2994,Lironrad,13,0.00083,321158,20.57285,1561077
2995,loopio,13,0.00083,321171,20.57368,1561077
2996,ltutar,13,0.00083,321184,20.57451,1561077
2997,lucajung,13,0.00083,321197,20.57535,1561077
2998,lwhsu,13,0.00083,321210,20.57618,1561077
2999,maciejurbanskisaucelabs,13,0.00083,321223,20.57701,1561077
3000,MALPI,13,0.00083,321236,20.57784,1561077
3001,marco-krammer,13,0.00083,321249,20.57868,1561077
3002,mark-rekveld-sonarsource,13,0.00083,321262,20.57951,1561077
3003,marthinsen,13,0.00083,321275,20.58034,1561077
3004,mbakhoff,13,0.00083,321288,20.58118,1561077
3005,michaelgalloway,13,0.00083,321301,20.58201,1561077
3006,MichaelGreco,13,0.00083,321314,20.58284,1561077
3007,mortenbirkelund,13,0.00083,321327,20.58367,1561077
3008,msabastian,13,0.00083,321340,20.58451,1561077
3009,mulawamichal,13,0.00083,321353,20.58534,1561077
3010,Nancy-Chauhan,13,0.00083,321366,20.58617,1561077
3011,ndcampbell,13,0.00083,321379,20.58700,1561077
3012,nirgilboa,13,0.00083,321392,20.58784,1561077
3013,noam123,13,0.00083,321405,20.58867,1561077
3014,n-rodriguez,13,0.00083,321418,20.58950,1561077
3015,olegchorny,13,0.00083,321431,20.59034,1561077
3016,OliverPereira,13,0.00083,321444,20.59117,1561077
3017,OrangeDog,13,0.00083,321457,20.59200,1561077
3018,Outconn2016,13,0.00083,321470,20.59283,1561077
3019,ovidiub13,13,0.00083,321483,20.59367,1561077
3020,padyx,13,0.00083,321496,20.59450,1561077
3021,pamgluss-slack,13,0.00083,321509,20.59533,1561077
3022,pascal910107,13,0.00083,321522,20.59617,1561077
3023,PatrickRogg,13,0.00083,321535,20.59700,1561077
3024,petewilcock,13,0.00083,321548,20.59783,1561077
3025,phpboyscout,13,0.00083,321561,20.59866,1561077
3026,pmgupte,13,0.00083,321574,20.59950,1561077
3027,pmv,13,0.00083,321587,20.60033,1561077
3028,pod2metra,13,0.00083,321600,20.60116,1561077
3029,prashankprince,13,0.00083,321613,20.60199,1561077
3030,prawen,13,0.00083,321626,20.60283,1561077
3031,preddymm,13,0.00083,321639,20.60366,1561077
3032,Pymann,13,0.00083,321652,20.60449,1561077
3033,qiuxin,13,0.00083,321665,20.60533,1561077
3034,Queen-esther01,13,0.00083,321678,20.60616,1561077
3035,rajeev-ranjan7,13,0.00083,321691,20.60699,1561077
3036,rathneesh,13,0.00083,321704,20.60782,1561077
3037,readerx,13,0.00083,321717,20.60866,1561077
3038,RealCLanger,13,0.00083,321730,20.60949,1561077
3039,rgrimley-r7,13,0.00083,321743,20.61032,1561077
3040,RohanBhanderi,13,0.00083,321756,20.61115,1561077
3041,rohel01,13,0.00083,321769,20.61199,1561077
3042,RPGillespie6,13,0.00083,321782,20.61282,1561077
3043,ryoichitaniguchi,13,0.00083,321795,20.61365,1561077
3044,Saibamen,13,0.00083,321808,20.61449,1561077
3045,Salkinmelen,13,0.00083,321821,20.61532,1561077
3046,SarveshLimaye,13,0.00083,321834,20.61615,1561077
3047,sauliusgrigaitis,13,0.00083,321847,20.61698,1561077
3048,schnatterer,13,0.00083,321860,20.61782,1561077
3049,schribl,13,0.00083,321873,20.61865,1561077
3050,ScoobyChris,13,0.00083,321886,20.61948,1561077
3051,ScOut3R,13,0.00083,321899,20.62032,1561077
3052,seanwarren,13,0.00083,321912,20.62115,1561077
3053,sfryffdc,13,0.00083,321925,20.62198,1561077
3054,sg3629,13,0.00083,321938,20.62281,1561077
3055,SHxKM,13,0.00083,321951,20.62365,1561077
3056,Sirrah,13,0.00083,321964,20.62448,1561077
3057,sitay93,13,0.00083,321977,20.62531,1561077
3058,skelliam,13,0.00083,321990,20.62614,1561077
3059,smdahmed,13,0.00083,322003,20.62698,1561077
3060,smnsch,13,0.00083,322016,20.62781,1561077
3061,spidey,13,0.00083,322029,20.62864,1561077
3062,stevejensen22,13,0.00083,322042,20.62948,1561077
3063,sturcol,13,0.00083,322055,20.63031,1561077
3064,sundeepkalt,13,0.00083,322068,20.63114,1561077
3065,sunjingyun,13,0.00083,322081,20.63197,1561077
3066,suthsc,13,0.00083,322094,20.63281,1561077
3067,suvirp,13,0.00083,322107,20.63364,1561077
3068,Syquel,13,0.00083,322120,20.63447,1561077
3069,szhem,13,0.00083,322133,20.63530,1561077
3070,t0r0X,13,0.00083,322146,20.63614,1561077
3071,TanjaRo1,13,0.00083,322159,20.63697,1561077
3072,tchrischan,13,0.00083,322172,20.63780,1561077
3073,tcollignon,13,0.00083,322185,20.63864,1561077
3074,testcocoon,13,0.00083,322198,20.63947,1561077
3075,ThoGro,13,0.00083,322211,20.64030,1561077
3076,thors,13,0.00083,322224,20.64113,1561077
3077,tjamet,13,0.00083,322237,20.64197,1561077
3078,tn-osimis,13,0.00083,322250,20.64280,1561077
3079,tobgen,13,0.00083,322263,20.64363,1561077
3080,tolnaisz,13,0.00083,322276,20.64447,1561077
3081,tomhau01,13,0.00083,322289,20.64530,1561077
3082,tomlankhorst,13,0.00083,322302,20.64613,1561077
3083,tom-smalls,13,0.00083,322315,20.64696,1561077
3084,TreverW,13,0.00083,322328,20.64780,1561077
3085,trqlcgcg,13,0.00083,322341,20.64863,1561077
3086,tynril,13,0.00083,322354,20.64946,1561077
3087,vaneyckt,13,0.00083,322367,20.65029,1561077
3088,vills,13,0.00083,322380,20.65113,1561077
3089,vuza,13,0.00083,322393,20.65196,1561077
3090,vvv444,13,0.00083,322406,20.65279,1561077
3091,wanglei-alive,13,0.00083,322419,20.65363,1561077
3092,wduda,13,0.00083,322432,20.65446,1561077
3093,wendywww,13,0.00083,322445,20.65529,1561077
3094,win-t,13,0.00083,322458,20.65612,1561077
3095,ximenes,13,0.00083,322471,20.65696,1561077
3096,xUrko,13,0.00083,322484,20.65779,1561077
3097,zionyx,13,0.00083,322497,20.65862,1561077
3098,zxavier94,13,0.00083,322510,20.65945,1561077
3099,030,12,0.00077,322522,20.66022,1561077
3100,0xFelix,12,0.00077,322534,20.66099,1561077
3101,278668433,12,0.00077,322546,20.66176,1561077
3102,aarondobbing,12,0.00077,322558,20.66253,1561077
3103,abhijaju,12,0.00077,322570,20.66330,1561077
3104,AdanUrbanReyesArmory,12,0.00077,322582,20.66407,1561077
3105,aelath,12,0.00077,322594,20.66484,1561077
3106,aflat,12,0.00077,322606,20.66560,1561077
3107,ahoward-conga,12,0.00077,322618,20.66637,1561077
3108,ajschmidt8,12,0.00077,322630,20.66714,1561077
3109,akhmadnurmuhammad,12,0.00077,322642,20.66791,1561077
3110,aknackiron,12,0.00077,322654,20.66868,1561077
3111,alan-schwarzenberger,12,0.00077,322666,20.66945,1561077
3112,alauregaillard,12,0.00077,322678,20.67022,1561077
3113,Alceatraz,12,0.00077,322690,20.67099,1561077
3114,alejojo,12,0.00077,322702,20.67175,1561077
3115,alered01,12,0.00077,322714,20.67252,1561077
3116,alokjoshi89,12,0.00077,322726,20.67329,1561077
3117,AndKiel,12,0.00077,322738,20.67406,1561077
3118,andreydanin,12,0.00077,322750,20.67483,1561077
3119,AnEmortalKid,12,0.00077,322762,20.67560,1561077
3120,apraovjr,12,0.00077,322774,20.67637,1561077
3121,Areiser,12,0.00077,322786,20.67714,1561077
3122,arfiqbal,12,0.00077,322798,20.67790,1561077
3123,arjungopisetty,12,0.00077,322810,20.67867,1561077
3124,artms,12,0.00077,322822,20.67944,1561077
3125,asadpiz,12,0.00077,322834,20.68021,1561077
3126,asengqi,12,0.00077,322846,20.68098,1561077
3127,astrisk,12,0.00077,322858,20.68175,1561077
3128,atai,12,0.00077,322870,20.68252,1561077
3129,avivek,12,0.00077,322882,20.68328,1561077
3130,azherebtsov,12,0.00077,322894,20.68405,1561077
3131,backtrackshubham,12,0.00077,322906,20.68482,1561077
3132,benjie332,12,0.00077,322918,20.68559,1561077
3133,Bertg,12,0.00077,322930,20.68636,1561077
3134,bettse,12,0.00077,322942,20.68713,1561077
3135,Bevigil,12,0.00077,322954,20.68790,1561077
3136,bholat,12,0.00077,322966,20.68867,1561077
3137,bhreinb,12,0.00077,322978,20.68943,1561077
3138,bikebilly,12,0.00077,322990,20.69020,1561077
3139,BlackJam44,12,0.00077,323002,20.69097,1561077
3140,BlueDragn,12,0.00077,323014,20.69174,1561077
3141,BogdanSukonnov,12,0.00077,323026,20.69251,1561077
3142,brenc,12,0.00077,323038,20.69328,1561077
3143,bschelberg,12,0.00077,323050,20.69405,1561077
3144,buchi-busireddy,12,0.00077,323062,20.69482,1561077
3145,budelmann,12,0.00077,323074,20.69558,1561077
3146,bytesandwich,12,0.00077,323086,20.69635,1561077
3147,camueller,12,0.00077,323098,20.69712,1561077
3148,Carbenium,12,0.00077,323110,20.69789,1561077
3149,carrenelloyd,12,0.00077,323122,20.69866,1561077
3150,cburne-oshyn,12,0.00077,323134,20.69943,1561077
3151,chanjetsdp,12,0.00077,323146,20.70020,1561077
3152,chriskotula,12,0.00077,323158,20.70096,1561077
3153,connorads,12,0.00077,323170,20.70173,1561077
3154,coreyjonoliver,12,0.00077,323182,20.70250,1561077
3155,cornelf,12,0.00077,323194,20.70327,1561077
3156,cvanes,12,0.00077,323206,20.70404,1561077
3157,Dainerx,12,0.00077,323218,20.70481,1561077
3158,damianb,12,0.00077,323230,20.70558,1561077
3159,DanArlowski,12,0.00077,323242,20.70635,1561077
3160,danielburgmann,12,0.00077,323254,20.70711,1561077
3161,dark0dave,12,0.00077,323266,20.70788,1561077
3162,dasanjan1296,12,0.00077,323278,20.70865,1561077
3163,daverod24,12,0.00077,323290,20.70942,1561077
3164,devsquash,12,0.00077,323302,20.71019,1561077
3165,dhobi,12,0.00077,323314,20.71096,1561077
3166,dhruv-dave,12,0.00077,323326,20.71173,1561077
3167,diginc,12,0.00077,323338,20.71250,1561077
3168,dipthegeezer,12,0.00077,323350,20.71326,1561077
3169,dmivankov,12,0.00077,323362,20.71403,1561077
3170,DonMcNamara,12,0.00077,323374,20.71480,1561077
3171,egullusahabt,12,0.00077,323386,20.71557,1561077
3172,emoxam,12,0.00077,323398,20.71634,1561077
3173,erancx,12,0.00077,323410,20.71711,1561077
3174,feliwir,12,0.00077,323422,20.71788,1561077
3175,ferrucciobongianni,12,0.00077,323434,20.71864,1561077
3176,fishfacemcgee,12,0.00077,323446,20.71941,1561077
3177,fostermi,12,0.00077,323458,20.72018,1561077
3178,fr34k8,12,0.00077,323470,20.72095,1561077
3179,fractal9,12,0.00077,323482,20.72172,1561077
3180,framillien,12,0.00077,323494,20.72249,1561077
3181,francisoud,12,0.00077,323506,20.72326,1561077
3182,franknarf8,12,0.00077,323518,20.72403,1561077
3183,gaelrottier,12,0.00077,323530,20.72479,1561077
3184,gio-neo,12,0.00077,323542,20.72556,1561077
3185,gitupxm163,12,0.00077,323554,20.72633,1561077
3186,gokhanoner,12,0.00077,323566,20.72710,1561077
3187,gpaciga,12,0.00077,323578,20.72787,1561077
3188,gtudan,12,0.00077,323590,20.72864,1561077
3189,gwaghmare,12,0.00077,323602,20.72941,1561077
3190,gwsu2008,12,0.00077,323614,20.73018,1561077
3191,gyuvaraj10,12,0.00077,323626,20.73094,1561077
3192,hangsuma,12,0.00077,323638,20.73171,1561077
3193,harshad16,12,0.00077,323650,20.73248,1561077
3194,hashbrowncipher,12,0.00077,323662,20.73325,1561077
3195,haxzie,12,0.00077,323674,20.73402,1561077
3196,Hellojungle,12,0.00077,323686,20.73479,1561077
3197,hho,12,0.00077,323698,20.73556,1561077
3198,Hmr-ramzi,12,0.00077,323710,20.73632,1561077
3199,hugoduncan,12,0.00077,323722,20.73709,1561077
3200,il--ya,12,0.00077,323734,20.73786,1561077
3201,ivanvandessel,12,0.00077,323746,20.73863,1561077
3202,izzekil,12,0.00077,323758,20.73940,1561077
3203,jainsahab,12,0.00077,323770,20.74017,1561077
3204,James-Dengel,12,0.00077,323782,20.74094,1561077
3205,jan-z,12,0.00077,323794,20.74171,1561077
3206,jay-nanduri,12,0.00077,323806,20.74247,1561077
3207,jbarlin,12,0.00077,323818,20.74324,1561077
3208,jbesta,12,0.00077,323830,20.74401,1561077
3209,jblaine,12,0.00077,323842,20.74478,1561077
3210,jeremylong,12,0.00077,323854,20.74555,1561077
3211,JGNanjappan,12,0.00077,323866,20.74632,1561077
3212,jimsnab,12,0.00077,323878,20.74709,1561077
3213,jmccann,12,0.00077,323890,20.74786,1561077
3214,Jmennius,12,0.00077,323902,20.74862,1561077
3215,joe-niland,12,0.00077,323914,20.74939,1561077
3216,Johann01,12,0.00077,323926,20.75016,1561077
3217,johnamac7,12,0.00077,323938,20.75093,1561077
3218,jommgoncalves,12,0.00077,323950,20.75170,1561077
3219,joshsleeper,12,0.00077,323962,20.75247,1561077
3220,Jotschi,12,0.00077,323974,20.75324,1561077
3221,jphartley,12,0.00077,323986,20.75401,1561077
3222,jplandolt,12,0.00077,323998,20.75477,1561077
3223,jrudolph,12,0.00077,324010,20.75554,1561077
3224,jvanderloo,12,0.00077,324022,20.75631,1561077
3225,kaka1365,12,0.00077,324034,20.75708,1561077
3226,KAllan357,12,0.00077,324046,20.75785,1561077
3227,kamiyaa,12,0.00077,324058,20.75862,1561077
3228,KamranMackey,12,0.00077,324070,20.75939,1561077
3229,karenewlees,12,0.00077,324082,20.76015,1561077
3230,Ka-Wing,12,0.00077,324094,20.76092,1561077
3231,KDvu,12,0.00077,324106,20.76169,1561077
3232,kennyg,12,0.00077,324118,20.76246,1561077
3233,kevinkjt2000,12,0.00077,324130,20.76323,1561077
3234,khatchad,12,0.00077,324142,20.76400,1561077
3235,KissConsult,12,0.00077,324154,20.76477,1561077
3236,koan00,12,0.00077,324166,20.76554,1561077
3237,ksalerno99,12,0.00077,324178,20.76630,1561077
3238,l3ender,12,0.00077,324190,20.76707,1561077
3239,Ladicek,12,0.00077,324202,20.76784,1561077
3240,leonardo-filipe,12,0.00077,324214,20.76861,1561077
3241,lerit,12,0.00077,324226,20.76938,1561077
3242,linmuqin,12,0.00077,324238,20.77015,1561077
3243,liuz7,12,0.00077,324250,20.77092,1561077
3244,lpetre,12,0.00077,324262,20.77169,1561077
3245,lsarangi1,12,0.00077,324274,20.77245,1561077
3246,lsglick,12,0.00077,324286,20.77322,1561077
3247,luctrate,12,0.00077,324298,20.77399,1561077
3248,lukasz-lesiak,12,0.00077,324310,20.77476,1561077
3249,madhvidua,12,0.00077,324322,20.77553,1561077
3250,maksim77,12,0.00077,324334,20.77630,1561077
3251,maksym-kit,12,0.00077,324346,20.77707,1561077
3252,man0s,12,0.00077,324358,20.77783,1561077
3253,maniankara,12,0.00077,324370,20.77860,1561077
3254,mansi103,12,0.00077,324382,20.77937,1561077
3255,manuargue,12,0.00077,324394,20.78014,1561077
3256,markhu,12,0.00077,324406,20.78091,1561077
3257,markltbaker,12,0.00077,324418,20.78168,1561077
3258,markusschaefer,12,0.00077,324430,20.78245,1561077
3259,matejdro,12,0.00077,324442,20.78322,1561077
3260,mathspanda,12,0.00077,324454,20.78398,1561077
3261,mcritic,12,0.00077,324466,20.78475,1561077
3262,michelkaporin,12,0.00077,324478,20.78552,1561077
3263,micw,12,0.00077,324490,20.78629,1561077
3264,miguelgarcia,12,0.00077,324502,20.78706,1561077
3265,mindfulmonk,12,0.00077,324514,20.78783,1561077
3266,missedone,12,0.00077,324526,20.78860,1561077
3267,mjainta,12,0.00077,324538,20.78937,1561077
3268,mkalkov,12,0.00077,324550,20.79013,1561077
3269,mlgiroux,12,0.00077,324562,20.79090,1561077
3270,movedoa,12,0.00077,324574,20.79167,1561077
3271,mrmunch,12,0.00077,324586,20.79244,1561077
3272,MSch,12,0.00077,324598,20.79321,1561077
3273,msigler-cb,12,0.00077,324610,20.79398,1561077
3274,mtdeguzis,12,0.00077,324622,20.79475,1561077
3275,namtzigla,12,0.00077,324634,20.79551,1561077
3276,Neelam-zanvar,12,0.00077,324646,20.79628,1561077
3277,nehagupta29,12,0.00077,324658,20.79705,1561077
3278,netrounds-fredrik,12,0.00077,324670,20.79782,1561077
3279,nevins-b,12,0.00077,324682,20.79859,1561077
3280,nikitakasatkin44,12,0.00077,324694,20.79936,1561077
3281,nottyo,12,0.00077,324706,20.80013,1561077
3282,nvoskuilen,12,0.00077,324718,20.80090,1561077
3283,oc243,12,0.00077,324730,20.80166,1561077
3284,oisis,12,0.00077,324742,20.80243,1561077
3285,osoriano,12,0.00077,324754,20.80320,1561077
3286,parshap,12,0.00077,324766,20.80397,1561077
3287,pasikon,12,0.00077,324778,20.80474,1561077
3288,paulojohnj,12,0.00077,324790,20.80551,1561077
3289,Payal94,12,0.00077,324802,20.80628,1561077
3290,pdodds,12,0.00077,324814,20.80705,1561077
3291,peachy-devops,12,0.00077,324826,20.80781,1561077
3292,pescuma,12,0.00077,324838,20.80858,1561077
3293,pesetskyps,12,0.00077,324850,20.80935,1561077
3294,peternijssen,12,0.00077,324862,20.81012,1561077
3295,petromir,12,0.00077,324874,20.81089,1561077
3296,pfrank13,12,0.00077,324886,20.81166,1561077
3297,prabhasgupte,12,0.00077,324898,20.81243,1561077
3298,pycaster,12,0.00077,324910,20.81319,1561077
3299,r3dlin3,12,0.00077,324922,20.81396,1561077
3300,rachelcarmena,12,0.00077,324934,20.81473,1561077
3301,radubutnaru,12,0.00077,324946,20.81550,1561077
3302,raghav-a,12,0.00077,324958,20.81627,1561077
3303,rayvincent2,12,0.00077,324970,20.81704,1561077
3304,reedloden,12,0.00077,324982,20.81781,1561077
3305,rgroult,12,0.00077,324994,20.81858,1561077
3306,rohitagarwal11,12,0.00077,325006,20.81934,1561077
3307,ronniezhou,12,0.00077,325018,20.82011,1561077
3308,RoryHunter,12,0.00077,325030,20.82088,1561077
3309,rowanhill,12,0.00077,325042,20.82165,1561077
3310,rschuetz,12,0.00077,325054,20.82242,1561077
3311,rufoa,12,0.00077,325066,20.82319,1561077
3312,Saurabh240991,12,0.00077,325078,20.82396,1561077
3313,segalaj,12,0.00077,325090,20.82473,1561077
3314,ShihouinYoruichi,12,0.00077,325102,20.82549,1561077
3315,sirstrahd,12,0.00077,325114,20.82626,1561077
3316,SoleneGK,12,0.00077,325126,20.82703,1561077
3317,sschneid,12,0.00077,325138,20.82780,1561077
3318,sterys,12,0.00077,325150,20.82857,1561077
3319,stevenpost,12,0.00077,325162,20.82934,1561077
3320,sugonyakivan,12,0.00077,325174,20.83011,1561077
3321,Sunilaj,12,0.00077,325186,20.83088,1561077
3322,tarun25garg,12,0.00077,325198,20.83164,1561077
3323,tdorsey,12,0.00077,325210,20.83241,1561077
3324,tecnobrat,12,0.00077,325222,20.83318,1561077
3325,thatsIch,12,0.00077,325234,20.83395,1561077
3326,theobolo,12,0.00077,325246,20.83472,1561077
3327,ThomasStockerUiPath,12,0.00077,325258,20.83549,1561077
3328,ThusithaDJ,12,0.00077,325270,20.83626,1561077
3329,timblaktu,12,0.00077,325282,20.83702,1561077
3330,tomaswolf,12,0.00077,325294,20.83779,1561077
3331,trejkaz,12,0.00077,325306,20.83856,1561077
3332,trivalik,12,0.00077,325318,20.83933,1561077
3333,troymohl,12,0.00077,325330,20.84010,1561077
3334,uweschaefer,12,0.00077,325342,20.84087,1561077
3335,valdestron,12,0.00077,325354,20.84164,1561077
3336,vaproc,12,0.00077,325366,20.84241,1561077
3337,VinceCapodanno,12,0.00077,325378,20.84317,1561077
3338,vrenjith,12,0.00077,325390,20.84394,1561077
3339,Vroni22,12,0.00077,325402,20.84471,1561077
3340,vstriz,12,0.00077,325414,20.84548,1561077
3341,vtitov,12,0.00077,325426,20.84625,1561077
3342,weakcamel,12,0.00077,325438,20.84702,1561077
3343,willi1s,12,0.00077,325450,20.84779,1561077
3344,xadozuk,12,0.00077,325462,20.84856,1561077
3345,xasx,12,0.00077,325474,20.84932,1561077
3346,yyr03gy,12,0.00077,325486,20.85009,1561077
3347,zhangxpp,12,0.00077,325498,20.85086,1561077
3348,zhangzhenyu0819,12,0.00077,325510,20.85163,1561077
3349,zhogov,12,0.00077,325522,20.85240,1561077
3350,ziggyw,12,0.00077,325534,20.85317,1561077
3351,zivOrLive,12,0.00077,325546,20.85394,1561077
3352,85matthew,11,0.00070,325557,20.85464,1561077
3353,aadamovich,11,0.00070,325568,20.85535,1561077
3354,AaronJaegerVA,11,0.00070,325579,20.85605,1561077
3355,abhijeet007rocks8,11,0.00070,325590,20.85675,1561077
3356,AB-xdev,11,0.00070,325601,20.85746,1561077
3357,AdrianFarmadin,11,0.00070,325612,20.85816,1561077
3358,aeoris,11,0.00070,325623,20.85887,1561077
3359,ajbw,11,0.00070,325634,20.85957,1561077
3360,alexkoon,11,0.00070,325645,20.86028,1561077
3361,alexZhdankin,11,0.00070,325656,20.86098,1561077
3362,allenbenz,11,0.00070,325667,20.86169,1561077
3363,AllenJB,11,0.00070,325678,20.86239,1561077
3364,amarruedo,11,0.00070,325689,20.86310,1561077
3365,AnastasiaKozachuk,11,0.00070,325700,20.86380,1561077
3366,andrein,11,0.00070,325711,20.86451,1561077
3367,anishp55,11,0.00070,325722,20.86521,1561077
3368,arixmf,11,0.00070,325733,20.86592,1561077
3369,arnab1896,11,0.00070,325744,20.86662,1561077
3370,ash-sxn,11,0.00070,325755,20.86732,1561077
3371,asquel,11,0.00070,325766,20.86803,1561077
3372,atifrasheed79,11,0.00070,325777,20.86873,1561077
3373,aubelix,11,0.00070,325788,20.86944,1561077
3374,avishah101,11,0.00070,325799,20.87014,1561077
3375,backlogAK,11,0.00070,325810,20.87085,1561077
3376,baskaran-md,11,0.00070,325821,20.87155,1561077
3377,benjaminrene,11,0.00070,325832,20.87226,1561077
3378,benjidea,11,0.00070,325843,20.87296,1561077
3379,benpdavison,11,0.00070,325854,20.87367,1561077
3380,betandr,11,0.00070,325865,20.87437,1561077
3381,betull,11,0.00070,325876,20.87508,1561077
3382,Bilgetz,11,0.00070,325887,20.87578,1561077
3383,blademainer,11,0.00070,325898,20.87648,1561077
3384,bmuschko,11,0.00070,325909,20.87719,1561077
3385,BorisYaoA,11,0.00070,325920,20.87789,1561077
3386,bra-fsn,11,0.00070,325931,20.87860,1561077
3387,brgruber92,11,0.00070,325942,20.87930,1561077
3388,brocktubre,11,0.00070,325953,20.88001,1561077
3389,builder-main,11,0.00070,325964,20.88071,1561077
3390,bvn13,11,0.00070,325975,20.88142,1561077
3391,caduri,11,0.00070,325986,20.88212,1561077
3392,captn3m0,11,0.00070,325997,20.88283,1561077
3393,carlos-sandoval-11,11,0.00070,326008,20.88353,1561077
3394,chiefus,11,0.00070,326019,20.88424,1561077
3395,chriscarpenter12,11,0.00070,326030,20.88494,1561077
3396,chrisLeeTW,11,0.00070,326041,20.88564,1561077
3397,chris-orchard,11,0.00070,326052,20.88635,1561077
3398,climblinne,11,0.00070,326063,20.88705,1561077
3399,cmsoconsistent,11,0.00070,326074,20.88776,1561077
3400,conan-z,11,0.00070,326085,20.88846,1561077
3401,CondormanFr,11,0.00070,326096,20.88917,1561077
3402,CooperRS,11,0.00070,326107,20.88987,1561077
3403,CorevistCI,11,0.00070,326118,20.89058,1561077
3404,countableSet,11,0.00070,326129,20.89128,1561077
3405,cpwr-devops,11,0.00070,326140,20.89199,1561077
3406,curiousprogrammer-net,11,0.00070,326151,20.89269,1561077
3407,Cyberax,11,0.00070,326162,20.89340,1561077
3408,daeho-ro,11,0.00070,326173,20.89410,1561077
3409,danielraq,11,0.00070,326184,20.89481,1561077
3410,danjee,11,0.00070,326195,20.89551,1561077
3411,DavidRodHub,11,0.00070,326206,20.89621,1561077
3412,david-romero,11,0.00070,326217,20.89692,1561077
3413,dazze1812,11,0.00070,326228,20.89762,1561077
3414,dbingham,11,0.00070,326239,20.89833,1561077
3415,delpic,11,0.00070,326250,20.89903,1561077
3416,deweerdt,11,0.00070,326261,20.89974,1561077
3417,dforrest88,11,0.00070,326272,20.90044,1561077
3418,dgeissl,11,0.00070,326283,20.90115,1561077
3419,diananana,11,0.00070,326294,20.90185,1561077
3420,dimacus,11,0.00070,326305,20.90256,1561077
3421,dsilvasc,11,0.00070,326316,20.90326,1561077
3422,dsouzai,11,0.00070,326327,20.90397,1561077
3423,dtrunk90,11,0.00070,326338,20.90467,1561077
3424,e88z4,11,0.00070,326349,20.90537,1561077
3425,edudar,11,0.00070,326360,20.90608,1561077
3426,ENCHALWARPRANJAL,11,0.00070,326371,20.90678,1561077
3427,eqqe,11,0.00070,326382,20.90749,1561077
3428,ericfrancis,11,0.00070,326393,20.90819,1561077
3429,farkasmate,11,0.00070,326404,20.90890,1561077
3430,fbuehlmann,11,0.00070,326415,20.90960,1561077
3431,Flamki,11,0.00070,326426,20.91031,1561077
3432,florimondmanca,11,0.00070,326437,20.91101,1561077
3433,fr123k,11,0.00070,326448,20.91172,1561077
3434,freegroup,11,0.00070,326459,20.91242,1561077
3435,Friz-zy,11,0.00070,326470,20.91313,1561077
3436,fuentesj,11,0.00070,326481,20.91383,1561077
3437,furai,11,0.00070,326492,20.91454,1561077
3438,gandadil,11,0.00070,326503,20.91524,1561077
3439,gdhbashton,11,0.00070,326514,20.91594,1561077
3440,gejunqiang,11,0.00070,326525,20.91665,1561077
3441,gmanfunky,11,0.00070,326536,20.91735,1561077
3442,gogskrish,11,0.00070,326547,20.91806,1561077
3443,gregswift,11,0.00070,326558,20.91876,1561077
3444,grit96,11,0.00070,326569,20.91947,1561077
3445,GyrosGeier,11,0.00070,326580,20.92017,1561077
3446,hangie,11,0.00070,326591,20.92088,1561077
3447,harry-g,11,0.00070,326602,20.92158,1561077
3448,hd42,11,0.00070,326613,20.92229,1561077
3449,HelderMagalhaes,11,0.00070,326624,20.92299,1561077
3450,herbert-venancio,11,0.00070,326635,20.92370,1561077
3451,hesco,11,0.00070,326646,20.92440,1561077
3452,HexTank,11,0.00070,326657,20.92510,1561077
3453,highlyunavailable,11,0.00070,326668,20.92581,1561077
3454,holoGDM,11,0.00070,326679,20.92651,1561077
3455,hplatou,11,0.00070,326690,20.92722,1561077
3456,HughePaul,11,0.00070,326701,20.92792,1561077
3457,hwangjr,11,0.00070,326712,20.92863,1561077
3458,I3urny,11,0.00070,326723,20.92933,1561077
3459,imrahul361,11,0.00070,326734,20.93004,1561077
3460,imuchnik,11,0.00070,326745,20.93074,1561077
3461,intelradoux,11,0.00070,326756,20.93145,1561077
3462,Isakgicu,11,0.00070,326767,20.93215,1561077
3463,itomaldonado,11,0.00070,326778,20.93286,1561077
3464,janisz,11,0.00070,326789,20.93356,1561077
3465,janpapenbrock,11,0.00070,326800,20.93427,1561077
3466,JasonBoyles,11,0.00070,326811,20.93497,1561077
3467,jillmon,11,0.00070,326822,20.93567,1561077
3468,JimmyMa,11,0.00070,326833,20.93638,1561077
3469,joaedwar,11,0.00070,326844,20.93708,1561077
3470,joerajeev,11,0.00070,326855,20.93779,1561077
3471,jotka,11,0.00070,326866,20.93849,1561077
3472,jphelion,11,0.00070,326877,20.93920,1561077
3473,jsj1027,11,0.00070,326888,20.93990,1561077
3474,jsowndarrajan,11,0.00070,326899,20.94061,1561077
3475,js-timbirkett,11,0.00070,326910,20.94131,1561077
3476,kapilkumar04,11,0.00070,326921,20.94202,1561077
3477,karentobo,11,0.00070,326932,20.94272,1561077
3478,KasperFranz,11,0.00070,326943,20.94343,1561077
3479,kerrhome,11,0.00070,326954,20.94413,1561077
3480,kid0809,11,0.00070,326965,20.94483,1561077
3481,kirhie,11,0.00070,326976,20.94554,1561077
3482,Kissy,11,0.00070,326987,20.94624,1561077
3483,kk-r,11,0.00070,326998,20.94695,1561077
3484,KLBonn,11,0.00070,327009,20.94765,1561077
3485,knorrest,11,0.00070,327020,20.94836,1561077
3486,knut-olav-hoven-ske,11,0.00070,327031,20.94906,1561077
3487,kokkerhout,11,0.00070,327042,20.94977,1561077
3488,kragab,11,0.00070,327053,20.95047,1561077
3489,krishna3008,11,0.00070,327064,20.95118,1561077
3490,kscherer,11,0.00070,327075,20.95188,1561077
3491,kuntalkumarbasu,11,0.00070,327086,20.95259,1561077
3492,kutsal,11,0.00070,327097,20.95329,1561077
3493,kwilson6744,11,0.00070,327108,20.95400,1561077
3494,layered-esell,11,0.00070,327119,20.95470,1561077
3495,lenivetsDCT,11,0.00070,327130,20.95540,1561077
3496,Liath,11,0.00070,327141,20.95611,1561077
3497,linzhaoming,11,0.00070,327152,20.95681,1561077
3498,llopezsugar,11,0.00070,327163,20.95752,1561077
3499,lmayorga1980,11,0.00070,327174,20.95822,1561077
3500,lord-i-will,11,0.00070,327185,20.95893,1561077
3501,ltozi,11,0.00070,327196,20.95963,1561077
3502,lucienbanholzer,11,0.00070,327207,20.96034,1561077
3503,luistilingue,11,0.00070,327218,20.96104,1561077
3504,maikelsteneker,11,0.00070,327229,20.96175,1561077
3505,ManuelB,11,0.00070,327240,20.96245,1561077
3506,marcelaraujo,11,0.00070,327251,20.96316,1561077
3507,marekkapowicki,11,0.00070,327262,20.96386,1561077
3508,Marslo,11,0.00070,327273,20.96456,1561077
3509,martinb3,11,0.00070,327284,20.96527,1561077
3510,mateodelnorte,11,0.00070,327295,20.96597,1561077
3511,matiashaller,11,0.00070,327306,20.96668,1561077
3512,maura-e-ardden,11,0.00070,327317,20.96738,1561077
3513,maxfields2000,11,0.00070,327328,20.96809,1561077
3514,mbockus,11,0.00070,327339,20.96879,1561077
3515,MBorze,11,0.00070,327350,20.96950,1561077
3516,meiboyu,11,0.00070,327361,20.97020,1561077
3517,mhabsaoui,11,0.00070,327372,20.97091,1561077
3518,MichalAugustyn,11,0.00070,327383,20.97161,1561077
3519,michalperlak,11,0.00070,327394,20.97232,1561077
3520,mmarseglia,11,0.00070,327405,20.97302,1561077
3521,mnunezdm,11,0.00070,327416,20.97373,1561077
3522,mohammadmaulana,11,0.00070,327427,20.97443,1561077
3523,MOldenbourg,11,0.00070,327438,20.97513,1561077
3524,mount986,11,0.00070,327449,20.97584,1561077
3525,mrjgreen,11,0.00070,327460,20.97654,1561077
3526,mslipets,11,0.00070,327471,20.97725,1561077
3527,mtamboli,11,0.00070,327482,20.97795,1561077
3528,murraybo,11,0.00070,327493,20.97866,1561077
3529,MyronFanQiu,11,0.00070,327504,20.97936,1561077
3530,nate-tri,11,0.00070,327515,20.98007,1561077
3531,nathanhi,11,0.00070,327526,20.98077,1561077
3532,neilcar,11,0.00070,327537,20.98148,1561077
3533,nengelbrecht,11,0.00070,327548,20.98218,1561077
3534,nikita-andreev,11,0.00070,327559,20.98289,1561077
3535,NiklasEi,11,0.00070,327570,20.98359,1561077
3536,nilsmahlstaedt,11,0.00070,327581,20.98429,1561077
3537,noahwc,11,0.00070,327592,20.98500,1561077
3538,noamtcohen,11,0.00070,327603,20.98570,1561077
3539,nolange,11,0.00070,327614,20.98641,1561077
3540,NuclearCookie,11,0.00070,327625,20.98711,1561077
3541,ocristian,11,0.00070,327636,20.98782,1561077
3542,oddgames-david,11,0.00070,327647,20.98852,1561077
3543,oguzhancevik,11,0.00070,327658,20.98923,1561077
3544,Ohadbasan,11,0.00070,327669,20.98993,1561077
3545,okoye,11,0.00070,327680,20.99064,1561077
3546,oltruong,11,0.00070,327691,20.99134,1561077
3547,orbsfoc,11,0.00070,327702,20.99205,1561077
3548,OrfeasZ,11,0.00070,327713,20.99275,1561077
3549,osamasalem,11,0.00070,327724,20.99346,1561077
3550,osthus-dm,11,0.00070,327735,20.99416,1561077
3551,p00j4,11,0.00070,327746,20.99486,1561077
3552,pactel,11,0.00070,327757,20.99557,1561077
3553,papajulio,11,0.00070,327768,20.99627,1561077
3554,PapaNappa,11,0.00070,327779,20.99698,1561077
3555,patrickschlebusch,11,0.00070,327790,20.99768,1561077
3556,paullaleu,11,0.00070,327801,20.99839,1561077
3557,PereBueno,11,0.00070,327812,20.99909,1561077
3558,phanitejanunna,11,0.00070,327823,20.99980,1561077
3559,Pistahh,11,0.00070,327834,21.00050,1561077
3560,pjama,11,0.00070,327845,21.00121,1561077
3561,ProgramCpp,11,0.00070,327856,21.00191,1561077
3562,psig-bah,11,0.00070,327867,21.00262,1561077
3563,pussinboots,11,0.00070,327878,21.00332,1561077
3564,quidl,11,0.00070,327889,21.00402,1561077
3565,Ramon-Balaguer,11,0.00070,327900,21.00473,1561077
3566,rannox,11,0.00070,327911,21.00543,1561077
3567,rcosnita,11,0.00070,327922,21.00614,1561077
3568,Reamer,11,0.00070,327933,21.00684,1561077
3569,reftel,11,0.00070,327944,21.00755,1561077
3570,Remz-Jay,11,0.00070,327955,21.00825,1561077
3571,rfvmonteiro,11,0.00070,327966,21.00896,1561077
3572,rgal,11,0.00070,327977,21.00966,1561077
3573,romanblachman,11,0.00070,327988,21.01037,1561077
3574,romang12,11,0.00070,327999,21.01107,1561077
3575,rskang,11,0.00070,328010,21.01178,1561077
3576,rwillard,11,0.00070,328021,21.01248,1561077
3577,SagarGaniga,11,0.00070,328032,21.01319,1561077
3578,sahilrkalra,11,0.00070,328043,21.01389,1561077
3579,SalahAdDin,11,0.00070,328054,21.01459,1561077
3580,sathomps,11,0.00070,328065,21.01530,1561077
3581,Schoch10,11,0.00070,328076,21.01600,1561077
3582,scymtym,11,0.00070,328087,21.01671,1561077
3583,seanmceligot,11,0.00070,328098,21.01741,1561077
3584,sellitforcache,11,0.00070,328109,21.01812,1561077
3585,seschi98,11,0.00070,328120,21.01882,1561077
3586,sethp-nr,11,0.00070,328131,21.01953,1561077
3587,sharkannon,11,0.00070,328142,21.02023,1561077
3588,shdowofdeath,11,0.00070,328153,21.02094,1561077
3589,simonvanderveldt,11,0.00070,328164,21.02164,1561077
3590,sjjarvi,11,0.00070,328175,21.02235,1561077
3591,s-j-nilsson,11,0.00070,328186,21.02305,1561077
3592,smousa,11,0.00070,328197,21.02375,1561077
3593,soham-chakraborty1,11,0.00070,328208,21.02446,1561077
3594,soma-gyore-intland23,11,0.00070,328219,21.02516,1561077
3595,sp-ricard-valverde,11,0.00070,328230,21.02587,1561077
3596,SrodriguezO,11,0.00070,328241,21.02657,1561077
3597,ssl-maxtouch,11,0.00070,328252,21.02728,1561077
3598,stefan6419846,11,0.00070,328263,21.02798,1561077
3599,steven-aerts,11,0.00070,328274,21.02869,1561077
3600,supershll,11,0.00070,328285,21.02939,1561077
3601,surendarsuyamprakasam,11,0.00070,328296,21.03010,1561077
3602,sutrosoftware,11,0.00070,328307,21.03080,1561077
3603,tadfisher,11,0.00070,328318,21.03151,1561077
3604,thedevopsguyblog,11,0.00070,328329,21.03221,1561077
3605,TheFriendlyCoder,11,0.00070,328340,21.03292,1561077
3606,TheSentinel454,11,0.00070,328351,21.03362,1561077
3607,this-is-r-gaurav,11,0.00070,328362,21.03432,1561077
3608,thomaslorentsen,11,0.00070,328373,21.03503,1561077
3609,thongmgnguyen,11,0.00070,328384,21.03573,1561077
3610,timabbott,11,0.00070,328395,21.03644,1561077
3611,timbru31,11,0.00070,328406,21.03714,1561077
3612,TimRots,11,0.00070,328417,21.03785,1561077
3613,tomotargz,11,0.00070,328428,21.03855,1561077
3614,tompa-cal,11,0.00070,328439,21.03926,1561077
3615,tonka3000,11,0.00070,328450,21.03996,1561077
3616,tuananht,11,0.00070,328461,21.04067,1561077
3617,tveal,11,0.00070,328472,21.04137,1561077
3618,tweakmy,11,0.00070,328483,21.04208,1561077
3619,unicman,11,0.00070,328494,21.04278,1561077
3620,Vahalas,11,0.00070,328505,21.04348,1561077
3621,vassilevsky,11,0.00070,328516,21.04419,1561077
3622,VGerris,11,0.00070,328527,21.04489,1561077
3623,vincentrussell,11,0.00070,328538,21.04560,1561077
3624,vinhlh,11,0.00070,328549,21.04630,1561077
3625,vitgorbunov,11,0.00070,328560,21.04701,1561077
3626,viveksiddineni,11,0.00070,328571,21.04771,1561077
3627,vorbis,11,0.00070,328582,21.04842,1561077
3628,walnut-tom,11,0.00070,328593,21.04912,1561077
3629,wbachnik,11,0.00070,328604,21.04983,1561077
3630,webmakersteve,11,0.00070,328615,21.05053,1561077
3631,wentwrong,11,0.00070,328626,21.05124,1561077
3632,WeTestQuality,11,0.00070,328637,21.05194,1561077
3633,whittlec,11,0.00070,328648,21.05265,1561077
3634,wolfgarnet,11,0.00070,328659,21.05335,1561077
3635,wouterhund,11,0.00070,328670,21.05405,1561077
3636,xacaxulu,11,0.00070,328681,21.05476,1561077
3637,XiaokunHou,11,0.00070,328692,21.05546,1561077
3638,yadavsachin0995,11,0.00070,328703,21.05617,1561077
3639,yatinsns,11,0.00070,328714,21.05687,1561077
3640,Z9n2JktHlZDmlhSvqc9X2MmL3BwQG7tk,11,0.00070,328725,21.05758,1561077
3641,zhekoff316,11,0.00070,328736,21.05828,1561077
3642,ZJvandeWeg,11,0.00070,328747,21.05899,1561077
3643,znz,11,0.00070,328758,21.05969,1561077
3644,Zohhak,11,0.00070,328769,21.06040,1561077
3645,Zsub,11,0.00070,328780,21.06110,1561077
3646,zthroo,11,0.00070,328791,21.06181,1561077
3647,zweizhang,11,0.00070,328802,21.06251,1561077
3648,1c3t3a,10,0.00064,328812,21.06315,1561077
3649,2018201920201920,10,0.00064,328822,21.06379,1561077
3650,4x0v7,10,0.00064,328832,21.06443,1561077
3651,a64011144,10,0.00064,328842,21.06507,1561077
3652,abloemert,10,0.00064,328852,21.06571,1561077
3653,AbsoluteOther,10,0.00064,328862,21.06635,1561077
3654,acejam,10,0.00064,328872,21.06699,1561077
3655,achedeuzot,10,0.00064,328882,21.06763,1561077
3656,adamcstephens,10,0.00064,328892,21.06828,1561077
3657,adam-knights,10,0.00064,328902,21.06892,1561077
3658,adaniline-traderev,10,0.00064,328912,21.06956,1561077
3659,adveres,10,0.00064,328922,21.07020,1561077
3660,afzal442,10,0.00064,328932,21.07084,1561077
3661,agnihotrigaurav,10,0.00064,328942,21.07148,1561077
3662,akbertram,10,0.00064,328952,21.07212,1561077
3663,aleixripoll,10,0.00064,328962,21.07276,1561077
3664,alexanikanov,10,0.00064,328972,21.07340,1561077
3665,alex-lee2,10,0.00064,328982,21.07404,1561077
3666,alexrovner,10,0.00064,328992,21.07468,1561077
3667,allustin,10,0.00064,329002,21.07532,1561077
3668,alshari86,10,0.00064,329012,21.07596,1561077
3669,amulyamalla,10,0.00064,329022,21.07660,1561077
3670,andlaz,10,0.00064,329032,21.07724,1561077
3671,andrealaura,10,0.00064,329042,21.07788,1561077
3672,andrew-garland,10,0.00064,329052,21.07852,1561077
3673,andreyakostov,10,0.00064,329062,21.07917,1561077
3674,andriosr,10,0.00064,329072,21.07981,1561077
3675,anilvasi,10,0.00064,329082,21.08045,1561077
3676,AnishaGharat,10,0.00064,329092,21.08109,1561077
3677,AntoineConffx,10,0.00064,329102,21.08173,1561077
3678,anton-unity,10,0.00064,329112,21.08237,1561077
3679,anurag-sachan,10,0.00064,329122,21.08301,1561077
3680,AparnaSaripaka,10,0.00064,329132,21.08365,1561077
3681,aplex,10,0.00064,329142,21.08429,1561077
3682,appidman,10,0.00064,329152,21.08493,1561077
3683,aramse,10,0.00064,329162,21.08557,1561077
3684,Arbuzov,10,0.00064,329172,21.08621,1561077
3685,ariadnarouco,10,0.00064,329182,21.08685,1561077
3686,arsiesys,10,0.00064,329192,21.08749,1561077
3687,arykov,10,0.00064,329202,21.08813,1561077
3688,asfaltboy,10,0.00064,329212,21.08877,1561077
3689,ashikka,10,0.00064,329222,21.08941,1561077
3690,asumitskykwn,10,0.00064,329232,21.09006,1561077
3691,atsalolikhin-spokeo,10,0.00064,329242,21.09070,1561077
3692,aviadatsnyk,10,0.00064,329252,21.09134,1561077
3693,avidspartan1,10,0.00064,329262,21.09198,1561077
3694,ayanamist,10,0.00064,329272,21.09262,1561077
3695,Bakies,10,0.00064,329282,21.09326,1561077
3696,bardec,10,0.00064,329292,21.09390,1561077
3697,bassplay3r,10,0.00064,329302,21.09454,1561077
3698,begoldsm,10,0.00064,329312,21.09518,1561077
3699,Beknur1003,10,0.00064,329322,21.09582,1561077
3700,Benbentwo,10,0.00064,329332,21.09646,1561077
3701,benipeled,10,0.00064,329342,21.09710,1561077
3702,bhartshorn,10,0.00064,329352,21.09774,1561077
3703,bhunter,10,0.00064,329362,21.09838,1561077
3704,biaomingzhong,10,0.00064,329372,21.09902,1561077
3705,bigfleet,10,0.00064,329382,21.09966,1561077
3706,BINGOGO123,10,0.00064,329392,21.10030,1561077
3707,biolauri,10,0.00064,329402,21.10095,1561077
3708,bkruger99,10,0.00064,329412,21.10159,1561077
3709,blaffoy,10,0.00064,329422,21.10223,1561077
3710,Blaisorblade,10,0.00064,329432,21.10287,1561077
3711,blaquezzz,10,0.00064,329442,21.10351,1561077
3712,bleibdirtroy,10,0.00064,329452,21.10415,1561077
3713,bliu2368,10,0.00064,329462,21.10479,1561077
3714,blucas,10,0.00064,329472,21.10543,1561077
3715,bmurphey,10,0.00064,329482,21.10607,1561077
3716,bnerDY,10,0.00064,329492,21.10671,1561077
3717,bonzani,10,0.00064,329502,21.10735,1561077
3718,brianberzins,10,0.00064,329512,21.10799,1561077
3719,bthompson90,10,0.00064,329522,21.10863,1561077
3720,buchen,10,0.00064,329532,21.10927,1561077
3721,busches,10,0.00064,329542,21.10991,1561077
3722,bvoss,10,0.00064,329552,21.11055,1561077
3723,bytemuck,10,0.00064,329562,21.11119,1561077
3724,cdoughty-r7,10,0.00064,329572,21.11183,1561077
3725,ChandarGadi,10,0.00064,329582,21.11248,1561077
3726,ChengYueJia,10,0.00064,329592,21.11312,1561077
3727,chinaboard,10,0.00064,329602,21.11376,1561077
3728,chojna,10,0.00064,329612,21.11440,1561077
3729,choppedpork,10,0.00064,329622,21.11504,1561077
3730,chrono,10,0.00064,329632,21.11568,1561077
3731,CJCombrink,10,0.00064,329642,21.11632,1561077
3732,cnorburn,10,0.00064,329652,21.11696,1561077
3733,codybaxter,10,0.00064,329662,21.11760,1561077
3734,colathurv,10,0.00064,329672,21.11824,1561077
3735,commodis,10,0.00064,329682,21.11888,1561077
3736,conn,10,0.00064,329692,21.11952,1561077
3737,cpolzer,10,0.00064,329702,21.12016,1561077
3738,cristi-vlad,10,0.00064,329712,21.12080,1561077
3739,cx2c,10,0.00064,329722,21.12144,1561077
3740,cyrus-one,10,0.00064,329732,21.12208,1561077
3741,DaAnda97,10,0.00064,329742,21.12272,1561077
3742,dalefwillis,10,0.00064,329752,21.12337,1561077
3743,danyaljj,10,0.00064,329762,21.12401,1561077
3744,DarphBobo,10,0.00064,329772,21.12465,1561077
3745,darthcabs,10,0.00064,329782,21.12529,1561077
3746,daxgames,10,0.00064,329792,21.12593,1561077
3747,da-yaroslav-orel,10,0.00064,329802,21.12657,1561077
3748,dbrgn,10,0.00064,329812,21.12721,1561077
3749,dcanadillas,10,0.00064,329822,21.12785,1561077
3750,ddumontatibm,10,0.00064,329832,21.12849,1561077
3751,d-enz,10,0.00064,329842,21.12913,1561077
3752,derek9gag,10,0.00064,329852,21.12977,1561077
3753,deronek,10,0.00064,329862,21.13041,1561077
3754,dia38,10,0.00064,329872,21.13105,1561077
3755,didushko,10,0.00064,329882,21.13169,1561077
3756,DiogoLG,10,0.00064,329892,21.13233,1561077
3757,DirkHa,10,0.00064,329902,21.13297,1561077
3758,diversys,10,0.00064,329912,21.13361,1561077
3759,dmolesUC3,10,0.00064,329922,21.13426,1561077
3760,Dneth04,10,0.00064,329932,21.13490,1561077
3761,doman18,10,0.00064,329942,21.13554,1561077
3762,doogie2301,10,0.00064,329952,21.13618,1561077
3763,dragoudin,10,0.00064,329962,21.13682,1561077
3764,dsavenko,10,0.00064,329972,21.13746,1561077
3765,d-schaffer,10,0.00064,329982,21.13810,1561077
3766,dskouris,10,0.00064,329992,21.13874,1561077
3767,dtao,10,0.00064,330002,21.13938,1561077
3768,duffn,10,0.00064,330012,21.14002,1561077
3769,EarthlingDavey,10,0.00064,330022,21.14066,1561077
3770,eddumelendez,10,0.00064,330032,21.14130,1561077
3771,eddyp,10,0.00064,330042,21.14194,1561077
3772,Edgar0119,10,0.00064,330052,21.14258,1561077
3773,edmooney,10,0.00064,330062,21.14322,1561077
3774,edsykes,10,0.00064,330072,21.14386,1561077
3775,Egor18,10,0.00064,330082,21.14450,1561077
3776,erickardus,10,0.00064,330092,21.14515,1561077
3777,Everspace,10,0.00064,330102,21.14579,1561077
3778,fcoelho,10,0.00064,330112,21.14643,1561077
3779,feczo,10,0.00064,330122,21.14707,1561077
3780,felixb,10,0.00064,330132,21.14771,1561077
3781,ferwguerra,10,0.00064,330142,21.14835,1561077
3782,feverLu,10,0.00064,330152,21.14899,1561077
3783,f-julian,10,0.00064,330162,21.14963,1561077
3784,fredrikand,10,0.00064,330172,21.15027,1561077
3785,freyam,10,0.00064,330182,21.15091,1561077
3786,froehr,10,0.00064,330192,21.15155,1561077
3787,GabLeRoux,10,0.00064,330202,21.15219,1561077
3788,gcernier-amadeus,10,0.00064,330212,21.15283,1561077
3789,geraldpereira,10,0.00064,330222,21.15347,1561077
3790,ggalloro,10,0.00064,330232,21.15411,1561077
3791,ghost1874,10,0.00064,330242,21.15475,1561077
3792,gnadaban,10,0.00064,330252,21.15539,1561077
3793,gotgenes,10,0.00064,330262,21.15604,1561077
3794,grahamlyons,10,0.00064,330272,21.15668,1561077
3795,grayzu,10,0.00064,330282,21.15732,1561077
3796,greghoeppner,10,0.00064,330292,21.15796,1561077
3797,gudipudipradeep,10,0.00064,330302,21.15860,1561077
3798,gviczai,10,0.00064,330312,21.15924,1561077
3799,HaipuSun123,10,0.00064,330322,21.15988,1561077
3800,Harminder84,10,0.00064,330332,21.16052,1561077
3801,hathoward,10,0.00064,330342,21.16116,1561077
3802,Helen1987,10,0.00064,330352,21.16180,1561077
3803,hemanthsridhar,10,0.00064,330362,21.16244,1561077
3804,hemp,10,0.00064,330372,21.16308,1561077
3805,herter4171,10,0.00064,330382,21.16372,1561077
3806,hkrpavan,10,0.00064,330392,21.16436,1561077
3807,hwang381,10,0.00064,330402,21.16500,1561077
3808,iakovgan,10,0.00064,330412,21.16564,1561077
3809,IAmMichal,10,0.00064,330422,21.16628,1561077
3810,icojb25,10,0.00064,330432,21.16693,1561077
3811,icoolchn,10,0.00064,330442,21.16757,1561077
3812,idealivan,10,0.00064,330452,21.16821,1561077
3813,idij,10,0.00064,330462,21.16885,1561077
3814,ikolomiyets,10,0.00064,330472,21.16949,1561077
3815,ileixe,10,0.00064,330482,21.17013,1561077
3816,imdevin567,10,0.00064,330492,21.17077,1561077
3817,ImmuniwebSA,10,0.00064,330502,21.17141,1561077
3818,ImShakthi,10,0.00064,330512,21.17205,1561077
3819,italoveloso89,10,0.00064,330522,21.17269,1561077
3820,itscatherinelam,10,0.00064,330532,21.17333,1561077
3821,iulianstana,10,0.00064,330542,21.17397,1561077
3822,izderadicka,10,0.00064,330552,21.17461,1561077
3823,jaceksokol,10,0.00064,330562,21.17525,1561077
3824,jacobfederer,10,0.00064,330572,21.17589,1561077
3825,janeted,10,0.00064,330582,21.17653,1561077
3826,jarora8,10,0.00064,330592,21.17717,1561077
3827,jeffreytolar,10,0.00064,330602,21.17782,1561077
3828,jeremybdk,10,0.00064,330612,21.17846,1561077
3829,jgournet,10,0.00064,330622,21.17910,1561077
3830,jgracin,10,0.00064,330632,21.17974,1561077
3831,jiamengyu,10,0.00064,330642,21.18038,1561077
3832,Jin-Whee-Park,10,0.00064,330652,21.18102,1561077
3833,jjvdgeer,10,0.00064,330662,21.18166,1561077
3834,jmozmoz,10,0.00064,330672,21.18230,1561077
3835,job,10,0.00064,330682,21.18294,1561077
3836,jody-frankowski,10,0.00064,330692,21.18358,1561077
3837,joelee2012,10,0.00064,330702,21.18422,1561077
3838,joel-schaal,10,0.00064,330712,21.18486,1561077
3839,joevin-slq-ibp,10,0.00064,330722,21.18550,1561077
3840,jonathanvansina,10,0.00064,330732,21.18614,1561077
3841,jordiclariana,10,0.00064,330742,21.18678,1561077
3842,jplayout,10,0.00064,330752,21.18742,1561077
3843,jsharpe-ctm,10,0.00064,330762,21.18806,1561077
3844,juanri0s,10,0.00064,330772,21.18870,1561077
3845,julweber,10,0.00064,330782,21.18935,1561077
3846,justnom,10,0.00064,330792,21.18999,1561077
3847,jzoldak,10,0.00064,330802,21.19063,1561077
3848,Kanshiroron,10,0.00064,330812,21.19127,1561077
3849,kaushalnavneet,10,0.00064,330822,21.19191,1561077
3850,kdanW,10,0.00064,330832,21.19255,1561077
3851,keltik85,10,0.00064,330842,21.19319,1561077
3852,kksharma1618,10,0.00064,330852,21.19383,1561077
3853,kmfas,10,0.00064,330862,21.19447,1561077
3854,krachynski,10,0.00064,330872,21.19511,1561077
3855,kshepitko,10,0.00064,330882,21.19575,1561077
3856,kunerd,10,0.00064,330892,21.19639,1561077
3857,laurentgo,10,0.00064,330902,21.19703,1561077
3858,leelavery,10,0.00064,330912,21.19767,1561077
3859,lemrouch,10,0.00064,330922,21.19831,1561077
3860,lextiz,10,0.00064,330932,21.19895,1561077
3861,linead,10,0.00064,330942,21.19959,1561077
3862,liuwenzhi0318,10,0.00064,330952,21.20024,1561077
3863,ljackiewicz,10,0.00064,330962,21.20088,1561077
3864,Lorquas,10,0.00064,330972,21.20152,1561077
3865,love-git,10,0.00064,330982,21.20216,1561077
3866,LOZORD,10,0.00064,330992,21.20280,1561077
3867,lppedd,10,0.00064,331002,21.20344,1561077
3868,lsbwant,10,0.00064,331012,21.20408,1561077
3869,lvogt,10,0.00064,331022,21.20472,1561077
3870,madsonic,10,0.00064,331032,21.20536,1561077
3871,mafgh,10,0.00064,331042,21.20600,1561077
3872,manishcompro,10,0.00064,331052,21.20664,1561077
3873,MansoorMajeed,10,0.00064,331062,21.20728,1561077
3874,mariadb-JeffBachtel,10,0.00064,331072,21.20792,1561077
3875,markush81,10,0.00064,331082,21.20856,1561077
3876,MartinHajducik,10,0.00064,331092,21.20920,1561077
3877,MarvAmBass,10,0.00064,331102,21.20984,1561077
3878,matanz121,10,0.00064,331112,21.21048,1561077
3879,matonb,10,0.00064,331122,21.21113,1561077
3880,matsushou,10,0.00064,331132,21.21177,1561077
3881,matthewceroni,10,0.00064,331142,21.21241,1561077
3882,mattlawnz,10,0.00064,331152,21.21305,1561077
3883,maxime-michel,10,0.00064,331162,21.21369,1561077
3884,mBouamama,10,0.00064,331172,21.21433,1561077
3885,mdouglass,10,0.00064,331182,21.21497,1561077
3886,mediabounds,10,0.00064,331192,21.21561,1561077
3887,Melligos,10,0.00064,331202,21.21625,1561077
3888,mephi42,10,0.00064,331212,21.21689,1561077
3889,microscotch,10,0.00064,331222,21.21753,1561077
3890,mikemcquaid,10,0.00064,331232,21.21817,1561077
3891,misgersameer,10,0.00064,331242,21.21881,1561077
3892,mitali-sahoo,10,0.00064,331252,21.21945,1561077
3893,mkeith-eir,10,0.00064,331262,21.22009,1561077
3894,Moliholy,10,0.00064,331272,21.22073,1561077
3895,mrcarlosrendon,10,0.00064,331282,21.22137,1561077
3896,mtrakal,10,0.00064,331292,21.22202,1561077
3897,mvach,10,0.00064,331302,21.22266,1561077
3898,mvtorres,10,0.00064,331312,21.22330,1561077
3899,myanime,10,0.00064,331322,21.22394,1561077
3900,nattofriends,10,0.00064,331332,21.22458,1561077
3901,Nezz,10,0.00064,331342,21.22522,1561077
3902,NikolayMetchev,10,0.00064,331352,21.22586,1561077
3903,nitincyberark,10,0.00064,331362,21.22650,1561077
3904,nkakkar81,10,0.00064,331372,21.22714,1561077
3905,norrisjeremy,10,0.00064,331382,21.22778,1561077
3906,noviicee,10,0.00064,331392,21.22842,1561077
3907,nvrfrgt,10,0.00064,331402,21.22906,1561077
3908,oganga,10,0.00064,331412,21.22970,1561077
3909,oleksandr-horobets,10,0.00064,331422,21.23034,1561077
3910,oofnikj,10,0.00064,331432,21.23098,1561077
3911,oosterholt,10,0.00064,331442,21.23162,1561077
3912,opack,10,0.00064,331452,21.23226,1561077
3913,oshmyrko,10,0.00064,331462,21.23291,1561077
3914,parvit,10,0.00064,331472,21.23355,1561077
3915,pascalgulikers,10,0.00064,331482,21.23419,1561077
3916,PatrickHess,10,0.00064,331492,21.23483,1561077
3917,paulmillar,10,0.00064,331502,21.23547,1561077
3918,pavanmr94,10,0.00064,331512,21.23611,1561077
3919,pavanmt9,10,0.00064,331522,21.23675,1561077
3920,peske,10,0.00064,331532,21.23739,1561077
3921,petacz,10,0.00064,331542,21.23803,1561077
3922,pgmillon,10,0.00064,331552,21.23867,1561077
3923,pgpx,10,0.00064,331562,21.23931,1561077
3924,piwak,10,0.00064,331572,21.23995,1561077
3925,pokey909,10,0.00064,331582,21.24059,1561077
3926,polopi,10,0.00064,331592,21.24123,1561077
3927,Poojam-murthy,10,0.00064,331602,21.24187,1561077
3928,prachikhadke,10,0.00064,331612,21.24251,1561077
3929,presPetkov,10,0.00064,331622,21.24315,1561077
3930,q131172019,10,0.00064,331632,21.24380,1561077
3931,r67yfyt,10,0.00064,331642,21.24444,1561077
3932,rasputnik,10,0.00064,331652,21.24508,1561077
3933,raviagarwal101,10,0.00064,331662,21.24572,1561077
3934,ravinder1985,10,0.00064,331672,21.24636,1561077
3935,ravindrakmr,10,0.00064,331682,21.24700,1561077
3936,rdesgroppes,10,0.00064,331692,21.24764,1561077
3937,reenberg,10,0.00064,331702,21.24828,1561077
3938,relyafi,10,0.00064,331712,21.24892,1561077
3939,renat-sabitov-sirca,10,0.00064,331722,21.24956,1561077
3940,reportingsjr,10,0.00064,331732,21.25020,1561077
3941,r-funke,10,0.00064,331742,21.25084,1561077
3942,rgov,10,0.00064,331752,21.25148,1561077
3943,rickie,10,0.00064,331762,21.25212,1561077
3944,rjohnst,10,0.00064,331772,21.25276,1561077
3945,rnickle79,10,0.00064,331782,21.25340,1561077
3946,robvadai,10,0.00064,331792,21.25404,1561077
3947,rupertgti,10,0.00064,331802,21.25469,1561077
3948,sagar-khanna,10,0.00064,331812,21.25533,1561077
3949,sahilkmansuriibm,10,0.00064,331822,21.25597,1561077
3950,SamsonChen94,10,0.00064,331832,21.25661,1561077
3951,sanjaykharwar,10,0.00064,331842,21.25725,1561077
3952,sarveshtamba,10,0.00064,331852,21.25789,1561077
3953,Sateesh16683,10,0.00064,331862,21.25853,1561077
3954,Saucistophe,10,0.00064,331872,21.25917,1561077
3955,scheibinger,10,0.00064,331882,21.25981,1561077
3956,schwede,10,0.00064,331892,21.26045,1561077
3957,scivm,10,0.00064,331902,21.26109,1561077
3958,sdiepend,10,0.00064,331912,21.26173,1561077
3959,sdouche,10,0.00064,331922,21.26237,1561077
3960,sean-3,10,0.00064,331932,21.26301,1561077
3961,sesto,10,0.00064,331942,21.26365,1561077
3962,sfontana,10,0.00064,331952,21.26429,1561077
3963,Sgydoo,10,0.00064,331962,21.26493,1561077
3964,sh4sh,10,0.00064,331972,21.26557,1561077
3965,shankarinece,10,0.00064,331982,21.26622,1561077
3966,sharvanath,10,0.00064,331992,21.26686,1561077
3967,sheinbergon,10,0.00064,332002,21.26750,1561077
3968,shividhar,10,0.00064,332012,21.26814,1561077
3969,shiyu-dong,10,0.00064,332022,21.26878,1561077
3970,Simmay93,10,0.00064,332032,21.26942,1561077
3971,sindhusri16,10,0.00064,332042,21.27006,1561077
3972,Sir-Jacques,10,0.00064,332052,21.27070,1561077
3973,sithmein,10,0.00064,332062,21.27134,1561077
3974,skannengiesser,10,0.00064,332072,21.27198,1561077
3975,skorhone,10,0.00064,332082,21.27262,1561077
3976,slb350,10,0.00064,332092,21.27326,1561077
3977,smithrs,10,0.00064,332102,21.27390,1561077
3978,smoyen,10,0.00064,332112,21.27454,1561077
3979,snay2,10,0.00064,332122,21.27518,1561077
3980,solud,10,0.00064,332132,21.27582,1561077
3981,sonarsphere,10,0.00064,332142,21.27646,1561077
3982,songsb13,10,0.00064,332152,21.27711,1561077
3983,sonneveld,10,0.00064,332162,21.27775,1561077
3984,Sophia-Okito,10,0.00064,332172,21.27839,1561077
3985,sotona-,10,0.00064,332182,21.27903,1561077
3986,spotlesstofu,10,0.00064,332192,21.27967,1561077
3987,Springjunky,10,0.00064,332202,21.28031,1561077
3988,stephlag,10,0.00064,332212,21.28095,1561077
3989,SvenLuebke,10,0.00064,332222,21.28159,1561077
3990,talbright,10,0.00064,332232,21.28223,1561077
3991,tangicolin,10,0.00064,332242,21.28287,1561077
3992,tapvirvirk,10,0.00064,332252,21.28351,1561077
3993,tatoberres,10,0.00064,332262,21.28415,1561077
3994,tbulubas,10,0.00064,332272,21.28479,1561077
3995,tdillenbeck,10,0.00064,332282,21.28543,1561077
3996,tgquan67,10,0.00064,332292,21.28607,1561077
3997,thiagozanetti,10,0.00064,332302,21.28671,1561077
3998,Thilaknath,10,0.00064,332312,21.28735,1561077
3999,thomaste,10,0.00064,332322,21.28800,1561077
4000,timops,10,0.00064,332332,21.28864,1561077
4001,TimoPtr,10,0.00064,332342,21.28928,1561077
4002,tingzhang-ming,10,0.00064,332352,21.28992,1561077
4003,tjbaker,10,0.00064,332362,21.29056,1561077
4004,tkalmar,10,0.00064,332372,21.29120,1561077
4005,tlantz,10,0.00064,332382,21.29184,1561077
4006,todeaoana,10,0.00064,332392,21.29248,1561077
4007,TPXP,10,0.00064,332402,21.29312,1561077
4008,tryIdea,10,0.00064,332412,21.29376,1561077
4009,tshasc,10,0.00064,332422,21.29440,1561077
4010,twogee,10,0.00064,332432,21.29504,1561077
4011,Tyler-Yates,10,0.00064,332442,21.29568,1561077
4012,umlublin,10,0.00064,332452,21.29632,1561077
4013,UncleIS,10,0.00064,332462,21.29696,1561077
4014,underscoreanuj,10,0.00064,332472,21.29760,1561077
4015,UnsolvedCypher,10,0.00064,332482,21.29824,1561077
4016,urusha,10,0.00064,332492,21.29889,1561077
4017,usinelogicielle,10,0.00064,332502,21.29953,1561077
4018,vava,10,0.00064,332512,21.30017,1561077
4019,veerendraopsmx,10,0.00064,332522,21.30081,1561077
4020,vicknesh22,10,0.00064,332532,21.30145,1561077
4021,vincenthodicq,10,0.00064,332542,21.30209,1561077
4022,vinitasanghi,10,0.00064,332552,21.30273,1561077
4023,vishal84,10,0.00064,332562,21.30337,1561077
4024,vishalhcl,10,0.00064,332572,21.30401,1561077
4025,viyh,10,0.00064,332582,21.30465,1561077
4026,vvvsrx,10,0.00064,332592,21.30529,1561077
4027,waggledans,10,0.00064,332602,21.30593,1561077
4028,waldyr,10,0.00064,332612,21.30657,1561077
4029,walliski,10,0.00064,332622,21.30721,1561077
4030,wazery,10,0.00064,332632,21.30785,1561077
4031,wiese,10,0.00064,332642,21.30849,1561077
4032,wobbals,10,0.00064,332652,21.30913,1561077
4033,Wonno,10,0.00064,332662,21.30978,1561077
4034,wrender,10,0.00064,332672,21.31042,1561077
4035,xavierzwirtz,10,0.00064,332682,21.31106,1561077
4036,yana-gusti,10,0.00064,332692,21.31170,1561077
4037,yashj21,10,0.00064,332702,21.31234,1561077
4038,ykirank25,10,0.00064,332712,21.31298,1561077
4039,yocode,10,0.00064,332722,21.31362,1561077
4040,yogeshghotekar,10,0.00064,332732,21.31426,1561077
4041,ypto,10,0.00064,332742,21.31490,1561077
4042,yutaolian,10,0.00064,332752,21.31554,1561077
4043,zackmeath,10,0.00064,332762,21.31618,1561077
4044,zeusro,10,0.00064,332772,21.31682,1561077
4045,zhaochunqi,10,0.00064,332782,21.31746,1561077
4046,zss1zss2,10,0.00064,332792,21.31810,1561077
4047,4n70w4,9,0.00058,332801,21.31868,1561077
4048,613andred,9,0.00058,332810,21.31926,1561077
4049,70995781,9,0.00058,332819,21.31983,1561077
4050,a-ba,9,0.00058,332828,21.32041,1561077
4051,AboorvaDevarajan,9,0.00058,332837,21.32099,1561077
4052,acdcjunior,9,0.00058,332846,21.32156,1561077
4053,acohen716,9,0.00058,332855,21.32214,1561077
4054,acormier1,9,0.00058,332864,21.32272,1561077
4055,adamdougal,9,0.00058,332873,21.32329,1561077
4056,aderigs,9,0.00058,332882,21.32387,1561077
4057,aellwein,9,0.00058,332891,21.32444,1561077
4058,Aga303,9,0.00058,332900,21.32502,1561077
4059,agray,9,0.00058,332909,21.32560,1561077
4060,Agukov,9,0.00058,332918,21.32617,1561077
4061,aishkotni,9,0.00058,332927,21.32675,1561077
4062,ajaypandit,9,0.00058,332936,21.32733,1561077
4063,Ajaypathak372,9,0.00058,332945,21.32790,1561077
4064,akennealy,9,0.00058,332954,21.32848,1561077
4065,akrymets,9,0.00058,332963,21.32906,1561077
4066,alexbde,9,0.00058,332972,21.32963,1561077
4067,alexey-sinyuk,9,0.00058,332981,21.33021,1561077
4068,Alexxtheonly,9,0.00058,332990,21.33079,1561077
4069,alfabravoteam,9,0.00058,332999,21.33136,1561077
4070,AliakseiSavanchuk,9,0.00058,333008,21.33194,1561077
4071,alorlea,9,0.00058,333017,21.33252,1561077
4072,alreay,9,0.00058,333026,21.33309,1561077
4073,amainwaring,9,0.00058,333035,21.33367,1561077
4074,AmanSarraf,9,0.00058,333044,21.33425,1561077
4075,anderl86,9,0.00058,333053,21.33482,1561077
4076,AndreasKnapp1812,9,0.00058,333062,21.33540,1561077
4077,Andrei-Stepanov,9,0.00058,333071,21.33598,1561077
4078,andrewdmcleod,9,0.00058,333080,21.33655,1561077
4079,andrewm-aero,9,0.00058,333089,21.33713,1561077
4080,andrzejwp,9,0.00058,333098,21.33770,1561077
4081,andzej505hq,9,0.00058,333107,21.33828,1561077
4082,Angie1013,9,0.00058,333116,21.33886,1561077
4083,animeshdas2000,9,0.00058,333125,21.33943,1561077
4084,anjal-pachat,9,0.00058,333134,21.34001,1561077
4085,AnsisMalins,9,0.00058,333143,21.34059,1561077
4086,AnthonyMastrean,9,0.00058,333152,21.34116,1561077
4087,arcadien,9,0.00058,333161,21.34174,1561077
4088,arjenzhou,9,0.00058,333170,21.34232,1561077
4089,armandfp,9,0.00058,333179,21.34289,1561077
4090,ashwinjk,9,0.00058,333188,21.34347,1561077
4091,ask-SAK,9,0.00058,333197,21.34405,1561077
4092,atehrani,9,0.00058,333206,21.34462,1561077
4093,baaym,9,0.00058,333215,21.34520,1561077
4094,BalintSzigeti,9,0.00058,333224,21.34578,1561077
4095,bawjensen,9,0.00058,333233,21.34635,1561077
4096,BBimie,9,0.00058,333242,21.34693,1561077
4097,bchavet,9,0.00058,333251,21.34751,1561077
4098,b-dean,9,0.00058,333260,21.34808,1561077
4099,bdkoepke,9,0.00058,333269,21.34866,1561077
4100,benjaoming,9,0.00058,333278,21.34924,1561077
4101,benjarobin,9,0.00058,333287,21.34981,1561077
4102,benken-parasoft,9,0.00058,333296,21.35039,1561077
4103,BerndFarkaDyna,9,0.00058,333305,21.35096,1561077
4104,bgoncalv,9,0.00058,333314,21.35154,1561077
4105,binhex,9,0.00058,333323,21.35212,1561077
4106,bjacklyn,9,0.00058,333332,21.35269,1561077
4107,Bjoern-Hegstam,9,0.00058,333341,21.35327,1561077
4108,BlueCog,9,0.00058,333350,21.35385,1561077
4109,bmess,9,0.00058,333359,21.35442,1561077
4110,borisovano,9,0.00058,333368,21.35500,1561077
4111,boydj,9,0.00058,333377,21.35558,1561077
4112,breisig,9,0.00058,333386,21.35615,1561077
4113,BrianSidebotham,9,0.00058,333395,21.35673,1561077
4114,byuvasri,9,0.00058,333404,21.35731,1561077
4115,bzehner93,9,0.00058,333413,21.35788,1561077
4116,camerenisonfire,9,0.00058,333422,21.35846,1561077
4117,castanedaci,9,0.00058,333431,21.35904,1561077
4118,Cetlan,9,0.00058,333440,21.35961,1561077
4119,cgumpert,9,0.00058,333449,21.36019,1561077
4120,ChaiBapchya,9,0.00058,333458,21.36077,1561077
4121,champidead,9,0.00058,333467,21.36134,1561077
4122,championofblocks,9,0.00058,333476,21.36192,1561077
4123,chaoyangnz,9,0.00058,333485,21.36250,1561077
4124,Chekov2k,9,0.00058,333494,21.36307,1561077
4125,childnode,9,0.00058,333503,21.36365,1561077
4126,chongkong,9,0.00058,333512,21.36422,1561077
4127,chri7325,9,0.00058,333521,21.36480,1561077
4128,chrisgrove-keysight,9,0.00058,333530,21.36538,1561077
4129,christianmue1980a,9,0.00058,333539,21.36595,1561077
4130,christopherfrieler,9,0.00058,333548,21.36653,1561077
4131,chrylis,9,0.00058,333557,21.36711,1561077
4132,ciaranj,9,0.00058,333566,21.36768,1561077
4133,cidermole,9,0.00058,333575,21.36826,1561077
4134,code-knayam,9,0.00058,333584,21.36884,1561077
4135,codeleongy,9,0.00058,333593,21.36941,1561077
4136,colinodell,9,0.00058,333602,21.36999,1561077
4137,Cyanoth,9,0.00058,333611,21.37057,1561077
4138,cyburs,9,0.00058,333620,21.37114,1561077
4139,daanipuui,9,0.00058,333629,21.37172,1561077
4140,danielosg,9,0.00058,333638,21.37230,1561077
4141,danpalmer,9,0.00058,333647,21.37287,1561077
4142,dantwining,9,0.00058,333656,21.37345,1561077
4143,danzilio,9,0.00058,333665,21.37403,1561077
4144,daveLC,9,0.00058,333674,21.37460,1561077
4145,dbuedo,9,0.00058,333683,21.37518,1561077
4146,dchinmaya,9,0.00058,333692,21.37576,1561077
4147,delitescere,9,0.00058,333701,21.37633,1561077
4148,derinbay,9,0.00058,333710,21.37691,1561077
4149,DerkSchooltink,9,0.00058,333719,21.37748,1561077
4150,dgreene-r7,9,0.00058,333728,21.37806,1561077
4151,DotComing,9,0.00058,333737,21.37864,1561077
4152,doulba,9,0.00058,333746,21.37921,1561077
4153,dpogue,9,0.00058,333755,21.37979,1561077
4154,dragon788,9,0.00058,333764,21.38037,1561077
4155,duchatran,9,0.00058,333773,21.38094,1561077
4156,dvilaverde,9,0.00058,333782,21.38152,1561077
4157,earimont-ib,9,0.00058,333791,21.38210,1561077
4158,eddie-knight,9,0.00058,333800,21.38267,1561077
4159,edlevin6612,9,0.00058,333809,21.38325,1561077
4160,egonelbre,9,0.00058,333818,21.38383,1561077
4161,elliot-nelson,9,0.00058,333827,21.38440,1561077
4162,emccallum,9,0.00058,333836,21.38498,1561077
4163,enigma0Z,9,0.00058,333845,21.38556,1561077
4164,enwi,9,0.00058,333854,21.38613,1561077
4165,epowell,9,0.00058,333863,21.38671,1561077
4166,erickrmz,9,0.00058,333872,21.38729,1561077
4167,everops-alex,9,0.00058,333881,21.38786,1561077
4168,eyalb4doc,9,0.00058,333890,21.38844,1561077
4169,Fearxpc,9,0.00058,333899,21.38902,1561077
4170,FelicityHughes,9,0.00058,333908,21.38959,1561077
4171,felipeinfantino,9,0.00058,333917,21.39017,1561077
4172,feuer93,9,0.00058,333926,21.39074,1561077
4173,FeynmanFan,9,0.00058,333935,21.39132,1561077
4174,fhuberts,9,0.00058,333944,21.39190,1561077
4175,fkyc,9,0.00058,333953,21.39247,1561077
4176,flavioaiello,9,0.00058,333962,21.39305,1561077
4177,forever84721,9,0.00058,333971,21.39363,1561077
4178,fossdd,9,0.00058,333980,21.39420,1561077
4179,francisdb,9,0.00058,333989,21.39478,1561077
4180,friendly-pineapple,9,0.00058,333998,21.39536,1561077
4181,fujii,9,0.00058,334007,21.39593,1561077
4182,Fyb3roptik,9,0.00058,334016,21.39651,1561077
4183,Galileo1,9,0.00058,334025,21.39709,1561077
4184,garadox,9,0.00058,334034,21.39766,1561077
4185,gauravgupta288,9,0.00058,334043,21.39824,1561077
4186,GavrielNsof,9,0.00058,334052,21.39882,1561077
4187,gdbtheboss,9,0.00058,334061,21.39939,1561077
4188,gena01,9,0.00058,334070,21.39997,1561077
4189,ghglza,9,0.00058,334079,21.40055,1561077
4190,Giftedl-Jarvis,9,0.00058,334088,21.40112,1561077
4191,githubvick,9,0.00058,334097,21.40170,1561077
4192,gmarzot,9,0.00058,334106,21.40228,1561077
4193,GrantStreetGroup,9,0.00058,334115,21.40285,1561077
4194,grossws,9,0.00058,334124,21.40343,1561077
4195,Guschtel,9,0.00058,334133,21.40401,1561077
4196,HagarJNode,9,0.00058,334142,21.40458,1561077
4197,Haniket,9,0.00058,334151,21.40516,1561077
4198,hareku,9,0.00058,334160,21.40573,1561077
4199,Harriebo,9,0.00058,334169,21.40631,1561077
4200,hasakura12,9,0.00058,334178,21.40689,1561077
4201,hector-vido,9,0.00058,334187,21.40746,1561077
4202,highflyer910,9,0.00058,334196,21.40804,1561077
4203,himanshutaneja,9,0.00058,334205,21.40862,1561077
4204,h-okon,9,0.00058,334214,21.40919,1561077
4205,holgerfriedrich,9,0.00058,334223,21.40977,1561077
4206,holleymcfly,9,0.00058,334232,21.41035,1561077
4207,HonoluluHenk,9,0.00058,334241,21.41092,1561077
4208,howlger,9,0.00058,334250,21.41150,1561077
4209,hyunto,9,0.00058,334259,21.41208,1561077
4210,hzh,9,0.00058,334268,21.41265,1561077
4211,iax7,9,0.00058,334277,21.41323,1561077
4212,ikudriavtsev,9,0.00058,334286,21.41381,1561077
4213,Impakt,9,0.00058,334295,21.41438,1561077
4214,IntelBob,9,0.00058,334304,21.41496,1561077
4215,iptizer,9,0.00058,334313,21.41554,1561077
4216,ishani2412,9,0.00058,334322,21.41611,1561077
4217,itonito,9,0.00058,334331,21.41669,1561077
4218,Itsredd,9,0.00058,334340,21.41727,1561077
4219,james-m-tubbs,9,0.00058,334349,21.41784,1561077
4220,jamestelfer,9,0.00058,334358,21.41842,1561077
4221,jamiejackson,9,0.00058,334367,21.41899,1561077
4222,Janfy,9,0.00058,334376,21.41957,1561077
4223,janinko,9,0.00058,334385,21.42015,1561077
4224,jatinbajaj1,9,0.00058,334394,21.42072,1561077
4225,jbg,9,0.00058,334403,21.42130,1561077
4226,jcmoore3,9,0.00058,334412,21.42188,1561077
4227,JeanFred,9,0.00058,334421,21.42245,1561077
4228,JeffCobble,9,0.00058,334430,21.42303,1561077
4229,JesperTerkelsen,9,0.00058,334439,21.42361,1561077
4230,jfdenise,9,0.00058,334448,21.42418,1561077
4231,jgarverick,9,0.00058,334457,21.42476,1561077
4232,jgsogo,9,0.00058,334466,21.42534,1561077
4233,jhagege,9,0.00058,334475,21.42591,1561077
4234,jhg03a,9,0.00058,334484,21.42649,1561077
4235,jmlambert78,9,0.00058,334493,21.42707,1561077
4236,jmrodriguez-clv,9,0.00058,334502,21.42764,1561077
4237,jniesen,9,0.00058,334511,21.42822,1561077
4238,jninnes,9,0.00058,334520,21.42880,1561077
4239,joakime,9,0.00058,334529,21.42937,1561077
4240,jobcespedes,9,0.00058,334538,21.42995,1561077
4241,john-forrest,9,0.00058,334547,21.43053,1561077
4242,Johnlon,9,0.00058,334556,21.43110,1561077
4243,jordancoll,9,0.00058,334565,21.43168,1561077
4244,josedlpozo,9,0.00058,334574,21.43225,1561077
4245,JPEWdev,9,0.00058,334583,21.43283,1561077
4246,j-rivero,9,0.00058,334592,21.43341,1561077
4247,jrx-sjg,9,0.00058,334601,21.43398,1561077
4248,jsamu8ta,9,0.00058,334610,21.43456,1561077
4249,jsimao71,9,0.00058,334619,21.43514,1561077
4250,jtestard,9,0.00058,334628,21.43571,1561077
4251,juliomaqueda,9,0.00058,334637,21.43629,1561077
4252,jwbowen,9,0.00058,334646,21.43687,1561077
4253,kad-meedel,9,0.00058,334655,21.43744,1561077
4254,kakakakakku,9,0.00058,334664,21.43802,1561077
4255,Kalmalyzer,9,0.00058,334673,21.43860,1561077
4256,kanata2,9,0.00058,334682,21.43917,1561077
4257,karel1980,9,0.00058,334691,21.43975,1561077
4258,karisivo,9,0.00058,334700,21.44033,1561077
4259,karolgil,9,0.00058,334709,21.44090,1561077
4260,kassovix,9,0.00058,334718,21.44148,1561077
4261,kbeal,9,0.00058,334727,21.44206,1561077
4262,kchuriumova,9,0.00058,334736,21.44263,1561077
4263,KenHundley,9,0.00058,334745,21.44321,1561077
4264,kevinhuber,9,0.00058,334754,21.44379,1561077
4265,khansaAmrouni,9,0.00058,334763,21.44436,1561077
4266,kinnonyee-armory,9,0.00058,334772,21.44494,1561077
4267,klausbayrhammer,9,0.00058,334781,21.44551,1561077
4268,kmarczyk,9,0.00058,334790,21.44609,1561077
4269,kosiuk,9,0.00058,334799,21.44667,1561077
4270,krallin,9,0.00058,334808,21.44724,1561077
4271,KrishanBhasin,9,0.00058,334817,21.44782,1561077
4272,krishnaraman001,9,0.00058,334826,21.44840,1561077
4273,krmahadevan,9,0.00058,334835,21.44897,1561077
4274,kumarinfo90,9,0.00058,334844,21.44955,1561077
4275,LahariGuntha,9,0.00058,334853,21.45013,1561077
4276,Lanuet,9,0.00058,334862,21.45070,1561077
4277,laurence-h,9,0.00058,334871,21.45128,1561077
4278,laurentgoudet,9,0.00058,334880,21.45186,1561077
4279,leinardi,9,0.00058,334889,21.45243,1561077
4280,leonpros,9,0.00058,334898,21.45301,1561077
4281,lhr0909,9,0.00058,334907,21.45359,1561077
4282,litmanovich,9,0.00058,334916,21.45416,1561077
4283,lmussier,9,0.00058,334925,21.45474,1561077
4284,Ln11211,9,0.00058,334934,21.45532,1561077
4285,lucasclavero,9,0.00058,334943,21.45589,1561077
4286,luis-garza,9,0.00058,334952,21.45647,1561077
4287,madhukiranbr,9,0.00058,334961,21.45705,1561077
4288,Mage-Sky,9,0.00058,334970,21.45762,1561077
4289,magnusr,9,0.00058,334979,21.45820,1561077
4290,maiconbaumx,9,0.00058,334988,21.45877,1561077
4291,marcesher,9,0.00058,334997,21.45935,1561077
4292,marcin-kaniasty,9,0.00058,335006,21.45993,1561077
4293,marinusveit,9,0.00058,335015,21.46050,1561077
4294,markiewiczart,9,0.00058,335024,21.46108,1561077
4295,MarkusTiede,9,0.00058,335033,21.46166,1561077
4296,marlene01,9,0.00058,335042,21.46223,1561077
4297,martazobro,9,0.00058,335051,21.46281,1561077
4298,mat-613,9,0.00058,335060,21.46339,1561077
4299,mattfirtion,9,0.00058,335069,21.46396,1561077
4300,MaxCCC,9,0.00058,335078,21.46454,1561077
4301,mayaaravotwm,9,0.00058,335087,21.46512,1561077
4302,maybeec,9,0.00058,335096,21.46569,1561077
4303,mennatallah-amer,9,0.00058,335105,21.46627,1561077
4304,mhess2005,9,0.00058,335114,21.46685,1561077
4305,michaelcresswell,9,0.00058,335123,21.46742,1561077
4306,michaelseno,9,0.00058,335132,21.46800,1561077
4307,micxer,9,0.00058,335141,21.46858,1561077
4308,miglen,9,0.00058,335150,21.46915,1561077
4309,mikael-lindstrom,9,0.00058,335159,21.46973,1561077
4310,mikenau,9,0.00058,335168,21.47031,1561077
4311,Mi-La,9,0.00058,335177,21.47088,1561077
4312,mkarebski,9,0.00058,335186,21.47146,1561077
4313,mluebcke,9,0.00058,335195,21.47204,1561077
4314,moredhel,9,0.00058,335204,21.47261,1561077
4315,Mosho1,9,0.00058,335213,21.47319,1561077
4316,MrCitron,9,0.00058,335222,21.47376,1561077
4317,mrpity,9,0.00058,335231,21.47434,1561077
4318,msembinelli,9,0.00058,335240,21.47492,1561077
4319,mtolan,9,0.00058,335249,21.47549,1561077
4320,mukundsrinivasb,9,0.00058,335258,21.47607,1561077
4321,Munchery-JunyuWang,9,0.00058,335267,21.47665,1561077
4322,muslumb,9,0.00058,335276,21.47722,1561077
4323,n0mer,9,0.00058,335285,21.47780,1561077
4324,n0rig,9,0.00058,335294,21.47838,1561077
4325,Nagamohan1,9,0.00058,335303,21.47895,1561077
4326,nakula,9,0.00058,335312,21.47953,1561077
4327,nazarovkv,9,0.00058,335321,21.48011,1561077
4328,nbali,9,0.00058,335330,21.48068,1561077
4329,nbtdev,9,0.00058,335339,21.48126,1561077
4330,ndobson,9,0.00058,335348,21.48184,1561077
4331,nemesis-cruz-ar,9,0.00058,335357,21.48241,1561077
4332,nephre,9,0.00058,335366,21.48299,1561077
4333,neuro-support,9,0.00058,335375,21.48357,1561077
4334,NickWemekamp,9,0.00058,335384,21.48414,1561077
4335,nidve01,9,0.00058,335393,21.48472,1561077
4336,nikolay-martynov,9,0.00058,335402,21.48530,1561077
4337,niksw7,9,0.00058,335411,21.48587,1561077
4338,niranjanib,9,0.00058,335420,21.48645,1561077
4339,nishubansal,9,0.00058,335429,21.48702,1561077
4340,nosmo,9,0.00058,335438,21.48760,1561077
4341,NotSoImportant,9,0.00058,335447,21.48818,1561077
4342,nysander,9,0.00058,335456,21.48875,1561077
4343,Okhan-coder,9,0.00058,335465,21.48933,1561077
4344,oleksiilv,9,0.00058,335474,21.48991,1561077
4345,OmarElabd,9,0.00058,335483,21.49048,1561077
4346,omer-sd,9,0.00058,335492,21.49106,1561077
4347,Orekaria,9,0.00058,335501,21.49164,1561077
4348,Palmr,9,0.00058,335510,21.49221,1561077
4349,pansonm,9,0.00058,335519,21.49279,1561077
4350,PatrickRose,9,0.00058,335528,21.49337,1561077
4351,pawbur,9,0.00058,335537,21.49394,1561077
4352,peterchanghk01,9,0.00058,335546,21.49452,1561077
4353,petli,9,0.00058,335555,21.49510,1561077
4354,pguduru,9,0.00058,335564,21.49567,1561077
4355,pkumarxebia,9,0.00058,335573,21.49625,1561077
4356,plutonji,9,0.00058,335582,21.49683,1561077
4357,pmhahn,9,0.00058,335591,21.49740,1561077
4358,prachipalaskar23,9,0.00058,335600,21.49798,1561077
4359,pranshuverma,9,0.00058,335609,21.49856,1561077
4360,praqmaTim,9,0.00058,335618,21.49913,1561077
4361,pratiktest,9,0.00058,335627,21.49971,1561077
4362,purkhusid,9,0.00058,335636,21.50028,1561077
4363,qrsty,9,0.00058,335645,21.50086,1561077
4364,quassainraza,9,0.00058,335654,21.50144,1561077
4365,Quintok,9,0.00058,335663,21.50201,1561077
4366,r1ddl3m37h15,9,0.00058,335672,21.50259,1561077
4367,r4v5,9,0.00058,335681,21.50317,1561077
4368,rago-actions,9,0.00058,335690,21.50374,1561077
4369,ravage84,9,0.00058,335699,21.50432,1561077
4370,rboyc,9,0.00058,335708,21.50490,1561077
4371,rburgst,9,0.00058,335717,21.50547,1561077
4372,rcarun,9,0.00058,335726,21.50605,1561077
4373,redbrain,9,0.00058,335735,21.50663,1561077
4374,reddybhavaniprasad,9,0.00058,335744,21.50720,1561077
4375,regicsolutions,9,0.00058,335753,21.50778,1561077
4376,remh,9,0.00058,335762,21.50836,1561077
4377,renatoaraujoc,9,0.00058,335771,21.50893,1561077
4378,rgrebski,9,0.00058,335780,21.50951,1561077
4379,rhnewtron,9,0.00058,335789,21.51009,1561077
4380,rhysm,9,0.00058,335798,21.51066,1561077
4381,RichardChester,9,0.00058,335807,21.51124,1561077
4382,rickthepick,9,0.00058,335816,21.51182,1561077
4383,robocoder99,9,0.00058,335825,21.51239,1561077
4384,rodrigoguedes,9,0.00058,335834,21.51297,1561077
4385,rodrigozrusso,9,0.00058,335843,21.51354,1561077
4386,roguexz,9,0.00058,335852,21.51412,1561077
4387,ronkorland,9,0.00058,335861,21.51470,1561077
4388,sachu,9,0.00058,335870,21.51527,1561077
4389,saiimons,9,0.00058,335879,21.51585,1561077
4390,saipavan9,9,0.00058,335888,21.51643,1561077
4391,SameerGoyal125,9,0.00058,335897,21.51700,1561077
4392,sancelot,9,0.00058,335906,21.51758,1561077
4393,sanhi,9,0.00058,335915,21.51816,1561077
4394,sanigo,9,0.00058,335924,21.51873,1561077
4395,SarrahV,9,0.00058,335933,21.51931,1561077
4396,sathishavm,9,0.00058,335942,21.51989,1561077
4397,sbmehdy,9,0.00058,335951,21.52046,1561077
4398,scarrato,9,0.00058,335960,21.52104,1561077
4399,Sector14,9,0.00058,335969,21.52162,1561077
4400,Semmu,9,0.00058,335978,21.52219,1561077
4401,semos,9,0.00058,335987,21.52277,1561077
4402,sgautrin,9,0.00058,335996,21.52335,1561077
4403,shardy-cuda,9,0.00058,336005,21.52392,1561077
4404,shimpossible,9,0.00058,336014,21.52450,1561077
4405,shteou,9,0.00058,336023,21.52508,1561077
4406,shurikg,9,0.00058,336032,21.52565,1561077
4407,sichapman,9,0.00058,336041,21.52623,1561077
4408,simpgeek,9,0.00058,336050,21.52680,1561077
4409,sknight80,9,0.00058,336059,21.52738,1561077
4410,slaboure,9,0.00058,336068,21.52796,1561077
4411,slopez-quotient,9,0.00058,336077,21.52853,1561077
4412,smaftoul,9,0.00058,336086,21.52911,1561077
4413,smcavallo,9,0.00058,336095,21.52969,1561077
4414,snehakpersistent,9,0.00058,336104,21.53026,1561077
4415,SnowKnight42,9,0.00058,336113,21.53084,1561077
4416,sofam,9,0.00058,336122,21.53142,1561077
4417,sonali-rajput,9,0.00058,336131,21.53199,1561077
4418,spacedog,9,0.00058,336140,21.53257,1561077
4419,SpComb,9,0.00058,336149,21.53315,1561077
4420,speedywizard,9,0.00058,336158,21.53372,1561077
4421,sratz,9,0.00058,336167,21.53430,1561077
4422,srempfer,9,0.00058,336176,21.53488,1561077
4423,srinut096,9,0.00058,336185,21.53545,1561077
4424,ssvinoth22,9,0.00058,336194,21.53603,1561077
4425,stefandrissen,9,0.00058,336203,21.53661,1561077
4426,sternr,9,0.00058,336212,21.53718,1561077
4427,stevemayster,9,0.00058,336221,21.53776,1561077
4428,StoyanIvanovI,9,0.00058,336230,21.53834,1561077
4429,stru4OK,9,0.00058,336239,21.53891,1561077
4430,sturmf,9,0.00058,336248,21.53949,1561077
4431,subos2008,9,0.00058,336257,21.54006,1561077
4432,sudaan,9,0.00058,336266,21.54064,1561077
4433,sukanyasuresh,9,0.00058,336275,21.54122,1561077
4434,sumoanema,9,0.00058,336284,21.54179,1561077
4435,SuneelMaurya,9,0.00058,336293,21.54237,1561077
4436,sunil-vishwakarma-broadcom,9,0.00058,336302,21.54295,1561077
4437,surendra20,9,0.00058,336311,21.54352,1561077
4438,sureshmurthy85,9,0.00058,336320,21.54410,1561077
4439,svcautomator,9,0.00058,336329,21.54468,1561077
4440,t3d,9,0.00058,336338,21.54525,1561077
4441,taoistmath,9,0.00058,336347,21.54583,1561077
4442,tehsu,9,0.00058,336356,21.54641,1561077
4443,testuser7,9,0.00058,336365,21.54698,1561077
4444,thedomcab,9,0.00058,336374,21.54756,1561077
4445,TheImplementer,9,0.00058,336383,21.54814,1561077
4446,thomasbinny1989,9,0.00058,336392,21.54871,1561077
4447,TianxiangShen,9,0.00058,336401,21.54929,1561077
4448,timoris,9,0.00058,336410,21.54987,1561077
4449,tmcsantos,9,0.00058,336419,21.55044,1561077
4450,toabi,9,0.00058,336428,21.55102,1561077
4451,tomasnorre,9,0.00058,336437,21.55160,1561077
4452,tombee,9,0.00058,336446,21.55217,1561077
4453,tommikiviniemi-srs,9,0.00058,336455,21.55275,1561077
4454,tompa911,9,0.00058,336464,21.55333,1561077
4455,tompiscitell,9,0.00058,336473,21.55390,1561077
4456,tomqwu,9,0.00058,336482,21.55448,1561077
4457,toshke,9,0.00058,336491,21.55505,1561077
4458,tpbrown,9,0.00058,336500,21.55563,1561077
4459,tsal,9,0.00058,336509,21.55621,1561077
4460,tsurankov,9,0.00058,336518,21.55678,1561077
4461,twinderw,9,0.00058,336527,21.55736,1561077
4462,twllight,9,0.00058,336536,21.55794,1561077
4463,tzedar,9,0.00058,336545,21.55851,1561077
4464,Udiknedormin,9,0.00058,336554,21.55909,1561077
4465,UkonnRa,9,0.00058,336563,21.55967,1561077
4466,utkarsh006,9,0.00058,336572,21.56024,1561077
4467,UXabre,9,0.00058,336581,21.56082,1561077
4468,valones,9,0.00058,336590,21.56140,1561077
4469,vengopal,9,0.00058,336599,21.56197,1561077
4470,vhs21,9,0.00058,336608,21.56255,1561077
4471,vigneshsakthivel,9,0.00058,336617,21.56313,1561077
4472,VinaykumarEndla,9,0.00058,336626,21.56370,1561077
4473,wajika,9,0.00058,336635,21.56428,1561077
4474,wald-e,9,0.00058,336644,21.56486,1561077
4475,warrior8792,9,0.00058,336653,21.56543,1561077
4476,willpracht,9,0.00058,336662,21.56601,1561077
4477,wli66666,9,0.00058,336671,21.56659,1561077
4478,wpater,9,0.00058,336680,21.56716,1561077
4479,wTylerReid,9,0.00058,336689,21.56774,1561077
4480,wuhuizuo,9,0.00058,336698,21.56831,1561077
4481,wwalters12,9,0.00058,336707,21.56889,1561077
4482,wwu-cx,9,0.00058,336716,21.56947,1561077
4483,Xav83,9,0.00058,336725,21.57004,1561077
4484,xcolwell,9,0.00058,336734,21.57062,1561077
4485,xiajidexue,9,0.00058,336743,21.57120,1561077
4486,XLordalX,9,0.00058,336752,21.57177,1561077
4487,yamhai,9,0.00058,336761,21.57235,1561077
4488,yantimirov-timur,9,0.00058,336770,21.57293,1561077
4489,yashLadha,9,0.00058,336779,21.57350,1561077
4490,ybroeker,9,0.00058,336788,21.57408,1561077
4491,yermulnik,9,0.00058,336797,21.57466,1561077
4492,yh1094632455,9,0.00058,336806,21.57523,1561077
4493,Yihan1993,9,0.00058,336815,21.57581,1561077
4494,ytterx,9,0.00058,336824,21.57639,1561077
4495,zhouxinfeng,9,0.00058,336833,21.57696,1561077
4496,ziouf,9,0.00058,336842,21.57754,1561077
4497,Zipsnet,9,0.00058,336851,21.57812,1561077
4498,zivbaz,9,0.00058,336860,21.57869,1561077
4499,155knots,8,0.00051,336868,21.57920,1561077
4500,23doors,8,0.00051,336876,21.57972,1561077
4501,aaishikasb,8,0.00051,336884,21.58023,1561077
4502,aalmiray,8,0.00051,336892,21.58074,1561077
4503,abhinavjha126,8,0.00051,336900,21.58125,1561077
4504,abxhr,8,0.00051,336908,21.58177,1561077
4505,acunetix360,8,0.00051,336916,21.58228,1561077
4506,AdamBrousseau,8,0.00051,336924,21.58279,1561077
4507,adityai,8,0.00051,336932,21.58330,1561077
4508,Adityanr,8,0.00051,336940,21.58382,1561077
4509,afkbrb,8,0.00051,336948,21.58433,1561077
4510,ajayep,8,0.00051,336956,21.58484,1561077
4511,akhilkathuria,8,0.00051,336964,21.58535,1561077
4512,akhilkumar2601,8,0.00051,336972,21.58587,1561077
4513,AkshatM,8,0.00051,336980,21.58638,1561077
4514,AlbMor,8,0.00051,336988,21.58689,1561077
4515,alejandrovelez7,8,0.00051,336996,21.58740,1561077
4516,alexanderlink,8,0.00051,337004,21.58792,1561077
4517,alexejk,8,0.00051,337012,21.58843,1561077
4518,alexjrussell,8,0.00051,337020,21.58894,1561077
4519,alf5,8,0.00051,337028,21.58945,1561077
4520,AlienResidents,8,0.00051,337036,21.58997,1561077
4521,aloke-xebia,8,0.00051,337044,21.59048,1561077
4522,alu-training,8,0.00051,337052,21.59099,1561077
4523,andnyb,8,0.00051,337060,21.59150,1561077
4524,andreybehalf,8,0.00051,337068,21.59202,1561077
4525,andrey-hura,8,0.00051,337076,21.59253,1561077
4526,anihak,8,0.00051,337084,21.59304,1561077
4527,Ankit098,8,0.00051,337092,21.59355,1561077
4528,anudeep-bpgc,8,0.00051,337100,21.59407,1561077
4529,a-pikachu,8,0.00051,337108,21.59458,1561077
4530,apurvabhandari,8,0.00051,337116,21.59509,1561077
4531,arhe,8,0.00051,337124,21.59560,1561077
4532,arohithr8,8,0.00051,337132,21.59612,1561077
4533,Arthurflame,8,0.00051,337140,21.59663,1561077
4534,arunaousula9421,8,0.00051,337148,21.59714,1561077
4535,ashwini2410,8,0.00051,337156,21.59765,1561077
4536,atanasenko,8,0.00051,337164,21.59817,1561077
4537,Atchuu,8,0.00051,337172,21.59868,1561077
4538,Atrifex,8,0.00051,337180,21.59919,1561077
4539,austinthao5,8,0.00051,337188,21.59970,1561077
4540,autogun,8,0.00051,337196,21.60022,1561077
4541,Avi1235,8,0.00051,337204,21.60073,1561077
4542,avnerv,8,0.00051,337212,21.60124,1561077
4543,AymanDF,8,0.00051,337220,21.60175,1561077
4544,bacarroll,8,0.00051,337228,21.60227,1561077
4545,bachiri,8,0.00051,337236,21.60278,1561077
4546,BarelElbaz,8,0.00051,337244,21.60329,1561077
4547,barryprice,8,0.00051,337252,21.60380,1561077
4548,bartsaintgermain,8,0.00051,337260,21.60432,1561077
4549,beardedeagle,8,0.00051,337268,21.60483,1561077
4550,BenLloydPearson,8,0.00051,337276,21.60534,1561077
4551,BhaswatiRoy,8,0.00051,337284,21.60585,1561077
4552,bhavikbhavsar,8,0.00051,337292,21.60637,1561077
4553,bhoppeadoy,8,0.00051,337300,21.60688,1561077
4554,bilalvdemir,8,0.00051,337308,21.60739,1561077
4555,binarious,8,0.00051,337316,21.60790,1561077
4556,bjkastel,8,0.00051,337324,21.60842,1561077
4557,bkempe,8,0.00051,337332,21.60893,1561077
4558,Bl4d3s,8,0.00051,337340,21.60944,1561077
4559,Blackbaud-OdsDeploy,8,0.00051,337348,21.60995,1561077
4560,blackcat-lin,8,0.00051,337356,21.61047,1561077
4561,bmustiata,8,0.00051,337364,21.61098,1561077
4562,bobbyz-dk,8,0.00051,337372,21.61149,1561077
4563,borisivan,8,0.00051,337380,21.61200,1561077
4564,boussaffawalid,8,0.00051,337388,21.61251,1561077
4565,bparzella,8,0.00051,337396,21.61303,1561077
4566,bpedman,8,0.00051,337404,21.61354,1561077
4567,brainydamage,8,0.00051,337412,21.61405,1561077
4568,brianxjx,8,0.00051,337420,21.61456,1561077
4569,brosmar,8,0.00051,337428,21.61508,1561077
4570,brunnels,8,0.00051,337436,21.61559,1561077
4571,bvdawson,8,0.00051,337444,21.61610,1561077
4572,bversteegh,8,0.00051,337452,21.61661,1561077
4573,bzgec,8,0.00051,337460,21.61713,1561077
4574,camechis,8,0.00051,337468,21.61764,1561077
4575,canb0Testinium,8,0.00051,337476,21.61815,1561077
4576,carej,8,0.00051,337484,21.61866,1561077
4577,cfereday,8,0.00051,337492,21.61918,1561077
4578,cheeseit,8,0.00051,337500,21.61969,1561077
4579,chickenpie3,8,0.00051,337508,21.62020,1561077
4580,Chinmay922,8,0.00051,337516,21.62071,1561077
4581,chizou,8,0.00051,337524,21.62123,1561077
4582,chris-mac,8,0.00051,337532,21.62174,1561077
4583,christophgysin,8,0.00051,337540,21.62225,1561077
4584,ChristophII,8,0.00051,337548,21.62276,1561077
4585,cjbarker,8,0.00051,337556,21.62328,1561077
4586,cjerad,8,0.00051,337564,21.62379,1561077
4587,cmfcmf,8,0.00051,337572,21.62430,1561077
4588,colinlabs,8,0.00051,337580,21.62481,1561077
4589,Coogie7,8,0.00051,337588,21.62533,1561077
4590,coreegor,8,0.00051,337596,21.62584,1561077
4591,cotman,8,0.00051,337604,21.62635,1561077
4592,CptPlastic,8,0.00051,337612,21.62686,1561077
4593,CptSpaceToaster,8,0.00051,337620,21.62738,1561077
4594,crashvb,8,0.00051,337628,21.62789,1561077
4595,ctomp,8,0.00051,337636,21.62840,1561077
4596,danigar,8,0.00051,337644,21.62891,1561077
4597,davecore82,8,0.00051,337652,21.62943,1561077
4598,davidhonig,8,0.00051,337660,21.62994,1561077
4599,DavidPerezIngeniero,8,0.00051,337668,21.63045,1561077
4600,daydos,8,0.00051,337676,21.63096,1561077
4601,dbendelman,8,0.00051,337684,21.63148,1561077
4602,dclayton-godaddy,8,0.00051,337692,21.63199,1561077
4603,declension,8,0.00051,337700,21.63250,1561077
4604,DeepDiver1975,8,0.00051,337708,21.63301,1561077
4605,dee-see,8,0.00051,337716,21.63353,1561077
4606,deesprinter,8,0.00051,337724,21.63404,1561077
4607,dekokun,8,0.00051,337732,21.63455,1561077
4608,denis-arruda,8,0.00051,337740,21.63506,1561077
4609,denisj44,8,0.00051,337748,21.63558,1561077
4610,desolatorxxl,8,0.00051,337756,21.63609,1561077
4611,dewinterjack,8,0.00051,337764,21.63660,1561077
4612,diddy10,8,0.00051,337772,21.63711,1561077
4613,dimitryvolkov,8,0.00051,337780,21.63763,1561077
4614,dkfitbit,8,0.00051,337788,21.63814,1561077
4615,d-konovalov,8,0.00051,337796,21.63865,1561077
4616,dmaicher,8,0.00051,337804,21.63916,1561077
4617,dmardin,8,0.00051,337812,21.63968,1561077
4618,doino-gretchenliev,8,0.00051,337820,21.64019,1561077
4619,dolphy01,8,0.00051,337828,21.64070,1561077
4620,dominics,8,0.00051,337836,21.64121,1561077
4621,dplummer,8,0.00051,337844,21.64173,1561077
4622,DrakkenWulf,8,0.00051,337852,21.64224,1561077
4623,dreis2211,8,0.00051,337860,21.64275,1561077
4624,dsrink,8,0.00051,337868,21.64326,1561077
4625,dvdizon,8,0.00051,337876,21.64378,1561077
4626,dvlemplek,8,0.00051,337884,21.64429,1561077
4627,edef,8,0.00051,337892,21.64480,1561077
4628,EfrenRey,8,0.00051,337900,21.64531,1561077
4629,EltonAlvess,8,0.00051,337908,21.64583,1561077
4630,emexelem,8,0.00051,337916,21.64634,1561077
4631,engelmi,8,0.00051,337924,21.64685,1561077
4632,enginyoyen,8,0.00051,337932,21.64736,1561077
4633,eoc-ross,8,0.00051,337940,21.64788,1561077
4634,erenatas,8,0.00051,337948,21.64839,1561077
4635,ermshiperete,8,0.00051,337956,21.64890,1561077
4636,ernetas,8,0.00051,337964,21.64941,1561077
4637,erran-r7,8,0.00051,337972,21.64993,1561077
4638,etki,8,0.00051,337980,21.65044,1561077
4639,evanx9,8,0.00051,337988,21.65095,1561077
4640,ezdork,8,0.00051,337996,21.65146,1561077
4641,fabian84er,8,0.00051,338004,21.65197,1561077
4642,fabiang,8,0.00051,338012,21.65249,1561077
4643,fabiogoma,8,0.00051,338020,21.65300,1561077
4644,fbaligant,8,0.00051,338028,21.65351,1561077
4645,fl-max,8,0.00051,338036,21.65402,1561077
4646,Flow86,8,0.00051,338044,21.65454,1561077
4647,forpix,8,0.00051,338052,21.65505,1561077
4648,FP-Dmytro-B,8,0.00051,338060,21.65556,1561077
4649,frami,8,0.00051,338068,21.65607,1561077
4650,frankchrisg,8,0.00051,338076,21.65659,1561077
4651,FrankS77,8,0.00051,338084,21.65710,1561077
4652,frazergibsonntt,8,0.00051,338092,21.65761,1561077
4653,froggabriel,8,0.00051,338100,21.65812,1561077
4654,fuzzmz,8,0.00051,338108,21.65864,1561077
4655,fyrnaga,8,0.00051,338116,21.65915,1561077
4656,g0194776,8,0.00051,338124,21.65966,1561077
4657,gailazar300,8,0.00051,338132,21.66017,1561077
4658,galek,8,0.00051,338140,21.66069,1561077
4659,Gammal-Skalbagge,8,0.00051,338148,21.66120,1561077
4660,garyttierney,8,0.00051,338156,21.66171,1561077
4661,gavrilfb,8,0.00051,338164,21.66222,1561077
4662,gbastkowski,8,0.00051,338172,21.66274,1561077
4663,gdubicki,8,0.00051,338180,21.66325,1561077
4664,georambo,8,0.00051,338188,21.66376,1561077
4665,georgwolf,8,0.00051,338196,21.66427,1561077
4666,gerardborst,8,0.00051,338204,21.66479,1561077
4667,gerardsegarra,8,0.00051,338212,21.66530,1561077
4668,ggarcia24,8,0.00051,338220,21.66581,1561077
4669,ghenkes,8,0.00051,338228,21.66632,1561077
4670,gilesagnel,8,0.00051,338236,21.66684,1561077
4671,gilmoregrills,8,0.00051,338244,21.66735,1561077
4672,gmc-devel,8,0.00051,338252,21.66786,1561077
4673,GolanTrevize10,8,0.00051,338260,21.66837,1561077
4674,goodspark,8,0.00051,338268,21.66889,1561077
4675,greenorchid,8,0.00051,338276,21.66940,1561077
4676,greg-witczak,8,0.00051,338284,21.66991,1561077
4677,grzegorzgrzegorz,8,0.00051,338292,21.67042,1561077
4678,gsmlg,8,0.00051,338300,21.67094,1561077
4679,gt-dbechtold,8,0.00051,338308,21.67145,1561077
4680,gtheraud,8,0.00051,338316,21.67196,1561077
4681,gudeyang1,8,0.00051,338324,21.67247,1561077
4682,guhaneswaran,8,0.00051,338332,21.67299,1561077
4683,GuyCarmy,8,0.00051,338340,21.67350,1561077
4684,haliphax,8,0.00051,338348,21.67401,1561077
4685,HarishAtGitHub,8,0.00051,338356,21.67452,1561077
4686,harpreetsingh,8,0.00051,338364,21.67504,1561077
4687,has-varsani,8,0.00051,338372,21.67555,1561077
4688,herozabbix,8,0.00051,338380,21.67606,1561077
4689,hesamqpme,8,0.00051,338388,21.67657,1561077
4690,hfufu,8,0.00051,338396,21.67709,1561077
4691,hgautam,8,0.00051,338404,21.67760,1561077
4692,hgsgtk,8,0.00051,338412,21.67811,1561077
4693,hillbun,8,0.00051,338420,21.67862,1561077
4694,HolyxReid,8,0.00051,338428,21.67914,1561077
4695,holzfelix,8,0.00051,338436,21.67965,1561077
4696,HoveringHalibut,8,0.00051,338444,21.68016,1561077
4697,hubermi,8,0.00051,338452,21.68067,1561077
4698,hurzelchen,8,0.00051,338460,21.68119,1561077
4699,huynxtb,8,0.00051,338468,21.68170,1561077
4700,hypePG,8,0.00051,338476,21.68221,1561077
4701,iamonkara,8,0.00051,338484,21.68272,1561077
4702,ianferguson,8,0.00051,338492,21.68324,1561077
4703,ichi0915,8,0.00051,338500,21.68375,1561077
4704,Ilhicas,8,0.00051,338508,21.68426,1561077
4705,IlyaAvdeev,8,0.00051,338516,21.68477,1561077
4706,infestonn,8,0.00051,338524,21.68529,1561077
4707,InGramViking,8,0.00051,338532,21.68580,1561077
4708,inmchfw,8,0.00051,338540,21.68631,1561077
4709,isac-pan,8,0.00051,338548,21.68682,1561077
4710,isfong,8,0.00051,338556,21.68734,1561077
4711,isuftin,8,0.00051,338564,21.68785,1561077
4712,itaych,8,0.00051,338572,21.68836,1561077
4713,itsecureadmin,8,0.00051,338580,21.68887,1561077
4714,itsjohno,8,0.00051,338588,21.68938,1561077
4715,ivan-pinatti,8,0.00051,338596,21.68990,1561077
4716,j3parker,8,0.00051,338604,21.69041,1561077
4717,jachiev8a,8,0.00051,338612,21.69092,1561077
4718,jackwhelpton,8,0.00051,338620,21.69143,1561077
4719,jakubczaplicki,8,0.00051,338628,21.69195,1561077
4720,jamesallsup,8,0.00051,338636,21.69246,1561077
4721,jameschao,8,0.00051,338644,21.69297,1561077
4722,jandroav,8,0.00051,338652,21.69348,1561077
4723,Japh,8,0.00051,338660,21.69400,1561077
4724,jayfo,8,0.00051,338668,21.69451,1561077
4725,jcestibariz,8,0.00051,338676,21.69502,1561077
4726,jekh,8,0.00051,338684,21.69553,1561077
4727,jfperusse-bhvr,8,0.00051,338692,21.69605,1561077
4728,jheyduk,8,0.00051,338700,21.69656,1561077
4729,jiakuanghe,8,0.00051,338708,21.69707,1561077
4730,jiang-wei,8,0.00051,338716,21.69758,1561077
4731,JimmyJamCABD,8,0.00051,338724,21.69810,1561077
4732,jinwookh,8,0.00051,338732,21.69861,1561077
4733,jlehtnie,8,0.00051,338740,21.69912,1561077
4734,jlentink,8,0.00051,338748,21.69963,1561077
4735,jmcduffie,8,0.00051,338756,21.70015,1561077
4736,joaonatividade-vakt,8,0.00051,338764,21.70066,1561077
4737,joaosilva15,8,0.00051,338772,21.70117,1561077
4738,joelacrisp,8,0.00051,338780,21.70168,1561077
4739,johnscancella,8,0.00051,338788,21.70220,1561077
4740,jonahgraham,8,0.00051,338796,21.70271,1561077
4741,Jones2026,8,0.00051,338804,21.70322,1561077
4742,jonfreedman,8,0.00051,338812,21.70373,1561077
4743,jorkzijlstra,8,0.00051,338820,21.70425,1561077
4744,joyarzun,8,0.00051,338828,21.70476,1561077
4745,jroose,8,0.00051,338836,21.70527,1561077
4746,jsa34,8,0.00051,338844,21.70578,1561077
4747,jthDEV,8,0.00051,338852,21.70630,1561077
4748,juanmacoo,8,0.00051,338860,21.70681,1561077
4749,juggernaut,8,0.00051,338868,21.70732,1561077
4750,juhakuu,8,0.00051,338876,21.70783,1561077
4751,juherr,8,0.00051,338884,21.70835,1561077
4752,jvies,8,0.00051,338892,21.70886,1561077
4753,jwitrick,8,0.00051,338900,21.70937,1561077
4754,kamcknig,8,0.00051,338908,21.70988,1561077
4755,kaosf,8,0.00051,338916,21.71040,1561077
4756,Kara3,8,0.00051,338924,21.71091,1561077
4757,Katsu1991,8,0.00051,338932,21.71142,1561077
4758,kbrowder,8,0.00051,338940,21.71193,1561077
4759,keijohyttinen,8,0.00051,338948,21.71245,1561077
4760,kerby82,8,0.00051,338956,21.71296,1561077
4761,kevcodez,8,0.00051,338964,21.71347,1561077
4762,kevindelord,8,0.00051,338972,21.71398,1561077
4763,kevinsuperped,8,0.00051,338980,21.71450,1561077
4764,kheremos,8,0.00051,338988,21.71501,1561077
4765,Kindrat,8,0.00051,338996,21.71552,1561077
4766,kitingChris,8,0.00051,339004,21.71603,1561077
4767,kizdebski,8,0.00051,339012,21.71655,1561077
4768,kjonick1,8,0.00051,339020,21.71706,1561077
4769,klin111,8,0.00051,339028,21.71757,1561077
4770,Kosterio,8,0.00051,339036,21.71808,1561077
4771,koushikraghu,8,0.00051,339044,21.71860,1561077
4772,kozell,8,0.00051,339052,21.71911,1561077
4773,krslynx,8,0.00051,339060,21.71962,1561077
4774,kugelr,8,0.00051,339068,21.72013,1561077
4775,KyleBarton,8,0.00051,339076,21.72065,1561077
4776,Lakhankumawat,8,0.00051,339084,21.72116,1561077
4777,LakshanSS,8,0.00051,339092,21.72167,1561077
4778,lalmeras,8,0.00051,339100,21.72218,1561077
4779,LauJorge,8,0.00051,339108,21.72270,1561077
4780,laurentverbruggen,8,0.00051,339116,21.72321,1561077
4781,leMaik,8,0.00051,339124,21.72372,1561077
4782,lexotero,8,0.00051,339132,21.72423,1561077
4783,lezdep,8,0.00051,339140,21.72475,1561077
4784,liejuntao001,8,0.00051,339148,21.72526,1561077
4785,linefeedse,8,0.00051,339156,21.72577,1561077
4786,lionelraeymaekers,8,0.00051,339164,21.72628,1561077
4787,lionelve,8,0.00051,339172,21.72680,1561077
4788,lpancescu,8,0.00051,339180,21.72731,1561077
4789,lper1582,8,0.00051,339188,21.72782,1561077
4790,lporter-marvell,8,0.00051,339196,21.72833,1561077
4791,lqy1992,8,0.00051,339204,21.72884,1561077
4792,lrozenblyum,8,0.00051,339212,21.72936,1561077
4793,luis-silva,8,0.00051,339220,21.72987,1561077
4794,lukaszlenart,8,0.00051,339228,21.73038,1561077
4795,lukeknep,8,0.00051,339236,21.73089,1561077
4796,lyndseyBeil,8,0.00051,339244,21.73141,1561077
4797,lystor,8,0.00051,339252,21.73192,1561077
4798,ma77h1a5,8,0.00051,339260,21.73243,1561077
4799,mabrowning,8,0.00051,339268,21.73294,1561077
4800,mahesh228,8,0.00051,339276,21.73346,1561077
4801,maiakhoa,8,0.00051,339284,21.73397,1561077
4802,marcosmko,8,0.00051,339292,21.73448,1561077
4803,Markus-ipse,8,0.00051,339300,21.73499,1561077
4804,mar-rih,8,0.00051,339308,21.73551,1561077
4805,martenson,8,0.00051,339316,21.73602,1561077
4806,Marthijs-Berfelo,8,0.00051,339324,21.73653,1561077
4807,mastercard-rob,8,0.00051,339332,21.73704,1561077
4808,maxnitze,8,0.00051,339340,21.73756,1561077
4809,MayaPetter,8,0.00051,339348,21.73807,1561077
4810,MayukhSobo,8,0.00051,339356,21.73858,1561077
4811,mbektchiev,8,0.00051,339364,21.73909,1561077
4812,mdeitrick,8,0.00051,339372,21.73961,1561077
4813,mehtadev17,8,0.00051,339380,21.74012,1561077
4814,melissafritcher,8,0.00051,339388,21.74063,1561077
4815,memotype,8,0.00051,339396,21.74114,1561077
4816,mestredelpino,8,0.00051,339404,21.74166,1561077
4817,mhayen,8,0.00051,339412,21.74217,1561077
4818,mh-psaad,8,0.00051,339420,21.74268,1561077
4819,michaelsatish,8,0.00051,339428,21.74319,1561077
4820,michalip,8,0.00051,339436,21.74371,1561077
4821,michibat01,8,0.00051,339444,21.74422,1561077
4822,michmerr,8,0.00051,339452,21.74473,1561077
4823,mickengland,8,0.00051,339460,21.74524,1561077
4824,Mikedu1988,8,0.00051,339468,21.74576,1561077
4825,mike-pt,8,0.00051,339476,21.74627,1561077
4826,miketruty,8,0.00051,339484,21.74678,1561077
4827,milani,8,0.00051,339492,21.74729,1561077
4828,mitchelkoster,8,0.00051,339500,21.74781,1561077
4829,mizzy,8,0.00051,339508,21.74832,1561077
4830,mjstrasser,8,0.00051,339516,21.74883,1561077
4831,ml019,8,0.00051,339524,21.74934,1561077
4832,MohanRajRavi,8,0.00051,339532,21.74986,1561077
4833,morfien101,8,0.00051,339540,21.75037,1561077
4834,mpare,8,0.00051,339548,21.75088,1561077
4835,mrkolb,8,0.00051,339556,21.75139,1561077
4836,mrmarcsmith,8,0.00051,339564,21.75191,1561077
4837,mroderus,8,0.00051,339572,21.75242,1561077
4838,mrtylerzhou,8,0.00051,339580,21.75293,1561077
4839,msallin,8,0.00051,339588,21.75344,1561077
4840,mshwery,8,0.00051,339596,21.75396,1561077
4841,muirp-owner,8,0.00051,339604,21.75447,1561077
4842,NBE-SG,8,0.00051,339612,21.75498,1561077
4843,nearlyfreeapps,8,0.00051,339620,21.75549,1561077
4844,nervo,8,0.00051,339628,21.75601,1561077
4845,nick-george,8,0.00051,339636,21.75652,1561077
4846,NickitaX,8,0.00051,339644,21.75703,1561077
4847,nicobo,8,0.00051,339652,21.75754,1561077
4848,Nikamura,8,0.00051,339660,21.75806,1561077
4849,nikita-tkachenko-datadog,8,0.00051,339668,21.75857,1561077
4850,nitinjirawal,8,0.00051,339676,21.75908,1561077
4851,nitinsurana,8,0.00051,339684,21.75959,1561077
4852,noggin143,8,0.00051,339692,21.76011,1561077
4853,noneorone,8,0.00051,339700,21.76062,1561077
4854,norricorp,8,0.00051,339708,21.76113,1561077
4855,no-stupid-questions,8,0.00051,339716,21.76164,1561077
4856,notAJavaProgrammer,8,0.00051,339724,21.76216,1561077
4857,nthh,8,0.00051,339732,21.76267,1561077
4858,nukepuppy,8,0.00051,339740,21.76318,1561077
4859,nuupur9,8,0.00051,339748,21.76369,1561077
4860,nwillems,8,0.00051,339756,21.76421,1561077
4861,odorovic,8,0.00051,339764,21.76472,1561077
4862,Odusanya18,8,0.00051,339772,21.76523,1561077
4863,ofeige,8,0.00051,339780,21.76574,1561077
4864,ofosos,8,0.00051,339788,21.76625,1561077
4865,okyryl,8,0.00051,339796,21.76677,1561077
4866,olektretiak,8,0.00051,339804,21.76728,1561077
4867,ometa,8,0.00051,339812,21.76779,1561077
4868,openstack-test,8,0.00051,339820,21.76830,1561077
4869,ORESoftware,8,0.00051,339828,21.76882,1561077
4870,Osmyslitelny,8,0.00051,339836,21.76933,1561077
4871,p0deje,8,0.00051,339844,21.76984,1561077
4872,pallocchi,8,0.00051,339852,21.77035,1561077
4873,pankaj2934,8,0.00051,339860,21.77087,1561077
4874,patrickc91,8,0.00051,339868,21.77138,1561077
4875,paulsavoie,8,0.00051,339876,21.77189,1561077
4876,pavog,8,0.00051,339884,21.77240,1561077
4877,pcardos,8,0.00051,339892,21.77292,1561077
4878,pcornelissen,8,0.00051,339900,21.77343,1561077
4879,peppeweb,8,0.00051,339908,21.77394,1561077
4880,PeppyHare,8,0.00051,339916,21.77445,1561077
4881,Perry3D,8,0.00051,339924,21.77497,1561077
4882,pgmann,8,0.00051,339932,21.77548,1561077
4883,phanikumar1210,8,0.00051,339940,21.77599,1561077
4884,philchristensen,8,0.00051,339948,21.77650,1561077
4885,Philipp1909,8,0.00051,339956,21.77702,1561077
4886,philmcardle,8,0.00051,339964,21.77753,1561077
4887,PhotoTeeborChoka,8,0.00051,339972,21.77804,1561077
4888,pmithrandir,8,0.00051,339980,21.77855,1561077
4889,prabinb,8,0.00051,339988,21.77907,1561077
4890,pradeepnnv,8,0.00051,339996,21.77958,1561077
4891,prashantdj1,8,0.00051,340004,21.78009,1561077
4892,premaram,8,0.00051,340012,21.78060,1561077
4893,prenx4x,8,0.00051,340020,21.78112,1561077
4894,Prifiz,8,0.00051,340028,21.78163,1561077
4895,priteshmehta,8,0.00051,340036,21.78214,1561077
4896,prolificcoder,8,0.00051,340044,21.78265,1561077
4897,PsychoSid,8,0.00051,340052,21.78317,1561077
4898,psychosis448,8,0.00051,340060,21.78368,1561077
4899,pzoleex,8,0.00051,340068,21.78419,1561077
4900,quanzt,8,0.00051,340076,21.78470,1561077
4901,Quijibow,8,0.00051,340084,21.78522,1561077
4902,radhika1601,8,0.00051,340092,21.78573,1561077
4903,rafaelfbs,8,0.00051,340100,21.78624,1561077
4904,rawler,8,0.00051,340108,21.78675,1561077
4905,rcruzper,8,0.00051,340116,21.78727,1561077
4906,rebnridgway,8,0.00051,340124,21.78778,1561077
4907,regardfs,8,0.00051,340132,21.78829,1561077
4908,remusgolgot,8,0.00051,340140,21.78880,1561077
4909,renea,8,0.00051,340148,21.78932,1561077
4910,Reuuke,8,0.00051,340156,21.78983,1561077
4911,reysravanga,8,0.00051,340164,21.79034,1561077
4912,rgeraldporter,8,0.00051,340172,21.79085,1561077
4913,rgoomar,8,0.00051,340180,21.79137,1561077
4914,rimuln,8,0.00051,340188,21.79188,1561077
4915,rkolless,8,0.00051,340196,21.79239,1561077
4916,robinpuri,8,0.00051,340204,21.79290,1561077
4917,RochaStratovan,8,0.00051,340212,21.79342,1561077
4918,roel0,8,0.00051,340220,21.79393,1561077
4919,roie9876,8,0.00051,340228,21.79444,1561077
4920,rosepan,8,0.00051,340236,21.79495,1561077
4921,roundtrip-rslobojan,8,0.00051,340244,21.79547,1561077
4922,RyanGannon,8,0.00051,340252,21.79598,1561077
4923,ryantrevisol,8,0.00051,340260,21.79649,1561077
4924,ryanwholey,8,0.00051,340268,21.79700,1561077
4925,ryanwren,8,0.00051,340276,21.79752,1561077
4926,S3-D1,8,0.00051,340284,21.79803,1561077
4927,saad352,8,0.00051,340292,21.79854,1561077
4928,sagarj1,8,0.00051,340300,21.79905,1561077
4929,sam-caldwell,8,0.00051,340308,21.79957,1561077
4930,sanjaymp18,8,0.00051,340316,21.80008,1561077
4931,sanjeevpandey19,8,0.00051,340324,21.80059,1561077
4932,sanyarnd,8,0.00051,340332,21.80110,1561077
4933,sata,8,0.00051,340340,21.80162,1561077
4934,sauravdevops,8,0.00051,340348,21.80213,1561077
4935,sbobin,8,0.00051,340356,21.80264,1561077
4936,schefs,8,0.00051,340364,21.80315,1561077
4937,schneidexe,8,0.00051,340372,21.80367,1561077
4938,scribblingfox,8,0.00051,340380,21.80418,1561077
4939,sdmoralesma,8,0.00051,340388,21.80469,1561077
4940,SebastianSolidwork,8,0.00051,340396,21.80520,1561077
4941,sebracs,8,0.00051,340404,21.80571,1561077
4942,secade,8,0.00051,340412,21.80623,1561077
4943,sedstef,8,0.00051,340420,21.80674,1561077
4944,sergiogiuffrida,8,0.00051,340428,21.80725,1561077
4945,serpa-dystematic,8,0.00051,340436,21.80776,1561077
4946,shashankrnr32,8,0.00051,340444,21.80828,1561077
4947,shbhardwaj,8,0.00051,340452,21.80879,1561077
4948,shl3vi,8,0.00051,340460,21.80930,1561077
4949,Shyri,8,0.00051,340468,21.80981,1561077
4950,sirius94,8,0.00051,340476,21.81033,1561077
4951,sivapalan,8,0.00051,340484,21.81084,1561077
4952,sjcollin,8,0.00051,340492,21.81135,1561077
4953,slgriff,8,0.00051,340500,21.81186,1561077
4954,smutel,8,0.00051,340508,21.81238,1561077
4955,snadorp,8,0.00051,340516,21.81289,1561077
4956,SoftwareApe,8,0.00051,340524,21.81340,1561077
4957,solocommand,8,0.00051,340532,21.81391,1561077
4958,sonyali03,8,0.00051,340540,21.81443,1561077
4959,spuranam,8,0.00051,340548,21.81494,1561077
4960,squidgegmc,8,0.00051,340556,21.81545,1561077
4961,srotak5,8,0.00051,340564,21.81596,1561077
4962,srwalter,8,0.00051,340572,21.81648,1561077
4963,stefanjauker,8,0.00051,340580,21.81699,1561077
4964,stephank,8,0.00051,340588,21.81750,1561077
4965,stephenkerrmurphy,8,0.00051,340596,21.81801,1561077
4966,stigsb,8,0.00051,340604,21.81853,1561077
4967,suleymanbarman,8,0.00051,340612,21.81904,1561077
4968,svogt,8,0.00051,340620,21.81955,1561077
4969,swegner,8,0.00051,340628,21.82006,1561077
4970,systemsincode,8,0.00051,340636,21.82058,1561077
4971,szaher,8,0.00051,340644,21.82109,1561077
4972,szymex,8,0.00051,340652,21.82160,1561077
4973,tarzanek,8,0.00051,340660,21.82211,1561077
4974,tcrozier,8,0.00051,340668,21.82263,1561077
4975,terk28041,8,0.00051,340676,21.82314,1561077
4976,thekalpesh7,8,0.00051,340684,21.82365,1561077
4977,themysteq,8,0.00051,340692,21.82416,1561077
4978,ThePrankMonkey,8,0.00051,340700,21.82468,1561077
4979,theshadow27,8,0.00051,340708,21.82519,1561077
4980,theyough,8,0.00051,340716,21.82570,1561077
4981,thezim,8,0.00051,340724,21.82621,1561077
4982,Thomasbehan,8,0.00051,340732,21.82673,1561077
4983,thomascube,8,0.00051,340740,21.82724,1561077
4984,thornpar,8,0.00051,340748,21.82775,1561077
4985,thorntonrose,8,0.00051,340756,21.82826,1561077
4986,thrix,8,0.00051,340764,21.82878,1561077
4987,timflannagan,8,0.00051,340772,21.82929,1561077
4988,timotei,8,0.00051,340780,21.82980,1561077
4989,tinue,8,0.00051,340788,21.83031,1561077
4990,tiobe,8,0.00051,340796,21.83083,1561077
4991,toejough,8,0.00051,340804,21.83134,1561077
4992,tomaszwojciechowski,8,0.00051,340812,21.83185,1561077
4993,tommy04062019,8,0.00051,340820,21.83236,1561077
4994,tonygilkerson,8,0.00051,340828,21.83288,1561077
4995,tonyhsuclrous,8,0.00051,340836,21.83339,1561077
4996,tpieczkowskiParasoft,8,0.00051,340844,21.83390,1561077
4997,trieszklr,8,0.00051,340852,21.83441,1561077
4998,Trivikramreddy,8,0.00051,340860,21.83493,1561077
4999,tstibbs,8,0.00051,340868,21.83544,1561077
5000,tychota,8,0.00051,340876,21.83595,1561077
5001,TYsewyn,8,0.00051,340884,21.83646,1561077
5002,udbscience,8,0.00051,340892,21.83698,1561077
5003,ukyzr,8,0.00051,340900,21.83749,1561077
5004,UltimateGeek,8,0.00051,340908,21.83800,1561077
5005,undetiramesh,8,0.00051,340916,21.83851,1561077
5006,unilama,8,0.00051,340924,21.83903,1561077
5007,velagamrakesh,8,0.00051,340932,21.83954,1561077
5008,velivalab,8,0.00051,340940,21.84005,1561077
5009,venosov,8,0.00051,340948,21.84056,1561077
5010,viktorg2,8,0.00051,340956,21.84108,1561077
5011,Vince-Cercury,8,0.00051,340964,21.84159,1561077
5012,VinceMD,8,0.00051,340972,21.84210,1561077
5013,vishalsparmar,8,0.00051,340980,21.84261,1561077
5014,vit1251,8,0.00051,340988,21.84312,1561077
5015,vosscodes,8,0.00051,340996,21.84364,1561077
5016,vrymbu,8,0.00051,341004,21.84415,1561077
5017,WaffleStudios,8,0.00051,341012,21.84466,1561077
5018,watsonlu,8,0.00051,341020,21.84517,1561077
5019,waynr,8,0.00051,341028,21.84569,1561077
5020,webczat,8,0.00051,341036,21.84620,1561077
5021,weiZhenkun,8,0.00051,341044,21.84671,1561077
5022,wejrox,8,0.00051,341052,21.84722,1561077
5023,wesbland,8,0.00051,341060,21.84774,1561077
5024,whayne1103,8,0.00051,341068,21.84825,1561077
5025,whereIsMyDipp,8,0.00051,341076,21.84876,1561077
5026,willis7,8,0.00051,341084,21.84927,1561077
5027,WillSkates,8,0.00051,341092,21.84979,1561077
5028,wofish2,8,0.00051,341100,21.85030,1561077
5029,wololock,8,0.00051,341108,21.85081,1561077
5030,wosiu,8,0.00051,341116,21.85132,1561077
5031,ww-daniel-mora,8,0.00051,341124,21.85184,1561077
5032,xeonselina,8,0.00051,341132,21.85235,1561077
5033,xiangxingyong,8,0.00051,341140,21.85286,1561077
5034,xieweizhi-qmxx,8,0.00051,341148,21.85337,1561077
5035,xuejiangtao,8,0.00051,341156,21.85389,1561077
5036,XWTiger,8,0.00051,341164,21.85440,1561077
5037,yasassri,8,0.00051,341172,21.85491,1561077
5038,yasokada-lc,8,0.00051,341180,21.85542,1561077
5039,yehecarry,8,0.00051,341188,21.85594,1561077
5040,YeLincoln,8,0.00051,341196,21.85645,1561077
5041,yhil,8,0.00051,341204,21.85696,1561077
5042,Ykus,8,0.00051,341212,21.85747,1561077
5043,yotamshapira,8,0.00051,341220,21.85799,1561077
5044,yueyehm,8,0.00051,341228,21.85850,1561077
5045,yungez,8,0.00051,341236,21.85901,1561077
5046,yurigo79,8,0.00051,341244,21.85952,1561077
5047,yyolk,8,0.00051,341252,21.86004,1561077
5048,zafarella,8,0.00051,341260,21.86055,1561077
5049,zelonght,8,0.00051,341268,21.86106,1561077
5050,ZillaG,8,0.00051,341276,21.86157,1561077
5051,zxq1002,8,0.00051,341284,21.86209,1561077
5052,478859-anurag,7,0.00045,341291,21.86253,1561077
5053,Aaquiff,7,0.00045,341298,21.86298,1561077
5054,aaranmcguire,7,0.00045,341305,21.86343,1561077
5055,abhijeet-ankush,7,0.00045,341312,21.86388,1561077
5056,abuunice,7,0.00045,341319,21.86433,1561077
5057,AckermannC,7,0.00045,341326,21.86478,1561077
5058,acornett21,7,0.00045,341333,21.86523,1561077
5059,adamdavis40208,7,0.00045,341340,21.86567,1561077
5060,addihorn,7,0.00045,341347,21.86612,1561077
5061,adibendahan,7,0.00045,341354,21.86657,1561077
5062,aditaa,7,0.00045,341361,21.86702,1561077
5063,adnancerner,7,0.00045,341368,21.86747,1561077
5064,adrian-gierakowski,7,0.00045,341375,21.86792,1561077
5065,adux6991,7,0.00045,341382,21.86836,1561077
5066,advorsky73,7,0.00045,341389,21.86881,1561077
5067,afeblot,7,0.00045,341396,21.86926,1561077
5068,ahammond,7,0.00045,341403,21.86971,1561077
5069,ahatala,7,0.00045,341410,21.87016,1561077
5070,aj326,7,0.00045,341417,21.87061,1561077
5071,Akin2Silver,7,0.00045,341424,21.87105,1561077
5072,akmalhazim,7,0.00045,341431,21.87150,1561077
5073,aksenov007,7,0.00045,341438,21.87195,1561077
5074,aku163,7,0.00045,341445,21.87240,1561077
5075,alexandruivan,7,0.00045,341452,21.87285,1561077
5076,alex-dr,7,0.00045,341459,21.87330,1561077
5077,alexelent,7,0.00045,341466,21.87374,1561077
5078,alexgandy,7,0.00045,341473,21.87419,1561077
5079,alexgbernier,7,0.00045,341480,21.87464,1561077
5080,alexharv074,7,0.00045,341487,21.87509,1561077
5081,AlexReiff,7,0.00045,341494,21.87554,1561077
5082,algorys,7,0.00045,341501,21.87599,1561077
5083,Allancgx,7,0.00045,341508,21.87644,1561077
5084,allout58,7,0.00045,341515,21.87688,1561077
5085,alyssahardy,7,0.00045,341522,21.87733,1561077
5086,amai2012,7,0.00045,341529,21.87778,1561077
5087,amalaguti,7,0.00045,341536,21.87823,1561077
5088,Aman-Osman-Bose,7,0.00045,341543,21.87868,1561077
5089,amcginn,7,0.00045,341550,21.87913,1561077
5090,amendlik,7,0.00045,341557,21.87957,1561077
5091,amit-k-yadav,7,0.00045,341564,21.88002,1561077
5092,AMKiranKumar,7,0.00045,341571,21.88047,1561077
5093,amlozano,7,0.00045,341578,21.88092,1561077
5094,ammanders,7,0.00045,341585,21.88137,1561077
5095,anatoly-spb,7,0.00045,341592,21.88182,1561077
5096,anbrsap,7,0.00045,341599,21.88226,1561077
5097,anderspikas,7,0.00045,341606,21.88271,1561077
5098,andrew-ferguson-hs,7,0.00045,341613,21.88316,1561077
5099,Andy1221,7,0.00045,341620,21.88361,1561077
5100,aniketksh,7,0.00045,341627,21.88406,1561077
5101,AnilKumarVasireddy,7,0.00045,341634,21.88451,1561077
5102,anitabee,7,0.00045,341641,21.88496,1561077
5103,anlutro,7,0.00045,341648,21.88540,1561077
5104,anoymouserver,7,0.00045,341655,21.88585,1561077
5105,Anuj-Kumar-AJ,7,0.00045,341662,21.88630,1561077
5106,argorain,7,0.00045,341669,21.88675,1561077
5107,ariaviran,7,0.00045,341676,21.88720,1561077
5108,arkadiusz-konopka-collibra,7,0.00045,341683,21.88765,1561077
5109,ArnoACS,7,0.00045,341690,21.88809,1561077
5110,artem-kirillov,7,0.00045,341697,21.88854,1561077
5111,ArturFortunato,7,0.00045,341704,21.88899,1561077
5112,aruncdp,7,0.00045,341711,21.88944,1561077
5113,Asher256,7,0.00045,341718,21.88989,1561077
5114,ashwini-xecurify,7,0.00045,341725,21.89034,1561077
5115,aswild,7,0.00045,341732,21.89078,1561077
5116,atrillanes1972,7,0.00045,341739,21.89123,1561077
5117,Austinh100,7,0.00045,341746,21.89168,1561077
5118,avenda,7,0.00045,341753,21.89213,1561077
5119,avihaycloudinary,7,0.00045,341760,21.89258,1561077
5120,aviv-ebates,7,0.00045,341767,21.89303,1561077
5121,axilleas,7,0.00045,341774,21.89347,1561077
5122,a-y-khan,7,0.00045,341781,21.89392,1561077
5123,Azarko,7,0.00045,341788,21.89437,1561077
5124,bacher09,7,0.00045,341795,21.89482,1561077
5125,bagage,7,0.00045,341802,21.89527,1561077
5126,balleman,7,0.00045,341809,21.89572,1561077
5127,bamachrn,7,0.00045,341816,21.89617,1561077
5128,bambriy,7,0.00045,341823,21.89661,1561077
5129,barclay-reg,7,0.00045,341830,21.89706,1561077
5130,bbaetz,7,0.00045,341837,21.89751,1561077
5131,beazlr02,7,0.00045,341844,21.89796,1561077
5132,benDeMtp,7,0.00045,341851,21.89841,1561077
5133,BenjaminBarnel,7,0.00045,341858,21.89886,1561077
5134,bfh-reseiwe,7,0.00045,341865,21.89930,1561077
5135,BillHoo,7,0.00045,341872,21.89975,1561077
5136,bjoernHeneka,7,0.00045,341879,21.90020,1561077
5137,bkarakashev,7,0.00045,341886,21.90065,1561077
5138,Blackbaud-MikeLueders,7,0.00045,341893,21.90110,1561077
5139,blackpc,7,0.00045,341900,21.90155,1561077
5140,bplunkert,7,0.00045,341907,21.90199,1561077
5141,bradleywangia,7,0.00045,341914,21.90244,1561077
5142,brhota30,7,0.00045,341921,21.90289,1561077
5143,briahi,7,0.00045,341928,21.90334,1561077
5144,brijnandan,7,0.00045,341935,21.90379,1561077
5145,bronogard,7,0.00045,341942,21.90424,1561077
5146,brumhardS,7,0.00045,341949,21.90469,1561077
5147,bsloan-icl,7,0.00045,341956,21.90513,1561077
5148,btoconnor,7,0.00045,341963,21.90558,1561077
5149,c4m4,7,0.00045,341970,21.90603,1561077
5150,calebdelnay,7,0.00045,341977,21.90648,1561077
5151,calvinmorrow,7,0.00045,341984,21.90693,1561077
5152,CameronHudson8,7,0.00045,341991,21.90738,1561077
5153,carstenmuellerlemberg,7,0.00045,341998,21.90782,1561077
5154,ccureau,7,0.00045,342005,21.90827,1561077
5155,cdosborn,7,0.00045,342012,21.90872,1561077
5156,cgnuechtel,7,0.00045,342019,21.90917,1561077
5157,chabeezy,7,0.00045,342026,21.90962,1561077
5158,Chickoree,7,0.00045,342033,21.91007,1561077
5159,chikathreesix,7,0.00045,342040,21.91051,1561077
5160,chornlgscout,7,0.00045,342047,21.91096,1561077
5161,chuckwilbur,7,0.00045,342054,21.91141,1561077
5162,chwehrli,7,0.00045,342061,21.91186,1561077
5163,cinlloc,7,0.00045,342068,21.91231,1561077
5164,citizenkahn,7,0.00045,342075,21.91276,1561077
5165,clayvan,7,0.00045,342082,21.91320,1561077
5166,cliles,7,0.00045,342089,21.91365,1561077
5167,cmays20,7,0.00045,342096,21.91410,1561077
5168,codeasashu,7,0.00045,342103,21.91455,1561077
5169,coderadi,7,0.00045,342110,21.91500,1561077
5170,coinsummer,7,0.00045,342117,21.91545,1561077
5171,collabnix,7,0.00045,342124,21.91590,1561077
5172,connal-m,7,0.00045,342131,21.91634,1561077
5173,costincaraivan,7,0.00045,342138,21.91679,1561077
5174,cppforlife,7,0.00045,342145,21.91724,1561077
5175,crd477,7,0.00045,342152,21.91769,1561077
5176,CRuppert,7,0.00045,342159,21.91814,1561077
5177,crwdsmullz,7,0.00045,342166,21.91859,1561077
5178,CrystallDEV,7,0.00045,342173,21.91903,1561077
5179,cshupp1,7,0.00045,342180,21.91948,1561077
5180,CSLTech,7,0.00045,342187,21.91993,1561077
5181,CSTDev,7,0.00045,342194,21.92038,1561077
5182,cubicwork,7,0.00045,342201,21.92083,1561077
5183,cupsadarius,7,0.00045,342208,21.92128,1561077
5184,cycwll,7,0.00045,342215,21.92172,1561077
5185,CyrusKOCI,7,0.00045,342222,21.92217,1561077
5186,d3y,7,0.00045,342229,21.92262,1561077
5187,daften,7,0.00045,342236,21.92307,1561077
5188,daldinger,7,0.00045,342243,21.92352,1561077
5189,DamonStamper,7,0.00045,342250,21.92397,1561077
5190,dandare100,7,0.00045,342257,21.92442,1561077
5191,danieled-it,7,0.00045,342264,21.92486,1561077
5192,dantran,7,0.00045,342271,21.92531,1561077
5193,dasxx17,7,0.00045,342278,21.92576,1561077
5194,dawon,7,0.00045,342285,21.92621,1561077
5195,dbason,7,0.00045,342292,21.92666,1561077
5196,dbelyaev,7,0.00045,342299,21.92711,1561077
5197,dc1415daw2,7,0.00045,342306,21.92755,1561077
5198,dcheese,7,0.00045,342313,21.92800,1561077
5199,dchw,7,0.00045,342320,21.92845,1561077
5200,ddup2,7,0.00045,342327,21.92890,1561077
5201,deebloo,7,0.00045,342334,21.92935,1561077
5202,DeekshithSN,7,0.00045,342341,21.92980,1561077
5203,deeky666,7,0.00045,342348,21.93024,1561077
5204,deepakdubey2624,7,0.00045,342355,21.93069,1561077
5205,demoontz,7,0.00045,342362,21.93114,1561077
5206,derhecht,7,0.00045,342369,21.93159,1561077
5207,DerKnerd,7,0.00045,342376,21.93204,1561077
5208,devopsdynamo,7,0.00045,342383,21.93249,1561077
5209,dharmsheta,7,0.00045,342390,21.93293,1561077
5210,dhinojosa,7,0.00045,342397,21.93338,1561077
5211,dhruv3,7,0.00045,342404,21.93383,1561077
5212,digimonster,7,0.00045,342411,21.93428,1561077
5213,dilgerma,7,0.00045,342418,21.93473,1561077
5214,divramod,7,0.00045,342425,21.93518,1561077
5215,dj80hd,7,0.00045,342432,21.93563,1561077
5216,djanavar,7,0.00045,342439,21.93607,1561077
5217,djdenv,7,0.00045,342446,21.93652,1561077
5218,dkrowl,7,0.00045,342453,21.93697,1561077
5219,dmarjanovic,7,0.00045,342460,21.93742,1561077
5220,DmitryMihailov,7,0.00045,342467,21.93787,1561077
5221,dmkoelle,7,0.00045,342474,21.93832,1561077
5222,dmytrokomisaryk,7,0.00045,342481,21.93876,1561077
5223,dodwyer,7,0.00045,342488,21.93921,1561077
5224,dominguezcelada,7,0.00045,342495,21.93966,1561077
5225,douglasmiller,7,0.00045,342502,21.94011,1561077
5226,dpanyam,7,0.00045,342509,21.94056,1561077
5227,dracorp,7,0.00045,342516,21.94101,1561077
5228,dreniers,7,0.00045,342523,21.94145,1561077
5229,dsonsem2020,7,0.00045,342530,21.94190,1561077
5230,dtitov,7,0.00045,342537,21.94235,1561077
5231,DuckieHo,7,0.00045,342544,21.94280,1561077
5232,dwdyer,7,0.00045,342551,21.94325,1561077
5233,dwightguth,7,0.00045,342558,21.94370,1561077
5234,dzmitrytarasevich,7,0.00045,342565,21.94414,1561077
5235,eanrollings,7,0.00045,342572,21.94459,1561077
5236,ebennett48375,7,0.00045,342579,21.94504,1561077
5237,edenrox,7,0.00045,342586,21.94549,1561077
5238,egorse,7,0.00045,342593,21.94594,1561077
5239,egouraud-claranet,7,0.00045,342600,21.94639,1561077
5240,ekesseler,7,0.00045,342607,21.94684,1561077
5241,electricthunder,7,0.00045,342614,21.94728,1561077
5242,elixirl1l,7,0.00045,342621,21.94773,1561077
5243,els-grazziotinf,7,0.00045,342628,21.94818,1561077
5244,emaks,7,0.00045,342635,21.94863,1561077
5245,epsilo,7,0.00045,342642,21.94908,1561077
5246,erhangullu,7,0.00045,342649,21.94953,1561077
5247,ericgoedtel,7,0.00045,342656,21.94997,1561077
5248,erik-am,7,0.00045,342663,21.95042,1561077
5249,erlchamp,7,0.00045,342670,21.95087,1561077
5250,errnoh,7,0.00045,342677,21.95132,1561077
5251,evertonevaristo,7,0.00045,342684,21.95177,1561077
5252,Ezhvsalate,7,0.00045,342691,21.95222,1561077
5253,faandg,7,0.00045,342698,21.95266,1561077
5254,fabriziocucci,7,0.00045,342705,21.95311,1561077
5255,facetheheat,7,0.00045,342712,21.95356,1561077
5256,Faj5097,7,0.00045,342719,21.95401,1561077
5257,fakoe,7,0.00045,342726,21.95446,1561077
5258,felipe-vvoosh,7,0.00045,342733,21.95491,1561077
5259,FF186,7,0.00045,342740,21.95536,1561077
5260,fipciu1996,7,0.00045,342747,21.95580,1561077
5261,fjgarciao,7,0.00045,342754,21.95625,1561077
5262,fjjdev,7,0.00045,342761,21.95670,1561077
5263,flocard,7,0.00045,342768,21.95715,1561077
5264,fmarot,7,0.00045,342775,21.95760,1561077
5265,foeser,7,0.00045,342782,21.95805,1561077
5266,fontealpina,7,0.00045,342789,21.95849,1561077
5267,frangarcia,7,0.00045,342796,21.95894,1561077
5268,frederiksf,7,0.00045,342803,21.95939,1561077
5269,f-steff,7,0.00045,342810,21.95984,1561077
5270,fvogler,7,0.00045,342817,21.96029,1561077
5271,fydrah,7,0.00045,342824,21.96074,1561077
5272,g000444555,7,0.00045,342831,21.96118,1561077
5273,gaforester,7,0.00045,342838,21.96163,1561077
5274,gattytto,7,0.00045,342845,21.96208,1561077
5275,gavingray,7,0.00045,342852,21.96253,1561077
5276,gcoutant,7,0.00045,342859,21.96298,1561077
5277,geek876,7,0.00045,342866,21.96343,1561077
5278,gehel,7,0.00045,342873,21.96387,1561077
5279,gfleury,7,0.00045,342880,21.96432,1561077
5280,ghfalcon7,7,0.00045,342887,21.96477,1561077
5281,gilShin,7,0.00045,342894,21.96522,1561077
5282,girlrichie,7,0.00045,342901,21.96567,1561077
5283,gitfoobar,7,0.00045,342908,21.96612,1561077
5284,gkuchta,7,0.00045,342915,21.96657,1561077
5285,Glen-Cocoa,7,0.00045,342922,21.96701,1561077
5286,gloeglm,7,0.00045,342929,21.96746,1561077
5287,gluehbirnenkopf,7,0.00045,342936,21.96791,1561077
5288,gonglancy,7,0.00045,342943,21.96836,1561077
5289,goodboy23,7,0.00045,342950,21.96881,1561077
5290,GoWithTheFlo95,7,0.00045,342957,21.96926,1561077
5291,gpouilloux,7,0.00045,342964,21.96970,1561077
5292,grafjo,7,0.00045,342971,21.97015,1561077
5293,grantsunny,7,0.00045,342978,21.97060,1561077
5294,GregoireW,7,0.00045,342985,21.97105,1561077
5295,gregorburger,7,0.00045,342992,21.97150,1561077
5296,GregOriol,7,0.00045,342999,21.97195,1561077
5297,greydet,7,0.00045,343006,21.97239,1561077
5298,GuelorEmanuel,7,0.00045,343013,21.97284,1561077
5299,gurushub,7,0.00045,343020,21.97329,1561077
5300,guruvamsichintala,7,0.00045,343027,21.97374,1561077
5301,gustavoriveray,7,0.00045,343034,21.97419,1561077
5302,gv2011,7,0.00045,343041,21.97464,1561077
5303,gvasko,7,0.00045,343048,21.97509,1561077
5304,gvasquez-waypoint,7,0.00045,343055,21.97553,1561077
5305,habandi,7,0.00045,343062,21.97598,1561077
5306,HackAttack,7,0.00045,343069,21.97643,1561077
5307,hamidos,7,0.00045,343076,21.97688,1561077
5308,hangsu-ma,7,0.00045,343083,21.97733,1561077
5309,haroldo-bonette,7,0.00045,343090,21.97778,1561077
5310,hdoedens,7,0.00045,343097,21.97822,1561077
5311,heathergithub,7,0.00045,343104,21.97867,1561077
5312,hectotruj,7,0.00045,343111,21.97912,1561077
5313,hegdevenky,7,0.00045,343118,21.97957,1561077
5314,henrist,7,0.00045,343125,21.98002,1561077
5315,hervedevos,7,0.00045,343132,21.98047,1561077
5316,hexonxons,7,0.00045,343139,21.98091,1561077
5317,Hillgod,7,0.00045,343146,21.98136,1561077
5318,HMS-LIG,7,0.00045,343153,21.98181,1561077
5319,httpete,7,0.00045,343160,21.98226,1561077
5320,hugocortes,7,0.00045,343167,21.98271,1561077
5321,hunkim,7,0.00045,343174,21.98316,1561077
5322,hursittarcan,7,0.00045,343181,21.98360,1561077
5323,ikus060,7,0.00045,343188,21.98405,1561077
5324,IL-Automation,7,0.00045,343195,21.98450,1561077
5325,ilya2s,7,0.00045,343202,21.98495,1561077
5326,IlyaKiselevKolibri,7,0.00045,343209,21.98540,1561077
5327,iMichka,7,0.00045,343216,21.98585,1561077
5328,inforedaster,7,0.00045,343223,21.98630,1561077
5329,iOtter,7,0.00045,343230,21.98674,1561077
5330,isaacchou,7,0.00045,343237,21.98719,1561077
5331,isanketh,7,0.00045,343244,21.98764,1561077
5332,itanf,7,0.00045,343251,21.98809,1561077
5333,jackbowman,7,0.00045,343258,21.98854,1561077
5334,jackdpeterson,7,0.00045,343265,21.98899,1561077
5335,Jacky2,7,0.00045,343272,21.98943,1561077
5336,Jacob-Steele,7,0.00045,343279,21.98988,1561077
5337,jadestorm,7,0.00045,343286,21.99033,1561077
5338,JAlexoid,7,0.00045,343293,21.99078,1561077
5339,jamesD33064,7,0.00045,343300,21.99123,1561077
5340,jamesnswithers,7,0.00045,343307,21.99168,1561077
5341,janvrany,7,0.00045,343314,21.99212,1561077
5342,jaredrussell,7,0.00045,343321,21.99257,1561077
5343,jasperjonker,7,0.00045,343328,21.99302,1561077
5344,jayv,7,0.00045,343335,21.99347,1561077
5345,jbiel,7,0.00045,343342,21.99392,1561077
5346,jcberthon,7,0.00045,343349,21.99437,1561077
5347,jcmarcfloress,7,0.00045,343356,21.99482,1561077
5348,jefersonchaves,7,0.00045,343363,21.99526,1561077
5349,jeffreymcclain,7,0.00045,343370,21.99571,1561077
5350,jeffweiss,7,0.00045,343377,21.99616,1561077
5351,Jerbell,7,0.00045,343384,21.99661,1561077
5352,jeremy-seiu,7,0.00045,343391,21.99706,1561077
5353,jglazner,7,0.00045,343398,21.99751,1561077
5354,jhanbo,7,0.00045,343405,21.99795,1561077
5355,jhoenzsch,7,0.00045,343412,21.99840,1561077
5356,jiankafei,7,0.00045,343419,21.99885,1561077
5357,jiedongd,7,0.00045,343426,21.99930,1561077
5358,jikamens,7,0.00045,343433,21.99975,1561077
5359,jkakavas,7,0.00045,343440,22.00020,1561077
5360,JKDingwall,7,0.00045,343447,22.00064,1561077
5361,jludvice,7,0.00045,343454,22.00109,1561077
5362,jmdh,7,0.00045,343461,22.00154,1561077
5363,jnewton03,7,0.00045,343468,22.00199,1561077
5364,joaocfernandes,7,0.00045,343475,22.00244,1561077
5365,joaquin386,7,0.00045,343482,22.00289,1561077
5366,joariasl,7,0.00045,343489,22.00333,1561077
5367,joemar1988,7,0.00045,343496,22.00378,1561077
5368,JoeNunnelley,7,0.00045,343503,22.00423,1561077
5369,johnpneumann,7,0.00045,343510,22.00468,1561077
5370,jonathanpdx,7,0.00045,343517,22.00513,1561077
5371,JonCubed,7,0.00045,343524,22.00558,1561077
5372,josemalonsom,7,0.00045,343531,22.00603,1561077
5373,jose-manuel-almaza,7,0.00045,343538,22.00647,1561077
5374,josh-stupplebeen,7,0.00045,343545,22.00692,1561077
5375,jotacamou,7,0.00045,343552,22.00737,1561077
5376,jpace121,7,0.00045,343559,22.00782,1561077
5377,jpadhye,7,0.00045,343566,22.00827,1561077
5378,jpraet,7,0.00045,343573,22.00872,1561077
5379,jrichardsz,7,0.00045,343580,22.00916,1561077
5380,jsalinas29,7,0.00045,343587,22.00961,1561077
5381,jslay-excella,7,0.00045,343594,22.01006,1561077
5382,JTSweet,7,0.00045,343601,22.01051,1561077
5383,judy,7,0.00045,343608,22.01096,1561077
5384,jumpalongjim,7,0.00045,343615,22.01141,1561077
5385,jwach,7,0.00045,343622,22.01185,1561077
5386,jxbot-00,7,0.00045,343629,22.01230,1561077
5387,jzuijlek,7,0.00045,343636,22.01275,1561077
5388,kadimgh,7,0.00045,343643,22.01320,1561077
5389,kaisoz,7,0.00045,343650,22.01365,1561077
5390,kakumar,7,0.00045,343657,22.01410,1561077
5391,Kalvin126,7,0.00045,343664,22.01455,1561077
5392,KangTheTerrible,7,0.00045,343671,22.01499,1561077
5393,kardiff18,7,0.00045,343678,22.01544,1561077
5394,karjsim,7,0.00045,343685,22.01589,1561077
5395,karkusviktor,7,0.00045,343692,22.01634,1561077
5396,karthikeyan82,7,0.00045,343699,22.01679,1561077
5397,karthikjayaraman80,7,0.00045,343706,22.01724,1561077
5398,kaschel-hm,7,0.00045,343713,22.01768,1561077
5399,kcatstack,7,0.00045,343720,22.01813,1561077
5400,keegangroth,7,0.00045,343727,22.01858,1561077
5401,kerlandsson,7,0.00045,343734,22.01903,1561077
5402,kevindashgit,7,0.00045,343741,22.01948,1561077
5403,KevinLuc95,7,0.00045,343748,22.01993,1561077
5404,kgoedert,7,0.00045,343755,22.02037,1561077
5405,khensel17,7,0.00045,343762,22.02082,1561077
5406,kiril-dayradzhiev,7,0.00045,343769,22.02127,1561077
5407,kishorebhatia,7,0.00045,343776,22.02172,1561077
5408,kisoku,7,0.00045,343783,22.02217,1561077
5409,kjkao,7,0.00045,343790,22.02262,1561077
5410,kjt,7,0.00045,343797,22.02306,1561077
5411,KKoukiou,7,0.00045,343804,22.02351,1561077
5412,kousu,7,0.00045,343811,22.02396,1561077
5413,kpuchida,7,0.00045,343818,22.02441,1561077
5414,kpvdr,7,0.00045,343825,22.02486,1561077
5415,kraftydevil,7,0.00045,343832,22.02531,1561077
5416,krisgraham,7,0.00045,343839,22.02576,1561077
5417,kriske83,7,0.00045,343846,22.02620,1561077
5418,kristofferpeterhansel,7,0.00045,343853,22.02665,1561077
5419,kroutley,7,0.00045,343860,22.02710,1561077
5420,krtrego,7,0.00045,343867,22.02755,1561077
5421,krzysztofr,7,0.00045,343874,22.02800,1561077
5422,kvalev,7,0.00045,343881,22.02845,1561077
5423,kvanzuijlen,7,0.00045,343888,22.02889,1561077
5424,Kydybets,7,0.00045,343895,22.02934,1561077
5425,kyubisation,7,0.00045,343902,22.02979,1561077
5426,lakshmikarollil,7,0.00045,343909,22.03024,1561077
5427,LALITTUTY108,7,0.00045,343916,22.03069,1561077
5428,lawre,7,0.00045,343923,22.03114,1561077
5429,Leander1P,7,0.00045,343930,22.03158,1561077
5430,LEDfan,7,0.00045,343937,22.03203,1561077
5431,leewin12,7,0.00045,343944,22.03248,1561077
5432,lenkaDillip62,7,0.00045,343951,22.03293,1561077
5433,leylmordor,7,0.00045,343958,22.03338,1561077
5434,lh39,7,0.00045,343965,22.03383,1561077
5435,linux-samurai,7,0.00045,343972,22.03428,1561077
5436,lkolchin,7,0.00045,343979,22.03472,1561077
5437,llaaiiqq,7,0.00045,343986,22.03517,1561077
5438,lmatear-r7,7,0.00045,343993,22.03562,1561077
5439,lmserrano,7,0.00045,344000,22.03607,1561077
5440,louisrdev,7,0.00045,344007,22.03652,1561077
5441,Lovee2412,7,0.00045,344014,22.03697,1561077
5442,lqbweb,7,0.00045,344021,22.03741,1561077
5443,ls-julien-deruere,7,0.00045,344028,22.03786,1561077
5444,Lunik,7,0.00045,344035,22.03831,1561077
5445,M1kep,7,0.00045,344042,22.03876,1561077
5446,m8ram,7,0.00045,344049,22.03921,1561077
5447,macolso,7,0.00045,344056,22.03966,1561077
5448,MadeInChina,7,0.00045,344063,22.04010,1561077
5449,mad-p,7,0.00045,344070,22.04055,1561077
5450,maggosourabh,7,0.00045,344077,22.04100,1561077
5451,magik6k,7,0.00045,344084,22.04145,1561077
5452,maheshopsmx,7,0.00045,344091,22.04190,1561077
5453,Mai-Lapyst,7,0.00045,344098,22.04235,1561077
5454,malena-ebert-sonarsource,7,0.00045,344105,22.04279,1561077
5455,mali-conductor,7,0.00045,344112,22.04324,1561077
5456,ManInGotham,7,0.00045,344119,22.04369,1561077
5457,marcperemiquel,7,0.00045,344126,22.04414,1561077
5458,mariahbb1,7,0.00045,344133,22.04459,1561077
5459,MarioSteinitz,7,0.00045,344140,22.04504,1561077
5460,MarkSRobinson,7,0.00045,344147,22.04549,1561077
5461,masonpackard,7,0.00045,344154,22.04593,1561077
5462,MastanaGuru,7,0.00045,344161,22.04638,1561077
5463,mathiasmah,7,0.00045,344168,22.04683,1561077
5464,mattboothman,7,0.00045,344175,22.04728,1561077
5465,mbakker2000,7,0.00045,344182,22.04773,1561077
5466,mbauerness,7,0.00045,344189,22.04818,1561077
5467,mb-lyrical,7,0.00045,344196,22.04862,1561077
5468,mcg,7,0.00045,344203,22.04907,1561077
5469,mcupak,7,0.00045,344210,22.04952,1561077
5470,md-5,7,0.00045,344217,22.04997,1561077
5471,mdiez19,7,0.00045,344224,22.05042,1561077
5472,mdoppler,7,0.00045,344231,22.05087,1561077
5473,Mehdi-Mameri,7,0.00045,344238,22.05131,1561077
5474,melanahammel,7,0.00045,344245,22.05176,1561077
5475,michaelboyles,7,0.00045,344252,22.05221,1561077
5476,michaeljs1990,7,0.00045,344259,22.05266,1561077
5477,Michenux,7,0.00045,344266,22.05311,1561077
5478,mick-feller,7,0.00045,344273,22.05356,1561077
5479,mieciu,7,0.00045,344280,22.05401,1561077
5480,migangqui,7,0.00045,344287,22.05445,1561077
5481,miguelconde91,7,0.00045,344294,22.05490,1561077
5482,mika,7,0.00045,344301,22.05535,1561077
5483,mike-sirs,7,0.00045,344308,22.05580,1561077
5484,mKaloer,7,0.00045,344315,22.05625,1561077
5485,mkamlesh,7,0.00045,344322,22.05670,1561077
5486,mmlegrand,7,0.00045,344329,22.05714,1561077
5487,mnonnenmacher,7,0.00045,344336,22.05759,1561077
5488,mohanraj-r,7,0.00045,344343,22.05804,1561077
5489,mohanss08,7,0.00045,344350,22.05849,1561077
5490,Moniseeta,7,0.00045,344357,22.05894,1561077
5491,MoreSolutions,7,0.00045,344364,22.05939,1561077
5492,Morion-Self,7,0.00045,344371,22.05983,1561077
5493,Mr-13,7,0.00045,344378,22.06028,1561077
5494,mrbriandavis,7,0.00045,344385,22.06073,1561077
5495,mreilly82,7,0.00045,344392,22.06118,1561077
5496,Mr-Reca,7,0.00045,344399,22.06163,1561077
5497,mrrsm,7,0.00045,344406,22.06208,1561077
5498,mruzicka,7,0.00045,344413,22.06252,1561077
5499,mr-zepol,7,0.00045,344420,22.06297,1561077
5500,msglueck,7,0.00045,344427,22.06342,1561077
5501,mtyler,7,0.00045,344434,22.06387,1561077
5502,mupakoz,7,0.00045,344441,22.06432,1561077
5503,murali741,7,0.00045,344448,22.06477,1561077
5504,nanjingfm,7,0.00045,344455,22.06522,1561077
5505,narcotics726,7,0.00045,344462,22.06566,1561077
5506,nashdiesel,7,0.00045,344469,22.06611,1561077
5507,nastharl,7,0.00045,344476,22.06656,1561077
5508,nateg-gladly,7,0.00045,344483,22.06701,1561077
5509,nbaudis,7,0.00045,344490,22.06746,1561077
5510,nc-fosterr,7,0.00045,344497,22.06791,1561077
5511,neldridge,7,0.00045,344504,22.06835,1561077
5512,Neustradamus,7,0.00045,344511,22.06880,1561077
5513,nexaddo,7,0.00045,344518,22.06925,1561077
5514,nfplatzke,7,0.00045,344525,22.06970,1561077
5515,ngaya-ll,7,0.00045,344532,22.07015,1561077
5516,ngerke,7,0.00045,344539,22.07060,1561077
5517,nguoianphu,7,0.00045,344546,22.07104,1561077
5518,nhatkhai,7,0.00045,344553,22.07149,1561077
5519,nibblesnbits,7,0.00045,344560,22.07194,1561077
5520,nicholasmparker,7,0.00045,344567,22.07239,1561077
5521,NickCharsley,7,0.00045,344574,22.07284,1561077
5522,nickgriffiths,7,0.00045,344581,22.07329,1561077
5523,NikhilaKambham,7,0.00045,344588,22.07373,1561077
5524,nikki-rally,7,0.00045,344595,22.07418,1561077
5525,NikolasFunction,7,0.00045,344602,22.07463,1561077
5526,nilave,7,0.00045,344609,22.07508,1561077
5527,nimishbongale,7,0.00045,344616,22.07553,1561077
5528,nishant-gupta,7,0.00045,344623,22.07598,1561077
5529,nishantn3,7,0.00045,344630,22.07643,1561077
5530,nnsense,7,0.00045,344637,22.07687,1561077
5531,npolagani,7,0.00045,344644,22.07732,1561077
5532,nreeb,7,0.00045,344651,22.07777,1561077
5533,nscmcgrath,7,0.00045,344658,22.07822,1561077
5534,nzhelyakov,7,0.00045,344665,22.07867,1561077
5535,oak9jreiner,7,0.00045,344672,22.07912,1561077
5536,okainov,7,0.00045,344679,22.07956,1561077
5537,oleksdovz,7,0.00045,344686,22.08001,1561077
5538,olivereri,7,0.00045,344693,22.08046,1561077
5539,omegarus,7,0.00045,344700,22.08091,1561077
5540,onionjake,7,0.00045,344707,22.08136,1561077
5541,ooxaaxoo,7,0.00045,344714,22.08181,1561077
5542,openbrian,7,0.00045,344721,22.08225,1561077
5543,optimuspaul,7,0.00045,344728,22.08270,1561077
5544,osanjuan,7,0.00045,344735,22.08315,1561077
5545,OsQu,7,0.00045,344742,22.08360,1561077
5546,Panajev,7,0.00045,344749,22.08405,1561077
5547,pangorgo,7,0.00045,344756,22.08450,1561077
5548,pankajsa,7,0.00045,344763,22.08495,1561077
5549,pault28,7,0.00045,344770,22.08539,1561077
5550,pbsladek,7,0.00045,344777,22.08584,1561077
5551,pdolega,7,0.00045,344784,22.08629,1561077
5552,peanderson2016,7,0.00045,344791,22.08674,1561077
5553,Persi,7,0.00045,344798,22.08719,1561077
5554,peterbecich,7,0.00045,344805,22.08764,1561077
5555,peternied,7,0.00045,344812,22.08808,1561077
5556,pfeigl,7,0.00045,344819,22.08853,1561077
5557,pguimaraes,7,0.00045,344826,22.08898,1561077
5558,phil15world988,7,0.00045,344833,22.08943,1561077
5559,phillipjohnston,7,0.00045,344840,22.08988,1561077
5560,phucyall,7,0.00045,344847,22.09033,1561077
5561,phuna,7,0.00045,344854,22.09077,1561077
5562,pietervincken,7,0.00045,344861,22.09122,1561077
5563,piomar123,7,0.00045,344868,22.09167,1561077
5564,pipapo-sl,7,0.00045,344875,22.09212,1561077
5565,piyushGoyal2,7,0.00045,344882,22.09257,1561077
5566,planeonline,7,0.00045,344889,22.09302,1561077
5567,plnordquist,7,0.00045,344896,22.09346,1561077
5568,Polpetta,7,0.00045,344903,22.09391,1561077
5569,polsad,7,0.00045,344910,22.09436,1561077
5570,prabhir2008,7,0.00045,344917,22.09481,1561077
5571,pradyuman,7,0.00045,344924,22.09526,1561077
5572,pragnesh-infostretch,7,0.00045,344931,22.09571,1561077
5573,precisiondev,7,0.00045,344938,22.09616,1561077
5574,prelegalwonder,7,0.00045,344945,22.09660,1561077
5575,purduemike,7,0.00045,344952,22.09705,1561077
5576,q-a,7,0.00045,344959,22.09750,1561077
5577,qcspewa,7,0.00045,344966,22.09795,1561077
5578,raghavbhatnagar96,7,0.00045,344973,22.09840,1561077
5579,Raichel,7,0.00045,344980,22.09885,1561077
5580,rajachawat,7,0.00045,344987,22.09929,1561077
5581,Rajno1,7,0.00045,344994,22.09974,1561077
5582,RamonGebben,7,0.00045,345001,22.10019,1561077
5583,ramy-siha,7,0.00045,345008,22.10064,1561077
5584,RandomSort,7,0.00045,345015,22.10109,1561077
5585,rantav,7,0.00045,345022,22.10154,1561077
5586,rarawal,7,0.00045,345029,22.10198,1561077
5587,rarneson,7,0.00045,345036,22.10243,1561077
5588,Rashair,7,0.00045,345043,22.10288,1561077
5589,raskulka,7,0.00045,345050,22.10333,1561077
5590,rasmusjelsgaard,7,0.00045,345057,22.10378,1561077
5591,ratika-ipg,7,0.00045,345064,22.10423,1561077
5592,ravenchilde,7,0.00045,345071,22.10468,1561077
5593,Raviyadav409,7,0.00045,345078,22.10512,1561077
5594,rcmoutinho,7,0.00045,345085,22.10557,1561077
5595,rehidalgo,7,0.00045,345092,22.10602,1561077
5596,reintroducing,7,0.00045,345099,22.10647,1561077
5597,res0nat0r,7,0.00045,345106,22.10692,1561077
5598,review-ninja,7,0.00045,345113,22.10737,1561077
5599,rgarrigue,7,0.00045,345120,22.10781,1561077
5600,rgauny,7,0.00045,345127,22.10826,1561077
5601,rgrsoucy,7,0.00045,345134,22.10871,1561077
5602,rhels,7,0.00045,345141,22.10916,1561077
5603,ric79,7,0.00045,345148,22.10961,1561077
5604,ricardf,7,0.00045,345155,22.11006,1561077
5605,Rifffi,7,0.00045,345162,22.11050,1561077
5606,riqio,7,0.00045,345169,22.11095,1561077
5607,rmstyrczula,7,0.00045,345176,22.11140,1561077
5608,robertgartman,7,0.00045,345183,22.11185,1561077
5609,Robert-Ilg,7,0.00045,345190,22.11230,1561077
5610,roebi,7,0.00045,345197,22.11275,1561077
5611,roeera,7,0.00045,345204,22.11319,1561077
5612,RohanImmanuel,7,0.00045,345211,22.11364,1561077
5613,RoryQ,7,0.00045,345218,22.11409,1561077
5614,RoVernekar,7,0.00045,345225,22.11454,1561077
5615,roydekleijn,7,0.00045,345232,22.11499,1561077
5616,rparadowski,7,0.00045,345239,22.11544,1561077
5617,rporres,7,0.00045,345246,22.11589,1561077
5618,rschaefer2,7,0.00045,345253,22.11633,1561077
5619,rsommer,7,0.00045,345260,22.11678,1561077
5620,rupinr,7,0.00045,345267,22.11723,1561077
5621,rvadim,7,0.00045,345274,22.11768,1561077
5622,ryanpritchard,7,0.00045,345281,22.11813,1561077
5623,RyochanUedasan,7,0.00045,345288,22.11858,1561077
5624,S3NS4Ti0N,7,0.00045,345295,22.11902,1561077
5625,Safe0,7,0.00045,345302,22.11947,1561077
5626,saledouble,7,0.00045,345309,22.11992,1561077
5627,samirageb,7,0.00045,345316,22.12037,1561077
5628,sammic30,7,0.00045,345323,22.12082,1561077
5629,SamPeng87,7,0.00045,345330,22.12127,1561077
5630,sappersd,7,0.00045,345337,22.12171,1561077
5631,saptarshide007,7,0.00045,345344,22.12216,1561077
5632,sarnaudova,7,0.00045,345351,22.12261,1561077
5633,sasha-quali,7,0.00045,345358,22.12306,1561077
5634,sbauer18,7,0.00045,345365,22.12351,1561077
5635,sch1itzohr,7,0.00045,345372,22.12396,1561077
5636,sco11morgan,7,0.00045,345379,22.12441,1561077
5637,sdanieru,7,0.00045,345386,22.12485,1561077
5638,seb-lie,7,0.00045,345393,22.12530,1561077
5639,sebok,7,0.00045,345400,22.12575,1561077
5640,selin194,7,0.00045,345407,22.12620,1561077
5641,senare,7,0.00045,345414,22.12665,1561077
5642,sennetheunisporphy,7,0.00045,345421,22.12710,1561077
5643,sergeyshepel,7,0.00045,345428,22.12754,1561077
5644,sflynn-dell,7,0.00045,345435,22.12799,1561077
5645,sfransen,7,0.00045,345442,22.12844,1561077
5646,shalithasuranga,7,0.00045,345449,22.12889,1561077
5647,ShashankYadav,7,0.00045,345456,22.12934,1561077
5648,shenmou98,7,0.00045,345463,22.12979,1561077
5649,sidkris77,7,0.00045,345470,22.13023,1561077
5650,sig-cpotts,7,0.00045,345477,22.13068,1561077
5651,sigossi,7,0.00045,345484,22.13113,1561077
5652,sikelerd,7,0.00045,345491,22.13158,1561077
5653,simonati,7,0.00045,345498,22.13203,1561077
5654,SirMrDexter,7,0.00045,345505,22.13248,1561077
5655,skeenan947,7,0.00045,345512,22.13292,1561077
5656,skmukherjee,7,0.00045,345519,22.13337,1561077
5657,SKroell,7,0.00045,345526,22.13382,1561077
5658,SLourenco,7,0.00045,345533,22.13427,1561077
5659,slupers,7,0.00045,345540,22.13472,1561077
5660,snadn,7,0.00045,345547,22.13517,1561077
5661,Snapstromegon,7,0.00045,345554,22.13562,1561077
5662,Softmuppen,7,0.00045,345561,22.13606,1561077
5663,solevic,7,0.00045,345568,22.13651,1561077
5664,soliad,7,0.00045,345575,22.13696,1561077
5665,sona-tar,7,0.00045,345582,22.13741,1561077
5666,soorajpv,7,0.00045,345589,22.13786,1561077
5667,soundcloudfrank,7,0.00045,345596,22.13831,1561077
5668,Sounie,7,0.00045,345603,22.13875,1561077
5669,souvik-deepsource,7,0.00045,345610,22.13920,1561077
5670,Spacetown,7,0.00045,345617,22.13965,1561077
5671,Spritekin,7,0.00045,345624,22.14010,1561077
5672,srbala,7,0.00045,345631,22.14055,1561077
5673,srinath0301,7,0.00045,345638,22.14100,1561077
5674,SrutiMi,7,0.00045,345645,22.14144,1561077
5675,ssrivastava-papajohns,7,0.00045,345652,22.14189,1561077
5676,St4rz,7,0.00045,345659,22.14234,1561077
5677,stankolubomir,7,0.00045,345666,22.14279,1561077
5678,stefano-m,7,0.00045,345673,22.14324,1561077
5679,stephen-badger,7,0.00045,345680,22.14369,1561077
5680,stevenbaker,7,0.00045,345687,22.14414,1561077
5681,steve-todorov,7,0.00045,345694,22.14458,1561077
5682,Subzer0570,7,0.00045,345701,22.14503,1561077
5683,sumitag,7,0.00045,345708,22.14548,1561077
5684,sunil2438,7,0.00045,345715,22.14593,1561077
5685,svc-automator,7,0.00045,345722,22.14638,1561077
5686,svenstaro,7,0.00045,345729,22.14683,1561077
5687,SwankyPantie,7,0.00045,345736,22.14727,1561077
5688,swilliams-dev,7,0.00045,345743,22.14772,1561077
5689,sxcoll2,7,0.00045,345750,22.14817,1561077
5690,sylv704,7,0.00045,345757,22.14862,1561077
5691,szantopeter,7,0.00045,345764,22.14907,1561077
5692,szjozsef,7,0.00045,345771,22.14952,1561077
5693,Taeloz,7,0.00045,345778,22.14996,1561077
5694,tanon-adm,7,0.00045,345785,22.15041,1561077
5695,tasneemkoushar,7,0.00045,345792,22.15086,1561077
5696,Tas-sos,7,0.00045,345799,22.15131,1561077
5697,tavin,7,0.00045,345806,22.15176,1561077
5698,tbrugz,7,0.00045,345813,22.15221,1561077
5699,teabuilder,7,0.00045,345820,22.15265,1561077
5700,technolo-g,7,0.00045,345827,22.15310,1561077
5701,telisior,7,0.00045,345834,22.15355,1561077
5702,TestYourLuck,7,0.00045,345841,22.15400,1561077
5703,tetsushiawano,7,0.00045,345848,22.15445,1561077
5704,texasaggie97,7,0.00045,345855,22.15490,1561077
5705,tfheen,7,0.00045,345862,22.15535,1561077
5706,thcp,7,0.00045,345869,22.15579,1561077
5707,TheCodeArtist,7,0.00045,345876,22.15624,1561077
5708,thecodesmith,7,0.00045,345883,22.15669,1561077
5709,ThejashwiniSwamy,7,0.00045,345890,22.15714,1561077
5710,thephw,7,0.00045,345897,22.15759,1561077
5711,thesamet,7,0.00045,345904,22.15804,1561077
5712,thevinter,7,0.00045,345911,22.15848,1561077
5713,thorin,7,0.00045,345918,22.15893,1561077
5714,ThreadbareHalo,7,0.00045,345925,22.15938,1561077
5715,tibcoplord,7,0.00045,345932,22.15983,1561077
5716,timocov,7,0.00045,345939,22.16028,1561077
5717,timsheng,7,0.00045,345946,22.16073,1561077
5718,TimSin,7,0.00045,345953,22.16117,1561077
5719,tingzhang1210,7,0.00045,345960,22.16162,1561077
5720,tjormola,7,0.00045,345967,22.16207,1561077
5721,tkuther,7,0.00045,345974,22.16252,1561077
5722,tmshn,7,0.00045,345981,22.16297,1561077
5723,tomachi,7,0.00045,345988,22.16342,1561077
5724,Tom-Hobson,7,0.00045,345995,22.16387,1561077
5725,tommaso-borgato,7,0.00045,346002,22.16431,1561077
5726,tomverin,7,0.00045,346009,22.16476,1561077
5727,TomyLobo,7,0.00045,346016,22.16521,1561077
5728,toughrice,7,0.00045,346023,22.16566,1561077
5729,treuherz,7,0.00045,346030,22.16611,1561077
5730,tsonny,7,0.00045,346037,22.16656,1561077
5731,tudortimi-ifx,7,0.00045,346044,22.16700,1561077
5732,tvishwanatharkin,7,0.00045,346051,22.16745,1561077
5733,tyhunt99,7,0.00045,346058,22.16790,1561077
5734,tzvetkov75,7,0.00045,346065,22.16835,1561077
5735,u2g-tg,7,0.00045,346072,22.16880,1561077
5736,underscorebrody,7,0.00045,346079,22.16925,1561077
5737,uschindler,7,0.00045,346086,22.16969,1561077
5738,usernameisnull,7,0.00045,346093,22.17014,1561077
5739,vackraord,7,0.00045,346100,22.17059,1561077
5740,vadirajks,7,0.00045,346107,22.17104,1561077
5741,vamsi248,7,0.00045,346114,22.17149,1561077
5742,varju,7,0.00045,346121,22.17194,1561077
5743,Veske,7,0.00045,346128,22.17238,1561077
5744,ViachaslauKabak,7,0.00045,346135,22.17283,1561077
5745,vijayinjam,7,0.00045,346142,22.17328,1561077
5746,vikpatil270,7,0.00045,346149,22.17373,1561077
5747,vinced45,7,0.00045,346156,22.17418,1561077
5748,Vintic,7,0.00045,346163,22.17463,1561077
5749,vishaldotkhanna,7,0.00045,346170,22.17508,1561077
5750,vlam0120,7,0.00045,346177,22.17552,1561077
5751,vlambat,7,0.00045,346184,22.17597,1561077
5752,VQuery,7,0.00045,346191,22.17642,1561077
5753,wangchangjian,7,0.00045,346198,22.17687,1561077
5754,wborn,7,0.00045,346205,22.17732,1561077
5755,wdforson,7,0.00045,346212,22.17777,1561077
5756,whillas,7,0.00045,346219,22.17821,1561077
5757,willneumob,7,0.00045,346226,22.17866,1561077
5758,willylee,7,0.00045,346233,22.17911,1561077
5759,wimsymons,7,0.00045,346240,22.17956,1561077
5760,witjoh,7,0.00045,346247,22.18001,1561077
5761,wvbirder,7,0.00045,346254,22.18046,1561077
5762,wy2249,7,0.00045,346261,22.18090,1561077
5763,XavierRaynaud,7,0.00045,346268,22.18135,1561077
5764,xcesiv,7,0.00045,346275,22.18180,1561077
5765,xeon22,7,0.00045,346282,22.18225,1561077
5766,xiaoyao-shull,7,0.00045,346289,22.18270,1561077
5767,y0y0z,7,0.00045,346296,22.18315,1561077
5768,Yamini-TWG,7,0.00045,346303,22.18360,1561077
5769,yangxylab,7,0.00045,346310,22.18404,1561077
5770,yarinkos,7,0.00045,346317,22.18449,1561077
5771,yeroc,7,0.00045,346324,22.18494,1561077
5772,yesdevnull,7,0.00045,346331,22.18539,1561077
5773,yindejie,7,0.00045,346338,22.18584,1561077
5774,ykoehler,7,0.00045,346345,22.18629,1561077
5775,ykw0104,7,0.00045,346352,22.18673,1561077
5776,yu-ya0614,7,0.00045,346359,22.18718,1561077
5777,ywang-psee,7,0.00045,346366,22.18763,1561077
5778,zackb,7,0.00045,346373,22.18808,1561077
5779,zambamingi,7,0.00045,346380,22.18853,1561077
5780,zcjtom,7,0.00045,346387,22.18898,1561077
5781,zekiunal,7,0.00045,346394,22.18942,1561077
5782,3r1co,6,0.00038,346400,22.18981,1561077
5783,4a6f656c,6,0.00038,346406,22.19019,1561077
5784,96RadhikaJadhav,6,0.00038,346412,22.19058,1561077
5785,aahmed7,6,0.00038,346418,22.19096,1561077
5786,aakhmerov,6,0.00038,346424,22.19135,1561077
5787,aakoch,6,0.00038,346430,22.19173,1561077
5788,Aamir010,6,0.00038,346436,22.19211,1561077
5789,Aathirajan,6,0.00038,346442,22.19250,1561077
5790,abentley,6,0.00038,346448,22.19288,1561077
5791,abhishekshah-qmetry,6,0.00038,346454,22.19327,1561077
5792,abridgett,6,0.00038,346460,22.19365,1561077
5793,Abubakar22,6,0.00038,346466,22.19404,1561077
5794,acelorio,6,0.00038,346472,22.19442,1561077
5795,adamcath,6,0.00038,346478,22.19481,1561077
5796,adamkenihan,6,0.00038,346484,22.19519,1561077
5797,adam-krieg,6,0.00038,346490,22.19557,1561077
5798,adiltajammal,6,0.00038,346496,22.19596,1561077
5799,adityaparamesh,6,0.00038,346502,22.19634,1561077
5800,adolfo,6,0.00038,346508,22.19673,1561077
5801,adrianmiron,6,0.00038,346514,22.19711,1561077
5802,adriavernetta,6,0.00038,346520,22.19750,1561077
5803,agherzan,6,0.00038,346526,22.19788,1561077
5804,ahahxof,6,0.00038,346532,22.19826,1561077
5805,aii-ssvinoth22,6,0.00038,346538,22.19865,1561077
5806,ailsachiu,6,0.00038,346544,22.19903,1561077
5807,ajmera25,6,0.00038,346550,22.19942,1561077
5808,ajureeruja,6,0.00038,346556,22.19980,1561077
5809,akanshaallyo,6,0.00038,346562,22.20019,1561077
5810,Akash3221,6,0.00038,346568,22.20057,1561077
5811,akrapfl,6,0.00038,346574,22.20095,1561077
5812,alanjjenkins,6,0.00038,346580,22.20134,1561077
5813,albac,6,0.00038,346586,22.20172,1561077
5814,albert-lv,6,0.00038,346592,22.20211,1561077
5815,alberto-sierra,6,0.00038,346598,22.20249,1561077
5816,alcaeus,6,0.00038,346604,22.20288,1561077
5817,alex3d,6,0.00038,346610,22.20326,1561077
5818,alexkogon,6,0.00038,346616,22.20365,1561077
5819,AlexPrigoreanu,6,0.00038,346622,22.20403,1561077
5820,alexsuter,6,0.00038,346628,22.20441,1561077
5821,almozavr,6,0.00038,346634,22.20480,1561077
5822,aloubyansky,6,0.00038,346640,22.20518,1561077
5823,Amakata,6,0.00038,346646,22.20557,1561077
5824,AmanDhaka1986,6,0.00038,346652,22.20595,1561077
5825,amarps,6,0.00038,346658,22.20634,1561077
5826,AmineAML,6,0.00038,346664,22.20672,1561077
5827,amirbh913,6,0.00038,346670,22.20710,1561077
5828,AndreeaPocol,6,0.00038,346676,22.20749,1561077
5829,andrewdutton,6,0.00038,346682,22.20787,1561077
5830,andrewegel,6,0.00038,346688,22.20826,1561077
5831,andrewfba,6,0.00038,346694,22.20864,1561077
5832,andrewwippler,6,0.00038,346700,22.20903,1561077
5833,AndreyAlifanov,6,0.00038,346706,22.20941,1561077
5834,andycockers,6,0.00038,346712,22.20979,1561077
5835,andy-smith-msm,6,0.00038,346718,22.21018,1561077
5836,angelakim,6,0.00038,346724,22.21056,1561077
5837,ankititdude,6,0.00038,346730,22.21095,1561077
5838,ankushkatiyar,6,0.00038,346736,22.21133,1561077
5839,AnnoyingB,6,0.00038,346742,22.21172,1561077
5840,antone-sb,6,0.00038,346748,22.21210,1561077
5841,AntonioArenas,6,0.00038,346754,22.21249,1561077
5842,anub1s187,6,0.00038,346760,22.21287,1561077
5843,anurag1408,6,0.00038,346766,22.21325,1561077
5844,anyone-can-test,6,0.00038,346772,22.21364,1561077
5845,apolloTaotao,6,0.00038,346778,22.21402,1561077
5846,apwrv,6,0.00038,346784,22.21441,1561077
5847,aq-lporter,6,0.00038,346790,22.21479,1561077
5848,aquator,6,0.00038,346796,22.21518,1561077
5849,arihyttinen,6,0.00038,346802,22.21556,1561077
5850,aruantec,6,0.00038,346808,22.21594,1561077
5851,arunavemulapalli,6,0.00038,346814,22.21633,1561077
5852,arunsr2015,6,0.00038,346820,22.21671,1561077
5853,asc-adean,6,0.00038,346826,22.21710,1561077
5854,ash1425,6,0.00038,346832,22.21748,1561077
5855,ashleyfrieze,6,0.00038,346838,22.21787,1561077
5856,ashsrira,6,0.00038,346844,22.21825,1561077
5857,ashutosh16,6,0.00038,346850,22.21863,1561077
5858,AssaelDan,6,0.00038,346856,22.21902,1561077
5859,atcarmo,6,0.00038,346862,22.21940,1561077
5860,atmcarmo,6,0.00038,346868,22.21979,1561077
5861,att55,6,0.00038,346874,22.22017,1561077
5862,aty55,6,0.00038,346880,22.22056,1561077
5863,aunderw,6,0.00038,346886,22.22094,1561077
5864,awolde,6,0.00038,346892,22.22133,1561077
5865,ayushjainrksh,6,0.00038,346898,22.22171,1561077
5866,b4b4r07,6,0.00038,346904,22.22209,1561077
5867,bainss,6,0.00038,346910,22.22248,1561077
5868,balainit,6,0.00038,346916,22.22286,1561077
5869,balaji-digital-ai,6,0.00038,346922,22.22325,1561077
5870,balajipachai,6,0.00038,346928,22.22363,1561077
5871,baohaojun,6,0.00038,346934,22.22402,1561077
5872,bars0um,6,0.00038,346940,22.22440,1561077
5873,baubakg,6,0.00038,346946,22.22478,1561077
5874,beerkeeper,6,0.00038,346952,22.22517,1561077
5875,beezly,6,0.00038,346958,22.22555,1561077
5876,behren,6,0.00038,346964,22.22594,1561077
5877,belingueres,6,0.00038,346970,22.22632,1561077
5878,BenjaminGill-Metaswitch,6,0.00038,346976,22.22671,1561077
5879,Ben-Mark,6,0.00038,346982,22.22709,1561077
5880,benru,6,0.00038,346988,22.22748,1561077
5881,bernardomk,6,0.00038,346994,22.22786,1561077
5882,betterphp,6,0.00038,347000,22.22824,1561077
5883,bgalamb,6,0.00038,347006,22.22863,1561077
5884,bhavith,6,0.00038,347012,22.22901,1561077
5885,bianxseyer,6,0.00038,347018,22.22940,1561077
5886,biffen,6,0.00038,347024,22.22978,1561077
5887,bimlendu,6,0.00038,347030,22.23017,1561077
5888,bishnuroy,6,0.00038,347036,22.23055,1561077
5889,blackHatMonkey,6,0.00038,347042,22.23093,1561077
5890,BlackHornet,6,0.00038,347048,22.23132,1561077
5891,Blogshot,6,0.00038,347054,22.23170,1561077
5892,BlueIcarus,6,0.00038,347060,22.23209,1561077
5893,bniwredyc,6,0.00038,347066,22.23247,1561077
5894,boarder981,6,0.00038,347072,22.23286,1561077
5895,bogdanmuresan,6,0.00038,347078,22.23324,1561077
5896,BradyShober,6,0.00038,347084,22.23362,1561077
5897,branch331,6,0.00038,347090,22.23401,1561077
5898,brd,6,0.00038,347096,22.23439,1561077
5899,brianantonelli,6,0.00038,347102,22.23478,1561077
5900,bschommer,6,0.00038,347108,22.23516,1561077
5901,bsda,6,0.00038,347114,22.23555,1561077
5902,bsiri,6,0.00038,347120,22.23593,1561077
5903,bunnyyiu,6,0.00038,347126,22.23632,1561077
5904,byakk70,6,0.00038,347132,22.23670,1561077
5905,c1505,6,0.00038,347138,22.23708,1561077
5906,cadorb,6,0.00038,347144,22.23747,1561077
5907,calin-iorgulescu,6,0.00038,347150,22.23785,1561077
5908,cam-laf,6,0.00038,347156,22.23824,1561077
5909,ca-monteiro,6,0.00038,347162,22.23862,1561077
5910,CaptainPGums,6,0.00038,347168,22.23901,1561077
5911,carllindberg,6,0.00038,347174,22.23939,1561077
5912,carloscaverobarca,6,0.00038,347180,22.23977,1561077
5913,carlosjer,6,0.00038,347186,22.24016,1561077
5914,ccosby,6,0.00038,347192,22.24054,1561077
5915,cdbennett,6,0.00038,347198,22.24093,1561077
5916,cedriclecoz,6,0.00038,347204,22.24131,1561077
5917,cfarence,6,0.00038,347210,22.24170,1561077
5918,cfraenkel,6,0.00038,347216,22.24208,1561077
5919,Chabouchakour,6,0.00038,347222,22.24246,1561077
5920,chasturansky,6,0.00038,347228,22.24285,1561077
5921,cheungaryk,6,0.00038,347234,22.24323,1561077
5922,chforster,6,0.00038,347240,22.24362,1561077
5923,chris248570,6,0.00038,347246,22.24400,1561077
5924,chrisevett,6,0.00038,347252,22.24439,1561077
5925,chris-lee-parsable,6,0.00038,347258,22.24477,1561077
5926,chrismair,6,0.00038,347264,22.24516,1561077
5927,christophe-mailfert,6,0.00038,347270,22.24554,1561077
5928,cizara,6,0.00038,347276,22.24592,1561077
5929,claudio-walser,6,0.00038,347282,22.24631,1561077
5930,clover-bt,6,0.00038,347288,22.24669,1561077
5931,cmaggiulli,6,0.00038,347294,22.24708,1561077
5932,Cocotton,6,0.00038,347300,22.24746,1561077
5933,cocowowo,6,0.00038,347306,22.24785,1561077
5934,Coeur,6,0.00038,347312,22.24823,1561077
5935,ConstantinElse,6,0.00038,347318,22.24861,1561077
5936,Cosby86,6,0.00038,347324,22.24900,1561077
5937,cprovencher,6,0.00038,347330,22.24938,1561077
5938,cristi-vlad2,6,0.00038,347336,22.24977,1561077
5939,czsilence,6,0.00038,347342,22.25015,1561077
5940,dabogee,6,0.00038,347348,22.25054,1561077
5941,dabrowt1,6,0.00038,347354,22.25092,1561077
5942,daftano,6,0.00038,347360,22.25130,1561077
5943,daipresents,6,0.00038,347366,22.25169,1561077
5944,Damien9527,6,0.00038,347372,22.25207,1561077
5945,damon-atkins,6,0.00038,347378,22.25246,1561077
5946,danhumphrey,6,0.00038,347384,22.25284,1561077
5947,Daniel1854,6,0.00038,347390,22.25323,1561077
5948,danielkutik,6,0.00038,347396,22.25361,1561077
5949,danielleffler,6,0.00038,347402,22.25400,1561077
5950,DanInst84,6,0.00038,347408,22.25438,1561077
5951,danjmccay,6,0.00038,347414,22.25476,1561077
5952,darinpantley,6,0.00038,347420,22.25515,1561077
5953,darshank15,6,0.00038,347426,22.25553,1561077
5954,DarthOpto,6,0.00038,347432,22.25592,1561077
5955,dash1291,6,0.00038,347438,22.25630,1561077
5956,davewongillies,6,0.00038,347444,22.25669,1561077
5957,dbilling,6,0.00038,347450,22.25707,1561077
5958,ddavison,6,0.00038,347456,22.25745,1561077
5959,deadly-panda,6,0.00038,347462,22.25784,1561077
5960,deepakr199,6,0.00038,347468,22.25822,1561077
5961,deepio,6,0.00038,347474,22.25861,1561077
5962,delphym,6,0.00038,347480,22.25899,1561077
5963,DemiurgeKH3,6,0.00038,347486,22.25938,1561077
5964,denami,6,0.00038,347492,22.25976,1561077
5965,denis-matchenko,6,0.00038,347498,22.26014,1561077
5966,denissilveira,6,0.00038,347504,22.26053,1561077
5967,derfred,6,0.00038,347510,22.26091,1561077
5968,deshantm,6,0.00038,347516,22.26130,1561077
5969,devilmind81,6,0.00038,347522,22.26168,1561077
5970,dhet,6,0.00038,347528,22.26207,1561077
5971,dillona,6,0.00038,347534,22.26245,1561077
5972,dimitris-sweagle,6,0.00038,347540,22.26284,1561077
5973,dimkin-eu,6,0.00038,347546,22.26322,1561077
5974,dionrhys,6,0.00038,347552,22.26360,1561077
5975,dizeee,6,0.00038,347558,22.26399,1561077
5976,DKroot,6,0.00038,347564,22.26437,1561077
5977,Dlittler949,6,0.00038,347570,22.26476,1561077
5978,dmachard,6,0.00038,347576,22.26514,1561077
5979,dmackinnon,6,0.00038,347582,22.26553,1561077
5980,dmarin,6,0.00038,347588,22.26591,1561077
5981,doctorpangloss,6,0.00038,347594,22.26629,1561077
5982,dodgex,6,0.00038,347600,22.26668,1561077
5983,DomnMihai,6,0.00038,347606,22.26706,1561077
5984,DonaldKallman,6,0.00038,347612,22.26745,1561077
5985,donglinjy,6,0.00038,347618,22.26783,1561077
5986,dorrab,6,0.00038,347624,22.26822,1561077
5987,dotcom-monitor,6,0.00038,347630,22.26860,1561077
5988,doughgle,6,0.00038,347636,22.26898,1561077
5989,dougjoh,6,0.00038,347642,22.26937,1561077
5990,dproteus13,6,0.00038,347648,22.26975,1561077
5991,dragan-pazin,6,0.00038,347654,22.27014,1561077
5992,drauch,6,0.00038,347660,22.27052,1561077
5993,drealecs,6,0.00038,347666,22.27091,1561077
5994,drodio,6,0.00038,347672,22.27129,1561077
5995,Droogans,6,0.00038,347678,22.27168,1561077
5996,dschlenk,6,0.00038,347684,22.27206,1561077
5997,dschwabeS11,6,0.00038,347690,22.27244,1561077
5998,dudi-peer,6,0.00038,347696,22.27283,1561077
5999,DunklerPhoenix,6,0.00038,347702,22.27321,1561077
6000,dvaletin,6,0.00038,347708,22.27360,1561077
6001,dwatrous,6,0.00038,347714,22.27398,1561077
6002,D-wenhao,6,0.00038,347720,22.27437,1561077
6003,ebalsumgo,6,0.00038,347726,22.27475,1561077
6004,edimarlnx,6,0.00038,347732,22.27513,1561077
6005,edwardprzeniczny,6,0.00038,347738,22.27552,1561077
6006,edwinvanderham,6,0.00038,347744,22.27590,1561077
6007,eklein,6,0.00038,347750,22.27629,1561077
6008,ekmoore,6,0.00038,347756,22.27667,1561077
6009,ekreutz,6,0.00038,347762,22.27706,1561077
6010,ekupershlak,6,0.00038,347768,22.27744,1561077
6011,Elisedlund,6,0.00038,347774,22.27782,1561077
6012,elops-od,6,0.00038,347780,22.27821,1561077
6013,emanuelelevo,6,0.00038,347786,22.27859,1561077
6014,emilaasa,6,0.00038,347792,22.27898,1561077
6015,emile-jumo,6,0.00038,347798,22.27936,1561077
6016,emmaLP,6,0.00038,347804,22.27975,1561077
6017,emmanuelguerin,6,0.00038,347810,22.28013,1561077
6018,empath,6,0.00038,347816,22.28052,1561077
6019,enieuw,6,0.00038,347822,22.28090,1561077
6020,eniomachado,6,0.00038,347828,22.28128,1561077
6021,eonil,6,0.00038,347834,22.28167,1561077
6022,eran-davidi-optibus,6,0.00038,347840,22.28205,1561077
6023,eric-simpson,6,0.00038,347846,22.28244,1561077
6024,erik-hakansson-wcar,6,0.00038,347852,22.28282,1561077
6025,eriknellessen,6,0.00038,347858,22.28321,1561077
6026,escap89,6,0.00038,347864,22.28359,1561077
6027,espguitarist33,6,0.00038,347870,22.28397,1561077
6028,ethai,6,0.00038,347876,22.28436,1561077
6029,EtienneG,6,0.00038,347882,22.28474,1561077
6030,eyonasi,6,0.00038,347888,22.28513,1561077
6031,ezyang,6,0.00038,347894,22.28551,1561077
6032,f2rf2r,6,0.00038,347900,22.28590,1561077
6033,fabioluciano,6,0.00038,347906,22.28628,1561077
6034,fangchao117,6,0.00038,347912,22.28666,1561077
6035,Faraaaaaaaaaaaa,6,0.00038,347918,22.28705,1561077
6036,fasatrix,6,0.00038,347924,22.28743,1561077
6037,fcristovao,6,0.00038,347930,22.28782,1561077
6038,fdonze,6,0.00038,347936,22.28820,1561077
6039,fdvieira,6,0.00038,347942,22.28859,1561077
6040,FeBrex,6,0.00038,347948,22.28897,1561077
6041,ffloimair,6,0.00038,347954,22.28936,1561077
6042,fgauthier-boutin,6,0.00038,347960,22.28974,1561077
6043,fjmilens3,6,0.00038,347966,22.29012,1561077
6044,flaviostutz,6,0.00038,347972,22.29051,1561077
6045,florintamas,6,0.00038,347978,22.29089,1561077
6046,fluffy88,6,0.00038,347984,22.29128,1561077
6047,flynet,6,0.00038,347990,22.29166,1561077
6048,francois2metz,6,0.00038,347996,22.29205,1561077
6049,frederickplante,6,0.00038,348002,22.29243,1561077
6050,freename1,6,0.00038,348008,22.29281,1561077
6051,frostmourner,6,0.00038,348014,22.29320,1561077
6052,fulgas,6,0.00038,348020,22.29358,1561077
6053,fwal,6,0.00038,348026,22.29397,1561077
6054,galebm1004,6,0.00038,348032,22.29435,1561077
6055,galuszkak,6,0.00038,348038,22.29474,1561077
6056,gandikun,6,0.00038,348044,22.29512,1561077
6057,Ganonink,6,0.00038,348050,22.29550,1561077
6058,gebinic,6,0.00038,348056,22.29589,1561077
6059,gempain,6,0.00038,348062,22.29627,1561077
6060,GennadySpb,6,0.00038,348068,22.29666,1561077
6061,ge-o-rg,6,0.00038,348074,22.29704,1561077
6062,geVikrant,6,0.00038,348080,22.29743,1561077
6063,ghawkgu,6,0.00038,348086,22.29781,1561077
6064,gimler,6,0.00038,348092,22.29820,1561077
6065,giorgiosironi,6,0.00038,348098,22.29858,1561077
6066,Giusti,6,0.00038,348104,22.29896,1561077
6067,gizmomogwai,6,0.00038,348110,22.29935,1561077
6068,glukasiknuro,6,0.00038,348116,22.29973,1561077
6069,gongsu832,6,0.00038,348122,22.30012,1561077
6070,grandmore,6,0.00038,348128,22.30050,1561077
6071,grEvenX,6,0.00038,348134,22.30089,1561077
6072,grizzthedj,6,0.00038,348140,22.30127,1561077
6073,gtpark,6,0.00038,348146,22.30165,1561077
6074,guicholeo,6,0.00038,348152,22.30204,1561077
6075,guillaumeger,6,0.00038,348158,22.30242,1561077
6076,haithir,6,0.00038,348164,22.30281,1561077
6077,hakuna-matatah,6,0.00038,348170,22.30319,1561077
6078,hanalee-skytap,6,0.00038,348176,22.30358,1561077
6079,hanyongwoo,6,0.00038,348182,22.30396,1561077
6080,happyviral,6,0.00038,348188,22.30435,1561077
6081,hareldev,6,0.00038,348194,22.30473,1561077
6082,HarpreetChamdal,6,0.00038,348200,22.30511,1561077
6083,HarshaPTC,6,0.00038,348206,22.30550,1561077
6084,harveychow,6,0.00038,348212,22.30588,1561077
6085,hasanrashid,6,0.00038,348218,22.30627,1561077
6086,Hayyk,6,0.00038,348224,22.30665,1561077
6087,hedin-hiervard,6,0.00038,348230,22.30704,1561077
6088,Hemp0r,6,0.00038,348236,22.30742,1561077
6089,hetile-ssense,6,0.00038,348242,22.30780,1561077
6090,Hi-Fi,6,0.00038,348248,22.30819,1561077
6091,higginsci,6,0.00038,348254,22.30857,1561077
6092,hkbao,6,0.00038,348260,22.30896,1561077
6093,hkuersten,6,0.00038,348266,22.30934,1561077
6094,hmmachadocx,6,0.00038,348272,22.30973,1561077
6095,hoky841023,6,0.00038,348278,22.31011,1561077
6096,HolisticDeveloper,6,0.00038,348284,22.31049,1561077
6097,HouJiangtao,6,0.00038,348290,22.31088,1561077
6098,human33,6,0.00038,348296,22.31126,1561077
6099,hutson,6,0.00038,348302,22.31165,1561077
6100,iamahern,6,0.00038,348308,22.31203,1561077
6101,IanKemp,6,0.00038,348314,22.31242,1561077
6102,Idanatcox,6,0.00038,348320,22.31280,1561077
6103,ikari7789,6,0.00038,348326,22.31319,1561077
6104,ikorihn,6,0.00038,348332,22.31357,1561077
6105,ilx,6,0.00038,348338,22.31395,1561077
6106,impulse200,6,0.00038,348344,22.31434,1561077
6107,imrichardcole,6,0.00038,348350,22.31472,1561077
6108,imriz,6,0.00038,348356,22.31511,1561077
6109,Inetov,6,0.00038,348362,22.31549,1561077
6110,intelmatt,6,0.00038,348368,22.31588,1561077
6111,itaisanders,6,0.00038,348374,22.31626,1561077
6112,ITarkhov,6,0.00038,348380,22.31664,1561077
6113,IvanAnishchuk,6,0.00038,348386,22.31703,1561077
6114,J00MZ,6,0.00038,348392,22.31741,1561077
6115,JadyDJ,6,0.00038,348398,22.31780,1561077
6116,James-Chapman,6,0.00038,348404,22.31818,1561077
6117,JamesMahy,6,0.00038,348410,22.31857,1561077
6118,jameswtelfer,6,0.00038,348416,22.31895,1561077
6119,jamroks,6,0.00038,348422,22.31933,1561077
6120,janoobhandar,6,0.00038,348428,22.31972,1561077
6121,JanPatrickReibner,6,0.00038,348434,22.32010,1561077
6122,jantebeest,6,0.00038,348440,22.32049,1561077
6123,jaredcurtis,6,0.00038,348446,22.32087,1561077
6124,jaredj,6,0.00038,348452,22.32126,1561077
6125,jarosite,6,0.00038,348458,22.32164,1561077
6126,JarredParrettDickinson,6,0.00038,348464,22.32203,1561077
6127,jayaramsankara,6,0.00038,348470,22.32241,1561077
6128,jbnance,6,0.00038,348476,22.32279,1561077
6129,jchristheodore,6,0.00038,348482,22.32318,1561077
6130,jcppkkk,6,0.00038,348488,22.32356,1561077
6131,jdelagnes,6,0.00038,348494,22.32395,1561077
6132,JeanMarcSaad,6,0.00038,348500,22.32433,1561077
6133,jebentier,6,0.00038,348506,22.32472,1561077
6134,jeffkayser2,6,0.00038,348512,22.32510,1561077
6135,jeffret-bg,6,0.00038,348518,22.32548,1561077
6136,jereksel,6,0.00038,348524,22.32587,1561077
6137,jeremybryan,6,0.00038,348530,22.32625,1561077
6138,jeremyweber72,6,0.00038,348536,22.32664,1561077
6139,jeromepochat,6,0.00038,348542,22.32702,1561077
6140,jesse-houghton,6,0.00038,348548,22.32741,1561077
6141,jessejoe,6,0.00038,348554,22.32779,1561077
6142,jgedarovich,6,0.00038,348560,22.32817,1561077
6143,jimbair,6,0.00038,348566,22.32856,1561077
6144,jimmycasey,6,0.00038,348572,22.32894,1561077
6145,jimmy-ho,6,0.00038,348578,22.32933,1561077
6146,jjteo74,6,0.00038,348584,22.32971,1561077
6147,jkohrman,6,0.00038,348590,22.33010,1561077
6148,jleonelion,6,0.00038,348596,22.33048,1561077
6149,jluk-scms,6,0.00038,348602,22.33087,1561077
6150,jmlrt,6,0.00038,348608,22.33125,1561077
6151,jmpesp,6,0.00038,348614,22.33163,1561077
6152,jnazander,6,0.00038,348620,22.33202,1561077
6153,joachimprinzbach,6,0.00038,348626,22.33240,1561077
6154,joaomdiogo,6,0.00038,348632,22.33279,1561077
6155,joaoportela,6,0.00038,348638,22.33317,1561077
6156,JoaoPPCastelo,6,0.00038,348644,22.33356,1561077
6157,jofia,6,0.00038,348650,22.33394,1561077
6158,johankees,6,0.00038,348656,22.33432,1561077
6159,JohannesJaeger,6,0.00038,348662,22.33471,1561077
6160,jonathannewman,6,0.00038,348668,22.33509,1561077
6161,jordandev,6,0.00038,348674,22.33548,1561077
6162,jorgeelas,6,0.00038,348680,22.33586,1561077
6163,josb,6,0.00038,348686,22.33625,1561077
6164,Josbrafe,6,0.00038,348692,22.33663,1561077
6165,josh383451,6,0.00038,348698,22.33701,1561077
6166,josh-barker,6,0.00038,348704,22.33740,1561077
6167,joshshinn,6,0.00038,348710,22.33778,1561077
6168,josiahp,6,0.00038,348716,22.33817,1561077
6169,jpatterson-fastly,6,0.00038,348722,22.33855,1561077
6170,jpiccaluga,6,0.00038,348728,22.33894,1561077
6171,JPRuskin,6,0.00038,348734,22.33932,1561077
6172,jr200,6,0.00038,348740,22.33971,1561077
6173,jrarmstro,6,0.00038,348746,22.34009,1561077
6174,jrazgunas,6,0.00038,348752,22.34047,1561077
6175,jreese802,6,0.00038,348758,22.34086,1561077
6176,jrichman-r7,6,0.00038,348764,22.34124,1561077
6177,jrjohnson87,6,0.00038,348770,22.34163,1561077
6178,jrojassonatype,6,0.00038,348776,22.34201,1561077
6179,jschen3,6,0.00038,348782,22.34240,1561077
6180,jskjons,6,0.00038,348788,22.34278,1561077
6181,jsouth,6,0.00038,348794,22.34316,1561077
6182,Jszuser,6,0.00038,348800,22.34355,1561077
6183,julian-haase,6,0.00038,348806,22.34393,1561077
6184,juliantcook,6,0.00038,348812,22.34432,1561077
6185,JulienLajugie,6,0.00038,348818,22.34470,1561077
6186,justinsaliba,6,0.00038,348824,22.34509,1561077
6187,justyns,6,0.00038,348830,22.34547,1561077
6188,jwb,6,0.00038,348836,22.34585,1561077
6189,jxpearce-godaddy,6,0.00038,348842,22.34624,1561077
6190,Jyoti-Prakash01,6,0.00038,348848,22.34662,1561077
6191,kalarani-tw,6,0.00038,348854,22.34701,1561077
6192,kapfab,6,0.00038,348860,22.34739,1561077
6193,karanibm6,6,0.00038,348866,22.34778,1561077
6194,karanshah-browserstack,6,0.00038,348872,22.34816,1561077
6195,karliszigurs,6,0.00038,348878,22.34855,1561077
6196,karniemi,6,0.00038,348884,22.34893,1561077
6197,karthickvelu90,6,0.00038,348890,22.34931,1561077
6198,katrielt,6,0.00038,348896,22.34970,1561077
6199,kawaja,6,0.00038,348902,22.35008,1561077
6200,kbfastcat,6,0.00038,348908,22.35047,1561077
6201,kchrusciel,6,0.00038,348914,22.35085,1561077
6202,kdaud,6,0.00038,348920,22.35124,1561077
6203,keirbadger,6,0.00038,348926,22.35162,1561077
6204,kemuning,6,0.00038,348932,22.35200,1561077
6205,ken-ie,6,0.00038,348938,22.35239,1561077
6206,Kentzo,6,0.00038,348944,22.35277,1561077
6207,kepeket,6,0.00038,348950,22.35316,1561077
6208,KES777,6,0.00038,348956,22.35354,1561077
6209,kevb10,6,0.00038,348962,22.35393,1561077
6210,KevinChris7,6,0.00038,348968,22.35431,1561077
6211,kevinlin18,6,0.00038,348974,22.35469,1561077
6212,kha0s178,6,0.00038,348980,22.35508,1561077
6213,KhadijaAmmar,6,0.00038,348986,22.35546,1561077
6214,kirillsablin,6,0.00038,348992,22.35585,1561077
6215,klavan,6,0.00038,348998,22.35623,1561077
6216,kmoens,6,0.00038,349004,22.35662,1561077
6217,konetzed,6,0.00038,349010,22.35700,1561077
6218,KostaCitrix,6,0.00038,349016,22.35739,1561077
6219,koushartasneem,6,0.00038,349022,22.35777,1561077
6220,kranthisonuk,6,0.00038,349028,22.35815,1561077
6221,kressh,6,0.00038,349034,22.35854,1561077
6222,krishhpp4,6,0.00038,349040,22.35892,1561077
6223,krissell,6,0.00038,349046,22.35931,1561077
6224,KrissiK,6,0.00038,349052,22.35969,1561077
6225,ksg97031,6,0.00038,349058,22.36008,1561077
6226,ksully-execute,6,0.00038,349064,22.36046,1561077
6227,kugel-,6,0.00038,349070,22.36084,1561077
6228,kuilee,6,0.00038,349076,22.36123,1561077
6229,kummerer94,6,0.00038,349082,22.36161,1561077
6230,kwart,6,0.00038,349088,22.36200,1561077
6231,KyleJamesWalker,6,0.00038,349094,22.36238,1561077
6232,l8nite,6,0.00038,349100,22.36277,1561077
6233,laenco,6,0.00038,349106,22.36315,1561077
6234,LarsFronius,6,0.00038,349112,22.36353,1561077
6235,Larusso,6,0.00038,349118,22.36392,1561077
6236,latel,6,0.00038,349124,22.36430,1561077
6237,latituder,6,0.00038,349130,22.36469,1561077
6238,lboclboc,6,0.00038,349136,22.36507,1561077
6239,legolas,6,0.00038,349142,22.36546,1561077
6240,leoyim,6,0.00038,349148,22.36584,1561077
6241,lersouza,6,0.00038,349154,22.36623,1561077
6242,lessless,6,0.00038,349160,22.36661,1561077
6243,leszekchuchla,6,0.00038,349166,22.36699,1561077
6244,letsbringachange,6,0.00038,349172,22.36738,1561077
6245,letsrokk,6,0.00038,349178,22.36776,1561077
6246,letuyetvu3,6,0.00038,349184,22.36815,1561077
6247,Leviter,6,0.00038,349190,22.36853,1561077
6248,LewisHope,6,0.00038,349196,22.36892,1561077
6249,LiamMaru,6,0.00038,349202,22.36930,1561077
6250,lijingchun0,6,0.00038,349208,22.36968,1561077
6251,linkeal,6,0.00038,349214,22.37007,1561077
6252,linusfoldemo,6,0.00038,349220,22.37045,1561077
6253,linusgg,6,0.00038,349226,22.37084,1561077
6254,littlejo,6,0.00038,349232,22.37122,1561077
6255,liumazi,6,0.00038,349238,22.37161,1561077
6256,lmcdasm,6,0.00038,349244,22.37199,1561077
6257,lnformer,6,0.00038,349250,22.37237,1561077
6258,loheswaran,6,0.00038,349256,22.37276,1561077
6259,lokesh-webonise,6,0.00038,349262,22.37314,1561077
6260,longwave,6,0.00038,349268,22.37353,1561077
6261,lorainsu,6,0.00038,349274,22.37391,1561077
6262,Lothiraldan,6,0.00038,349280,22.37430,1561077
6263,Lovakush,6,0.00038,349286,22.37468,1561077
6264,lrpaquet-jive,6,0.00038,349292,22.37507,1561077
6265,lsouchard,6,0.00038,349298,22.37545,1561077
6266,luckysimek,6,0.00038,349304,22.37583,1561077
6267,lucymhdavies,6,0.00038,349310,22.37622,1561077
6268,LukasLuZoom,6,0.00038,349316,22.37660,1561077
6269,LukaszHerbet,6,0.00038,349322,22.37699,1561077
6270,lukaszun,6,0.00038,349328,22.37737,1561077
6271,luke-engle,6,0.00038,349334,22.37776,1561077
6272,lukenels,6,0.00038,349340,22.37814,1561077
6273,lusee88,6,0.00038,349346,22.37852,1561077
6274,lynxis,6,0.00038,349352,22.37891,1561077
6275,mabbas85,6,0.00038,349358,22.37929,1561077
6276,madhu1992blue,6,0.00038,349364,22.37968,1561077
6277,madmuffin1,6,0.00038,349370,22.38006,1561077
6278,magicianx,6,0.00038,349376,22.38045,1561077
6279,magruder85,6,0.00038,349382,22.38083,1561077
6280,mahi8061,6,0.00038,349388,22.38122,1561077
6281,mahsoud,6,0.00038,349394,22.38160,1561077
6282,mamat-wix,6,0.00038,349400,22.38198,1561077
6283,manjeet88,6,0.00038,349406,22.38237,1561077
6284,manojtr,6,0.00038,349412,22.38275,1561077
6285,manthanhd,6,0.00038,349418,22.38314,1561077
6286,manu844,6,0.00038,349424,22.38352,1561077
6287,marceldiass,6,0.00038,349430,22.38391,1561077
6288,MarcelNehring,6,0.00038,349436,22.38429,1561077
6289,marcosbento,6,0.00038,349442,22.38467,1561077
6290,marcusmaday,6,0.00038,349448,22.38506,1561077
6291,marcusrc,6,0.00038,349454,22.38544,1561077
6292,marekventur,6,0.00038,349460,22.38583,1561077
6293,marfenij,6,0.00038,349466,22.38621,1561077
6294,marius-balteanu,6,0.00038,349472,22.38660,1561077
6295,marklouiee,6,0.00038,349478,22.38698,1561077
6296,markmcnaughton,6,0.00038,349484,22.38736,1561077
6297,markphip,6,0.00038,349490,22.38775,1561077
6298,marufaytekin,6,0.00038,349496,22.38813,1561077
6299,marx-freedom,6,0.00038,349502,22.38852,1561077
6300,marziman,6,0.00038,349508,22.38890,1561077
6301,masics,6,0.00038,349514,22.38929,1561077
6302,maslakov,6,0.00038,349520,22.38967,1561077
6303,matankatz,6,0.00038,349526,22.39006,1561077
6304,mathieucoavoux,6,0.00038,349532,22.39044,1561077
6305,matiasgonzalocalvo,6,0.00038,349538,22.39082,1561077
6306,matihost,6,0.00038,349544,22.39121,1561077
6307,matir91,6,0.00038,349550,22.39159,1561077
6308,matpag,6,0.00038,349556,22.39198,1561077
6309,mattemoore,6,0.00038,349562,22.39236,1561077
6310,Matt-Gleich,6,0.00038,349568,22.39275,1561077
6311,matthewcmorgan,6,0.00038,349574,22.39313,1561077
6312,mattwilliams-stfc,6,0.00038,349580,22.39351,1561077
6313,mawulf,6,0.00038,349586,22.39390,1561077
6314,maxdanilov,6,0.00038,349592,22.39428,1561077
6315,maxock,6,0.00038,349598,22.39467,1561077
6316,MBalasubramanian,6,0.00038,349604,22.39505,1561077
6317,mbergo,6,0.00038,349610,22.39544,1561077
6318,mbirtwell,6,0.00038,349616,22.39582,1561077
6319,mdeguzis,6,0.00038,349622,22.39620,1561077
6320,mecm1993,6,0.00038,349628,22.39659,1561077
6321,meghalidhoble,6,0.00038,349634,22.39697,1561077
6322,melvyndekort,6,0.00038,349640,22.39736,1561077
6323,Memphiz,6,0.00038,349646,22.39774,1561077
6324,menaren,6,0.00038,349652,22.39813,1561077
6325,mercury200Hg,6,0.00038,349658,22.39851,1561077
6326,mestuddtc,6,0.00038,349664,22.39890,1561077
6327,metaspace,6,0.00038,349670,22.39928,1561077
6328,mew1033,6,0.00038,349676,22.39966,1561077
6329,mfreebairn-r7,6,0.00038,349682,22.40005,1561077
6330,mfuxi,6,0.00038,349688,22.40043,1561077
6331,mheil,6,0.00038,349694,22.40082,1561077
6332,mhp0rtal,6,0.00038,349700,22.40120,1561077
6333,michaelerobertsjr,6,0.00038,349706,22.40159,1561077
6334,michaeljb,6,0.00038,349712,22.40197,1561077
6335,michaelpaesold,6,0.00038,349718,22.40235,1561077
6336,michallaskowskivimn,6,0.00038,349724,22.40274,1561077
6337,MichelleTaylorRG,6,0.00038,349730,22.40312,1561077
6338,microhod,6,0.00038,349736,22.40351,1561077
6339,midnightrun,6,0.00038,349742,22.40389,1561077
6340,MikalaiHryniuk,6,0.00038,349748,22.40428,1561077
6341,mikeb01,6,0.00038,349754,22.40466,1561077
6342,mikeslattery,6,0.00038,349760,22.40504,1561077
6343,minche2,6,0.00038,349766,22.40543,1561077
6344,mjdavies,6,0.00038,349772,22.40581,1561077
6345,mjhoffman65,6,0.00038,349778,22.40620,1561077
6346,mk811,6,0.00038,349784,22.40658,1561077
6347,mkelliher3,6,0.00038,349790,22.40697,1561077
6348,mkjkec2005,6,0.00038,349796,22.40735,1561077
6349,mknezic,6,0.00038,349802,22.40774,1561077
6350,m-kostrzewa,6,0.00038,349808,22.40812,1561077
6351,mkryptis,6,0.00038,349814,22.40850,1561077
6352,mks-d,6,0.00038,349820,22.40889,1561077
6353,mlos,6,0.00038,349826,22.40927,1561077
6354,MMeent,6,0.00038,349832,22.40966,1561077
6355,mmn0o7,6,0.00038,349838,22.41004,1561077
6356,mmxkcd,6,0.00038,349844,22.41043,1561077
6357,modernNeo,6,0.00038,349850,22.41081,1561077
6358,moffatman,6,0.00038,349856,22.41119,1561077
6359,mohanisch-sixt,6,0.00038,349862,22.41158,1561077
6360,Moln,6,0.00038,349868,22.41196,1561077
6361,monkpit,6,0.00038,349874,22.41235,1561077
6362,monolithed,6,0.00038,349880,22.41273,1561077
6363,mononokehime,6,0.00038,349886,22.41312,1561077
6364,moon127,6,0.00038,349892,22.41350,1561077
6365,moritzbeck05,6,0.00038,349898,22.41388,1561077
6366,moritzplassnig,6,0.00038,349904,22.41427,1561077
6367,mosaic-nick,6,0.00038,349910,22.41465,1561077
6368,mostafaez,6,0.00038,349916,22.41504,1561077
6369,motofix,6,0.00038,349922,22.41542,1561077
6370,mpasha,6,0.00038,349928,22.41581,1561077
6371,mpbagot,6,0.00038,349934,22.41619,1561077
6372,mrferos,6,0.00038,349940,22.41658,1561077
6373,mriehl,6,0.00038,349946,22.41696,1561077
6374,mtb-xt,6,0.00038,349952,22.41734,1561077
6375,mtchavez,6,0.00038,349958,22.41773,1561077
6376,mtyurt,6,0.00038,349964,22.41811,1561077
6377,Mulder8472,6,0.00038,349970,22.41850,1561077
6378,Mulgikapsas,6,0.00038,349976,22.41888,1561077
6379,mwedgwood-rmn,6,0.00038,349982,22.41927,1561077
6380,mxkmp,6,0.00038,349988,22.41965,1561077
6381,myCodeHurts,6,0.00038,349994,22.42003,1561077
6382,MystWeb,6,0.00038,350000,22.42042,1561077
6383,nabla-c0d3,6,0.00038,350006,22.42080,1561077
6384,nagpalnipun22,6,0.00038,350012,22.42119,1561077
6385,nagyo,6,0.00038,350018,22.42157,1561077
6386,Nakilon,6,0.00038,350024,22.42196,1561077
6387,naoredricp,6,0.00038,350030,22.42234,1561077
6388,naosekine,6,0.00038,350036,22.42272,1561077
6389,nathanieltalbot,6,0.00038,350042,22.42311,1561077
6390,nathanwong91,6,0.00038,350048,22.42349,1561077
6391,natsen,6,0.00038,350054,22.42388,1561077
6392,nbutkowski,6,0.00038,350060,22.42426,1561077
6393,nehag83,6,0.00038,350066,22.42465,1561077
6394,nehakatta9,6,0.00038,350072,22.42503,1561077
6395,neilcx,6,0.00038,350078,22.42542,1561077
6396,nelsonsilva,6,0.00038,350084,22.42580,1561077
6397,nemui,6,0.00038,350090,22.42618,1561077
6398,Neppord,6,0.00038,350096,22.42657,1561077
6399,networkandcode,6,0.00038,350102,22.42695,1561077
6400,NEUerYZY,6,0.00038,350108,22.42734,1561077
6401,nh2,6,0.00038,350114,22.42772,1561077
6402,nicholasgcoles,6,0.00038,350120,22.42811,1561077
6403,nick1907,6,0.00038,350126,22.42849,1561077
6404,nickcatal,6,0.00038,350132,22.42887,1561077
6405,nidhi0512,6,0.00038,350138,22.42926,1561077
6406,nielslaukens,6,0.00038,350144,22.42964,1561077
6407,niemar,6,0.00038,350150,22.43003,1561077
6408,nieuwtje,6,0.00038,350156,22.43041,1561077
6409,nikeee,6,0.00038,350162,22.43080,1561077
6410,niketjsh,6,0.00038,350168,22.43118,1561077
6411,NITEMAN,6,0.00038,350174,22.43156,1561077
6412,njesper,6,0.00038,350180,22.43195,1561077
6413,nllarson,6,0.00038,350186,22.43233,1561077
6414,noamik,6,0.00038,350192,22.43272,1561077
6415,nocode99,6,0.00038,350198,22.43310,1561077
6416,Nooba,6,0.00038,350204,22.43349,1561077
6417,nop00,6,0.00038,350210,22.43387,1561077
6418,noralutz,6,0.00038,350216,22.43426,1561077
6419,noxo,6,0.00038,350222,22.43464,1561077
6420,npgarcia,6,0.00038,350228,22.43502,1561077
6421,ns-phennessy,6,0.00038,350234,22.43541,1561077
6422,nxmatic,6,0.00038,350240,22.43579,1561077
6423,nzlov,6,0.00038,350246,22.43618,1561077
6424,ofiry-tm,6,0.00038,350252,22.43656,1561077
6425,omervk,6,0.00038,350258,22.43695,1561077
6426,omitrowski,6,0.00038,350264,22.43733,1561077
6427,ondine,6,0.00038,350270,22.43771,1561077
6428,OOYUKIOO,6,0.00038,350276,22.43810,1561077
6429,Or-Gabay,6,0.00038,350282,22.43848,1561077
6430,osamahf,6,0.00038,350288,22.43887,1561077
6431,osipovaleks,6,0.00038,350294,22.43925,1561077
6432,Otmane-Guo,6,0.00038,350300,22.43964,1561077
6433,outime,6,0.00038,350306,22.44002,1561077
6434,pacificdolphins,6,0.00038,350312,22.44040,1561077
6435,pajuga,6,0.00038,350318,22.44079,1561077
6436,pappnase99,6,0.00038,350324,22.44117,1561077
6437,parasoft-sang,6,0.00038,350330,22.44156,1561077
6438,parasoftSupport,6,0.00038,350336,22.44194,1561077
6439,park896,6,0.00038,350342,22.44233,1561077
6440,parlacom,6,0.00038,350348,22.44271,1561077
6441,parveshmourya,6,0.00038,350354,22.44310,1561077
6442,pascalmartin,6,0.00038,350360,22.44348,1561077
6443,paschdan,6,0.00038,350366,22.44386,1561077
6444,patcito,6,0.00038,350372,22.44425,1561077
6445,patrickjoy,6,0.00038,350378,22.44463,1561077
6446,pauloneves,6,0.00038,350384,22.44502,1561077
6447,PaulRepo,6,0.00038,350390,22.44540,1561077
6448,pavenova,6,0.00038,350396,22.44579,1561077
6449,pbthorste,6,0.00038,350402,22.44617,1561077
6450,pdutta777,6,0.00038,350408,22.44655,1561077
6451,pengwynn,6,0.00038,350414,22.44694,1561077
6452,perfhector,6,0.00038,350420,22.44732,1561077
6453,perj,6,0.00038,350426,22.44771,1561077
6454,PFacheris,6,0.00038,350432,22.44809,1561077
6455,phathocker,6,0.00038,350438,22.44848,1561077
6456,phoellig,6,0.00038,350444,22.44886,1561077
6457,photoionized,6,0.00038,350450,22.44924,1561077
6458,piesarmin,6,0.00038,350456,22.44963,1561077
6459,Pietro-G,6,0.00038,350462,22.45001,1561077
6460,pjaitken,6,0.00038,350468,22.45040,1561077
6461,pkchuyen,6,0.00038,350474,22.45078,1561077
6462,pkruithofjr,6,0.00038,350480,22.45117,1561077
6463,pmarques,6,0.00038,350486,22.45155,1561077
6464,pmondal08,6,0.00038,350492,22.45194,1561077
6465,pmwar,6,0.00038,350498,22.45232,1561077
6466,poolik,6,0.00038,350504,22.45270,1561077
6467,PouncePenguin,6,0.00038,350510,22.45309,1561077
6468,ppi-agray,6,0.00038,350516,22.45347,1561077
6469,pplmx,6,0.00038,350522,22.45386,1561077
6470,prabusarav,6,0.00038,350528,22.45424,1561077
6471,premsompura,6,0.00038,350534,22.45463,1561077
6472,progrhyme,6,0.00038,350540,22.45501,1561077
6473,prondeau,6,0.00038,350546,22.45539,1561077
6474,provcristianmaluenda,6,0.00038,350552,22.45578,1561077
6475,pselden,6,0.00038,350558,22.45616,1561077
6476,pugnascotia,6,0.00038,350564,22.45655,1561077
6477,pvginkel,6,0.00038,350570,22.45693,1561077
6478,pwurbs,6,0.00038,350576,22.45732,1561077
6479,pzheng64,6,0.00038,350582,22.45770,1561077
6480,q13117god,6,0.00038,350588,22.45809,1561077
6481,qibint,6,0.00038,350594,22.45847,1561077
6482,qkflies,6,0.00038,350600,22.45885,1561077
6483,qllb,6,0.00038,350606,22.45924,1561077
6484,quliting,6,0.00038,350612,22.45962,1561077
6485,r00ger,6,0.00038,350618,22.46001,1561077
6486,radimch,6,0.00038,350624,22.46039,1561077
6487,rafatower,6,0.00038,350630,22.46078,1561077
6488,RahmadaniBayuAji,6,0.00038,350636,22.46116,1561077
6489,rahulkulkarniyahoo,6,0.00038,350642,22.46154,1561077
6490,rahvee,6,0.00038,350648,22.46193,1561077
6491,rainerfrey,6,0.00038,350654,22.46231,1561077
6492,rainmanh,6,0.00038,350660,22.46270,1561077
6493,rajanssingh,6,0.00038,350666,22.46308,1561077
6494,rajuvadarevu,6,0.00038,350672,22.46347,1561077
6495,RaRe2604,6,0.00038,350678,22.46385,1561077
6496,rasilvap,6,0.00038,350684,22.46423,1561077
6497,rbierman,6,0.00038,350690,22.46462,1561077
6498,ReadmeCritic,6,0.00038,350696,22.46500,1561077
6499,reasland,6,0.00038,350702,22.46539,1561077
6500,rebelopsio,6,0.00038,350708,22.46577,1561077
6501,Redirts,6,0.00038,350714,22.46616,1561077
6502,redonkulus,6,0.00038,350720,22.46654,1561077
6503,redoxate,6,0.00038,350726,22.46693,1561077
6504,remzix,6,0.00038,350732,22.46731,1561077
6505,renantmagalhaes,6,0.00038,350738,22.46769,1561077
6506,reniers-tiobe,6,0.00038,350744,22.46808,1561077
6507,rentallect,6,0.00038,350750,22.46846,1561077
6508,reshadatavid,6,0.00038,350756,22.46885,1561077
6509,rezaebrahimi1,6,0.00038,350762,22.46923,1561077
6510,rfftrifork,6,0.00038,350768,22.46962,1561077
6511,rhaendel,6,0.00038,350774,22.47000,1561077
6512,richardfriedman,6,0.00038,350780,22.47038,1561077
6513,riguy724,6,0.00038,350786,22.47077,1561077
6514,rimitchell,6,0.00038,350792,22.47115,1561077
6515,rinconedgar,6,0.00038,350798,22.47154,1561077
6516,riqbal-rocketlawyer,6,0.00038,350804,22.47192,1561077
6517,riqtest01,6,0.00038,350810,22.47231,1561077
6518,riuvshin,6,0.00038,350816,22.47269,1561077
6519,Rixium,6,0.00038,350822,22.47307,1561077
6520,rjbwtr,6,0.00038,350828,22.47346,1561077
6521,robcoward,6,0.00038,350834,22.47384,1561077
6522,robertflaig,6,0.00038,350840,22.47423,1561077
6523,RobertLemmens,6,0.00038,350846,22.47461,1561077
6524,robertohern83,6,0.00038,350852,22.47500,1561077
6525,robertoschwald,6,0.00038,350858,22.47538,1561077
6526,roee-landesman,6,0.00038,350864,22.47577,1561077
6527,RomanBoiarchuk,6,0.00038,350870,22.47615,1561077
6528,rousl4n,6,0.00038,350876,22.47653,1561077
6529,roxxette,6,0.00038,350882,22.47692,1561077
6530,RoyTinker,6,0.00038,350888,22.47730,1561077
6531,rpaasche,6,0.00038,350894,22.47769,1561077
6532,rskupnik,6,0.00038,350900,22.47807,1561077
6533,RubyLangdon,6,0.00038,350906,22.47846,1561077
6534,russellbarnes,6,0.00038,350912,22.47884,1561077
6535,rvelagam,6,0.00038,350918,22.47922,1561077
6536,rvernica,6,0.00038,350924,22.47961,1561077
6537,ryanaslett,6,0.00038,350930,22.47999,1561077
6538,ryaneberly,6,0.00038,350936,22.48038,1561077
6539,ryf123,6,0.00038,350942,22.48076,1561077
6540,RyPeck,6,0.00038,350948,22.48115,1561077
6541,saachinsiva,6,0.00038,350954,22.48153,1561077
6542,sagarailani,6,0.00038,350960,22.48191,1561077
6543,sager-tech,6,0.00038,350966,22.48230,1561077
6544,sajid2045,6,0.00038,350972,22.48268,1561077
6545,Sakuragi,6,0.00038,350978,22.48307,1561077
6546,sambenas,6,0.00038,350984,22.48345,1561077
6547,sameerElance,6,0.00038,350990,22.48384,1561077
6548,samgegr8,6,0.00038,350996,22.48422,1561077
6549,samsta,6,0.00038,351002,22.48461,1561077
6550,sandeepnagori87,6,0.00038,351008,22.48499,1561077
6551,SandunWebDev,6,0.00038,351014,22.48537,1561077
6552,sanrum21,6,0.00038,351020,22.48576,1561077
6553,santam85,6,0.00038,351026,22.48614,1561077
6554,SaranshBS,6,0.00038,351032,22.48653,1561077
6555,SaranshIam,6,0.00038,351038,22.48691,1561077
6556,sarath9985,6,0.00038,351044,22.48730,1561077
6557,Sargemck,6,0.00038,351050,22.48768,1561077
6558,scblur869,6,0.00038,351056,22.48806,1561077
6559,Schleuse,6,0.00038,351062,22.48845,1561077
6560,scoundril,6,0.00038,351068,22.48883,1561077
6561,scuba10steve,6,0.00038,351074,22.48922,1561077
6562,sduggisetty,6,0.00038,351080,22.48960,1561077
6563,seanhui1,6,0.00038,351086,22.48999,1561077
6564,sebastiangraf,6,0.00038,351092,22.49037,1561077
6565,SebastienRPOCH,6,0.00038,351098,22.49075,1561077
6566,SenthilkumarRasan,6,0.00038,351104,22.49114,1561077
6567,senyam08,6,0.00038,351110,22.49152,1561077
6568,SeriousMatt,6,0.00038,351116,22.49191,1561077
6569,shadamik,6,0.00038,351122,22.49229,1561077
6570,ShadowScorpion,6,0.00038,351128,22.49268,1561077
6571,shaikhu,6,0.00038,351134,22.49306,1561077
6572,shankerwangmiao,6,0.00038,351140,22.49345,1561077
6573,shaochieh,6,0.00038,351146,22.49383,1561077
6574,shar09,6,0.00038,351152,22.49421,1561077
6575,sharils,6,0.00038,351158,22.49460,1561077
6576,shashwot,6,0.00038,351164,22.49498,1561077
6577,shawnmartin,6,0.00038,351170,22.49537,1561077
6578,shayd3,6,0.00038,351176,22.49575,1561077
6579,shay-thompson,6,0.00038,351182,22.49614,1561077
6580,sheetalj2205,6,0.00038,351188,22.49652,1561077
6581,Shekharrajak,6,0.00038,351194,22.49690,1561077
6582,sheldonrong,6,0.00038,351200,22.49729,1561077
6583,Shorang,6,0.00038,351206,22.49767,1561077
6584,shudhanshh,6,0.00038,351212,22.49806,1561077
6585,Shunw19,6,0.00038,351218,22.49844,1561077
6586,SimonVleugels,6,0.00038,351224,22.49883,1561077
6587,siri06,6,0.00038,351230,22.49921,1561077
6588,skatlapa,6,0.00038,351236,22.49959,1561077
6589,Skilgarriff,6,0.00038,351242,22.49998,1561077
6590,slee1005,6,0.00038,351248,22.50036,1561077
6591,slikk66,6,0.00038,351254,22.50075,1561077
6592,Sluggerman,6,0.00038,351260,22.50113,1561077
6593,smarchandon,6,0.00038,351266,22.50152,1561077
6594,smartmarmot,6,0.00038,351272,22.50190,1561077
6595,smaslennikov,6,0.00038,351278,22.50229,1561077
6596,smattes,6,0.00038,351284,22.50267,1561077
6597,smazurov,6,0.00038,351290,22.50305,1561077
6598,smithhannahm,6,0.00038,351296,22.50344,1561077
6599,snake66,6,0.00038,351302,22.50382,1561077
6600,snehlatamohite,6,0.00038,351308,22.50421,1561077
6601,sneufeind,6,0.00038,351314,22.50459,1561077
6602,snipe122,6,0.00038,351320,22.50498,1561077
6603,sodre,6,0.00038,351326,22.50536,1561077
6604,sokratisg,6,0.00038,351332,22.50574,1561077
6605,spacanowski,6,0.00038,351338,22.50613,1561077
6606,speedyleion,6,0.00038,351344,22.50651,1561077
6607,Spinus1,6,0.00038,351350,22.50690,1561077
6608,splatch,6,0.00038,351356,22.50728,1561077
6609,srinivasgenesis,6,0.00038,351362,22.50767,1561077
6610,srtvasu,6,0.00038,351368,22.50805,1561077
6611,ssouris,6,0.00038,351374,22.50843,1561077
6612,stabenfeldt,6,0.00038,351380,22.50882,1561077
6613,staffanf,6,0.00038,351386,22.50920,1561077
6614,stalar,6,0.00038,351392,22.50959,1561077
6615,stanbos0815,6,0.00038,351398,22.50997,1561077
6616,stanchan,6,0.00038,351404,22.51036,1561077
6617,stanislr,6,0.00038,351410,22.51074,1561077
6618,stefangoor,6,0.00038,351416,22.51113,1561077
6619,stevenyeung,6,0.00038,351422,22.51151,1561077
6620,stieglma,6,0.00038,351428,22.51189,1561077
6621,stifm,6,0.00038,351434,22.51228,1561077
6622,stikonas,6,0.00038,351440,22.51266,1561077
6623,StinkyLord123,6,0.00038,351446,22.51305,1561077
6624,StKlug,6,0.00038,351452,22.51343,1561077
6625,stmlange,6,0.00038,351458,22.51382,1561077
6626,Strangerxxx,6,0.00038,351464,22.51420,1561077
6627,stronk7,6,0.00038,351470,22.51458,1561077
6628,stupchiy,6,0.00038,351476,22.51497,1561077
6629,Subaru365,6,0.00038,351482,22.51535,1561077
6630,sumitnigade,6,0.00038,351488,22.51574,1561077
6631,sunnypatel2141,6,0.00038,351494,22.51612,1561077
6632,sushnag22,6,0.00038,351500,22.51651,1561077
6633,sustmi,6,0.00038,351506,22.51689,1561077
6634,svenbovens,6,0.00038,351512,22.51727,1561077
6635,svsforsuccess,6,0.00038,351518,22.51766,1561077
6636,swapnilasawant,6,0.00038,351524,22.51804,1561077
6637,SylivanKenobi,6,0.00038,351530,22.51843,1561077
6638,sztomi,6,0.00038,351536,22.51881,1561077
6639,TaiSHiNet,6,0.00038,351542,22.51920,1561077
6640,TamasFlorin,6,0.00038,351548,22.51958,1561077
6641,Tampa,6,0.00038,351554,22.51997,1561077
6642,tanvirahmed2707,6,0.00038,351560,22.52035,1561077
6643,tarvitz,6,0.00038,351566,22.52073,1561077
6644,tashoyan,6,0.00038,351572,22.52112,1561077
6645,Tasseri,6,0.00038,351578,22.52150,1561077
6646,tbarda,6,0.00038,351584,22.52189,1561077
6647,tehzeklu,6,0.00038,351590,22.52227,1561077
6648,telegrapher,6,0.00038,351596,22.52266,1561077
6649,Termiton,6,0.00038,351602,22.52304,1561077
6650,terrdry,6,0.00038,351608,22.52342,1561077
6651,teruz,6,0.00038,351614,22.52381,1561077
6652,texnewmex,6,0.00038,351620,22.52419,1561077
6653,thebignet,6,0.00038,351626,22.52458,1561077
6654,the-it-jaeger,6,0.00038,351632,22.52496,1561077
6655,TheJokersThief,6,0.00038,351638,22.52535,1561077
6656,themakshter,6,0.00038,351644,22.52573,1561077
6657,TheTechOddBug,6,0.00038,351650,22.52611,1561077
6658,TheUbuntuGuy,6,0.00038,351656,22.52650,1561077
6659,thomasKalmar,6,0.00038,351662,22.52688,1561077
6660,thomasnal,6,0.00038,351668,22.52727,1561077
6661,thommelutten,6,0.00038,351674,22.52765,1561077
6662,thopiekar,6,0.00038,351680,22.52804,1561077
6663,threepistons,6,0.00038,351686,22.52842,1561077
6664,Tibo75,6,0.00038,351692,22.52881,1561077
6665,tiendungitd,6,0.00038,351698,22.52919,1561077
6666,tiger5226,6,0.00038,351704,22.52957,1561077
6667,timorohwedder,6,0.00038,351710,22.52996,1561077
6668,Timoses,6,0.00038,351716,22.53034,1561077
6669,timpeeters,6,0.00038,351722,22.53073,1561077
6670,tirelibirefe,6,0.00038,351728,22.53111,1561077
6671,tizki,6,0.00038,351734,22.53150,1561077
6672,tkaitoh,6,0.00038,351740,22.53188,1561077
6673,tmad,6,0.00038,351746,22.53226,1561077
6674,TobiasMeyster,6,0.00038,351752,22.53265,1561077
6675,tobias-trozowski,6,0.00038,351758,22.53303,1561077
6676,tofir,6,0.00038,351764,22.53342,1561077
6677,tom24d,6,0.00038,351770,22.53380,1561077
6678,tomasvcaldas,6,0.00038,351776,22.53419,1561077
6679,tomav,6,0.00038,351782,22.53457,1561077
6680,tomecho,6,0.00038,351788,22.53496,1561077
6681,Tommigun1980,6,0.00038,351794,22.53534,1561077
6682,tommyd3mdi,6,0.00038,351800,22.53572,1561077
6683,TommyM,6,0.00038,351806,22.53611,1561077
6684,tpbradt,6,0.00038,351812,22.53649,1561077
6685,Trii,6,0.00038,351818,22.53688,1561077
6686,trudesea,6,0.00038,351824,22.53726,1561077
6687,tsologub,6,0.00038,351830,22.53765,1561077
6688,tsusadivyago,6,0.00038,351836,22.53803,1561077
6689,txynidakis,6,0.00038,351842,22.53841,1561077
6690,tycoonm,6,0.00038,351848,22.53880,1561077
6691,u3shit,6,0.00038,351854,22.53918,1561077
6692,ubershmekel,6,0.00038,351860,22.53957,1561077
6693,uday4923,6,0.00038,351866,22.53995,1561077
6694,ueberhammDesign,6,0.00038,351872,22.54034,1561077
6695,ugurkanyenigun,6,0.00038,351878,22.54072,1561077
6696,ukuko,6,0.00038,351884,22.54110,1561077
6697,undead-osiris,6,0.00038,351890,22.54149,1561077
6698,uralsemih,6,0.00038,351896,22.54187,1561077
6699,username-is-too-long,6,0.00038,351902,22.54226,1561077
6700,vadeg,6,0.00038,351908,22.54264,1561077
6701,vadzay,6,0.00038,351914,22.54303,1561077
6702,ValdesChe,6,0.00038,351920,22.54341,1561077
6703,vamsidhar5434,6,0.00038,351926,22.54380,1561077
6704,vanta,6,0.00038,351932,22.54418,1561077
6705,vedant-z,6,0.00038,351938,22.54456,1561077
6706,venkateshjenkins,6,0.00038,351944,22.54495,1561077
6707,venturaville,6,0.00038,351950,22.54533,1561077
6708,Veve2,6,0.00038,351956,22.54572,1561077
6709,vgokul984,6,0.00038,351962,22.54610,1561077
6710,victimsnino,6,0.00038,351968,22.54649,1561077
6711,vijaychandra24,6,0.00038,351974,22.54687,1561077
6712,VijayKumarMidde,6,0.00038,351980,22.54725,1561077
6713,vikash-avid,6,0.00038,351986,22.54764,1561077
6714,Vilsol,6,0.00038,351992,22.54802,1561077
6715,Vincent1984,6,0.00038,351998,22.54841,1561077
6716,vishnujanardhanan,6,0.00038,352004,22.54879,1561077
6717,vish-ptl,6,0.00038,352010,22.54918,1561077
6718,vishveshv,6,0.00038,352016,22.54956,1561077
6719,visit1985,6,0.00038,352022,22.54994,1561077
6720,vitalykarasik,6,0.00038,352028,22.55033,1561077
6721,vitprakhar,6,0.00038,352034,22.55071,1561077
6722,vivekbugale,6,0.00038,352040,22.55110,1561077
6723,vivian-src,6,0.00038,352046,22.55148,1561077
6724,VkyHive,6,0.00038,352052,22.55187,1561077
6725,vmi,6,0.00038,352058,22.55225,1561077
6726,vojtechsokol,6,0.00038,352064,22.55264,1561077
6727,VonC,6,0.00038,352070,22.55302,1561077
6728,v-tugude,6,0.00038,352076,22.55340,1561077
6729,vvanholl,6,0.00038,352082,22.55379,1561077
6730,vvanouytsel,6,0.00038,352088,22.55417,1561077
6731,vwyuheng,6,0.00038,352094,22.55456,1561077
6732,vzabauski,6,0.00038,352100,22.55494,1561077
6733,walterk82,6,0.00038,352106,22.55533,1561077
6734,wangxiang5050,6,0.00038,352112,22.55571,1561077
6735,wcheang,6,0.00038,352118,22.55609,1561077
6736,WebDucer,6,0.00038,352124,22.55648,1561077
6737,webvictim,6,0.00038,352130,22.55686,1561077
6738,wedge-jarrad,6,0.00038,352136,22.55725,1561077
6739,weiguolau,6,0.00038,352142,22.55763,1561077
6740,wendtek,6,0.00038,352148,22.55802,1561077
6741,wenduwan,6,0.00038,352154,22.55840,1561077
6742,wendyyy,6,0.00038,352160,22.55878,1561077
6743,wfsaxton,6,0.00038,352166,22.55917,1561077
6744,wharfedale01,6,0.00038,352172,22.55955,1561077
6745,whren,6,0.00038,352178,22.55994,1561077
6746,willdeberry,6,0.00038,352184,22.56032,1561077
6747,wlbrough,6,0.00038,352190,22.56071,1561077
6748,workcjl,6,0.00038,352196,22.56109,1561077
6749,wozjac,6,0.00038,352202,22.56148,1561077
6750,wpc009,6,0.00038,352208,22.56186,1561077
6751,WraithCadmus,6,0.00038,352214,22.56224,1561077
6752,wykapedia,6,0.00038,352220,22.56263,1561077
6753,wyw,6,0.00038,352226,22.56301,1561077
6754,xabolcs,6,0.00038,352232,22.56340,1561077
6755,xaviou,6,0.00038,352238,22.56378,1561077
6756,xiaobaixurc,6,0.00038,352244,22.56417,1561077
6757,xinz0526,6,0.00038,352250,22.56455,1561077
6758,y4h006969,6,0.00038,352256,22.56493,1561077
6759,yarps95,6,0.00038,352262,22.56532,1561077
6760,yashcho,6,0.00038,352268,22.56570,1561077
6761,yemazon,6,0.00038,352274,22.56609,1561077
6762,ymougenel,6,0.00038,352280,22.56647,1561077
6763,yoyobbi,6,0.00038,352286,22.56686,1561077
6764,yshk-mrt,6,0.00038,352292,22.56724,1561077
6765,yugaa22,6,0.00038,352298,22.56762,1561077
6766,yukpun,6,0.00038,352304,22.56801,1561077
6767,yuri1969,6,0.00038,352310,22.56839,1561077
6768,yyunk,6,0.00038,352316,22.56878,1561077
6769,zarbis,6,0.00038,352322,22.56916,1561077
6770,zcicala,6,0.00038,352328,22.56955,1561077
6771,zerojk,6,0.00038,352334,22.56993,1561077
6772,Zevran,6,0.00038,352340,22.57032,1561077
6773,zingdle,6,0.00038,352346,22.57070,1561077
6774,zlippard,6,0.00038,352352,22.57108,1561077
6775,znerd,6,0.00038,352358,22.57147,1561077
6776,zops,6,0.00038,352364,22.57185,1561077
6777,zsjohny,6,0.00038,352370,22.57224,1561077
6778,zslabs,6,0.00038,352376,22.57262,1561077
6779,zwx168238,6,0.00038,352382,22.57301,1561077
6780,0x4a616e,5,0.00032,352387,22.57333,1561077
6781,33man,5,0.00032,352392,22.57365,1561077
6782,aacebedo,5,0.00032,352397,22.57397,1561077
6783,Aaronwang81,5,0.00032,352402,22.57429,1561077
6784,AaronZurawski,5,0.00032,352407,22.57461,1561077
6785,aatarasoff,5,0.00032,352412,22.57493,1561077
6786,aayore,5,0.00032,352417,22.57525,1561077
6787,abbec,5,0.00032,352422,22.57557,1561077
6788,abhishek-choudhury-callhub,5,0.00032,352427,22.57589,1561077
6789,Acaceres1996,5,0.00032,352432,22.57621,1561077
6790,acwwat,5,0.00032,352437,22.57653,1561077
6791,adamsmith448,5,0.00032,352442,22.57685,1561077
6792,adamtrousdale,5,0.00032,352447,22.57717,1561077
6793,adamwasila,5,0.00032,352452,22.57749,1561077
6794,adelmoradian,5,0.00032,352457,22.57781,1561077
6795,adini121,5,0.00032,352462,22.57813,1561077
6796,admoriarty,5,0.00032,352467,22.57845,1561077
6797,adomenech73,5,0.00032,352472,22.57877,1561077
6798,adrai,5,0.00032,352477,22.57909,1561077
6799,adrianmusante,5,0.00032,352482,22.57941,1561077
6800,adunderwood,5,0.00032,352487,22.57973,1561077
6801,aehlke,5,0.00032,352492,22.58005,1561077
6802,affixalex,5,0.00032,352497,22.58037,1561077
6803,Afterglow,5,0.00032,352502,22.58069,1561077
6804,afuchrisma,5,0.00032,352507,22.58101,1561077
6805,agrawalsmart7,5,0.00032,352512,22.58133,1561077
6806,aha-oretama,5,0.00032,352517,22.58165,1561077
6807,ahmadsyafrudin,5,0.00032,352522,22.58197,1561077
6808,aikebah,5,0.00032,352527,22.58229,1561077
6809,aikidave,5,0.00032,352532,22.58261,1561077
6810,airwolfnh,5,0.00032,352537,22.58293,1561077
6811,alasch2,5,0.00032,352542,22.58326,1561077
6812,alb777,5,0.00032,352547,22.58358,1561077
6813,albertinisg,5,0.00032,352552,22.58390,1561077
6814,albertocavalcante,5,0.00032,352557,22.58422,1561077
6815,Aldiuser,5,0.00032,352562,22.58454,1561077
6816,alejandroandreu,5,0.00032,352567,22.58486,1561077
6817,alekseiko,5,0.00032,352572,22.58518,1561077
6818,alex-anto,5,0.00032,352577,22.58550,1561077
6819,alexhopeoconnor,5,0.00032,352582,22.58582,1561077
6820,AlexKondrat,5,0.00032,352587,22.58614,1561077
6821,AlexRoberts,5,0.00032,352592,22.58646,1561077
6822,alfsender,5,0.00032,352597,22.58678,1561077
6823,alkuzad,5,0.00032,352602,22.58710,1561077
6824,almalki,5,0.00032,352607,22.58742,1561077
6825,almostjulian,5,0.00032,352612,22.58774,1561077
6826,alsenydiallo,5,0.00032,352617,22.58806,1561077
6827,amasok,5,0.00032,352622,22.58838,1561077
6828,amayer5125,5,0.00032,352627,22.58870,1561077
6829,ambrons,5,0.00032,352632,22.58902,1561077
6830,amcanirn,5,0.00032,352637,22.58934,1561077
6831,ameir,5,0.00032,352642,22.58966,1561077
6832,AmeyaJoshi1,5,0.00032,352647,22.58998,1561077
6833,amin224,5,0.00032,352652,22.59030,1561077
6834,amitlalani,5,0.00032,352657,22.59062,1561077
6835,amit-o,5,0.00032,352662,22.59094,1561077
6836,amoratti,5,0.00032,352667,22.59126,1561077
6837,amritb,5,0.00032,352672,22.59158,1561077
6838,amybachir,5,0.00032,352677,22.59190,1561077
6839,an1ket,5,0.00032,352682,22.59222,1561077
6840,anandka,5,0.00032,352687,22.59254,1561077
6841,anderson-dev,5,0.00032,352692,22.59286,1561077
6842,andpopov,5,0.00032,352697,22.59318,1561077
6843,AndreasBoehme,5,0.00032,352702,22.59350,1561077
6844,AndreasR92,5,0.00032,352707,22.59382,1561077
6845,Andrei94,5,0.00032,352712,22.59414,1561077
6846,andrewcharnley,5,0.00032,352717,22.59447,1561077
6847,andridzi,5,0.00032,352722,22.59479,1561077
6848,andrisro,5,0.00032,352727,22.59511,1561077
6849,andyhopp,5,0.00032,352732,22.59543,1561077
6850,anentropic,5,0.00032,352737,22.59575,1561077
6851,angelo-loria,5,0.00032,352742,22.59607,1561077
6852,AniketSK,5,0.00032,352747,22.59639,1561077
6853,ankuo,5,0.00032,352752,22.59671,1561077
6854,anmiralles,5,0.00032,352757,22.59703,1561077
6855,anoopmsivadas,5,0.00032,352762,22.59735,1561077
6856,AnotherStream,5,0.00032,352767,22.59767,1561077
6857,anouskastreets,5,0.00032,352772,22.59799,1561077
6858,antdrums,5,0.00032,352777,22.59831,1561077
6859,antoinetran,5,0.00032,352782,22.59863,1561077
6860,antoninBr,5,0.00032,352787,22.59895,1561077
6861,antonlindahlcevt,5,0.00032,352792,22.59927,1561077
6862,apotterri,5,0.00032,352797,22.59959,1561077
6863,applicatif-kilpro,5,0.00032,352802,22.59991,1561077
6864,arafatmohammed,5,0.00032,352807,22.60023,1561077
6865,ardakuyumcu,5,0.00032,352812,22.60055,1561077
6866,arghyadeep-k,5,0.00032,352817,22.60087,1561077
6867,arhohuttunen,5,0.00032,352822,22.60119,1561077
6868,arielman,5,0.00032,352827,22.60151,1561077
6869,arilivigni,5,0.00032,352832,22.60183,1561077
6870,arknoll,5,0.00032,352837,22.60215,1561077
6871,arpitgold,5,0.00032,352842,22.60247,1561077
6872,arranbartish,5,0.00032,352847,22.60279,1561077
6873,arsenalpoll,5,0.00032,352852,22.60311,1561077
6874,ArshiArora,5,0.00032,352857,22.60343,1561077
6875,arungitan,5,0.00032,352862,22.60375,1561077
6876,asbachb,5,0.00032,352867,22.60407,1561077
6877,askannon,5,0.00032,352872,22.60439,1561077
6878,astlock,5,0.00032,352877,22.60471,1561077
6879,astrobob,5,0.00032,352882,22.60503,1561077
6880,ataillefer,5,0.00032,352887,22.60536,1561077
6881,athornz,5,0.00032,352892,22.60568,1561077
6882,atlassian-bbs,5,0.00032,352897,22.60600,1561077
6883,atodmal,5,0.00032,352902,22.60632,1561077
6884,attachmentgenie,5,0.00032,352907,22.60664,1561077
6885,avatsyain,5,0.00032,352912,22.60696,1561077
6886,aviadcye,5,0.00032,352917,22.60728,1561077
6887,awaddell,5,0.00032,352922,22.60760,1561077
6888,aysahu,5,0.00032,352927,22.60792,1561077
6889,azuchi,5,0.00032,352932,22.60824,1561077
6890,bablushaw23,5,0.00032,352937,22.60856,1561077
6891,Badbond,5,0.00032,352942,22.60888,1561077
6892,badsector3,5,0.00032,352947,22.60920,1561077
6893,bagutzu,5,0.00032,352952,22.60952,1561077
6894,bakuppus,5,0.00032,352957,22.60984,1561077
6895,balakine,5,0.00032,352962,22.61016,1561077
6896,bamthomas,5,0.00032,352967,22.61048,1561077
6897,Barathwaja,5,0.00032,352972,22.61080,1561077
6898,barrymac,5,0.00032,352977,22.61112,1561077
6899,bartleboeuf,5,0.00032,352982,22.61144,1561077
6900,bartmeuris,5,0.00032,352987,22.61176,1561077
6901,baskar030,5,0.00032,352992,22.61208,1561077
6902,bastiaanb,5,0.00032,352997,22.61240,1561077
6903,batterseapower,5,0.00032,353002,22.61272,1561077
6904,bbuerger,5,0.00032,353007,22.61304,1561077
6905,bdominguez,5,0.00032,353012,22.61336,1561077
6906,beamerkun,5,0.00032,353017,22.61368,1561077
6907,behrangsa,5,0.00032,353022,22.61400,1561077
6908,benbrummer,5,0.00032,353027,22.61432,1561077
6909,BendeckDavid,5,0.00032,353032,22.61464,1561077
6910,benfiedler,5,0.00032,353037,22.61496,1561077
6911,benh57,5,0.00032,353042,22.61528,1561077
6912,benhumphreys,5,0.00032,353047,22.61560,1561077
6913,benichismo,5,0.00032,353052,22.61592,1561077
6914,BenjaminCCross,5,0.00032,353057,22.61625,1561077
6915,bentemple,5,0.00032,353062,22.61657,1561077
6916,benwicks,5,0.00032,353067,22.61689,1561077
6917,benzman81,5,0.00032,353072,22.61721,1561077
6918,bernardgut,5,0.00032,353077,22.61753,1561077
6919,bertfraterman,5,0.00032,353082,22.61785,1561077
6920,best4test,5,0.00032,353087,22.61817,1561077
6921,bhagathkumar,5,0.00032,353092,22.61849,1561077
6922,bhanteem,5,0.00032,353097,22.61881,1561077
6923,bheiskell,5,0.00032,353102,22.61913,1561077
6924,bigjew92,5,0.00032,353107,22.61945,1561077
6925,bigtrak,5,0.00032,353112,22.61977,1561077
6926,bigunyak,5,0.00032,353117,22.62009,1561077
6927,bilbothebaggins,5,0.00032,353122,22.62041,1561077
6928,billiford,5,0.00032,353127,22.62073,1561077
6929,billwang-au,5,0.00032,353132,22.62105,1561077
6930,Binternet,5,0.00032,353137,22.62137,1561077
6931,bischoje,5,0.00032,353142,22.62169,1561077
6932,bkconrad,5,0.00032,353147,22.62201,1561077
6933,Bkocsan,5,0.00032,353152,22.62233,1561077
6934,BlackFLX,5,0.00032,353157,22.62265,1561077
6935,bleuchtang,5,0.00032,353162,22.62297,1561077
6936,blonghurst93,5,0.00032,353167,22.62329,1561077
6937,bmannix,5,0.00032,353172,22.62361,1561077
6938,bmerry,5,0.00032,353177,22.62393,1561077
6939,bnf2si,5,0.00032,353182,22.62425,1561077
6940,bou1der,5,0.00032,353187,22.62457,1561077
6941,bowlesns,5,0.00032,353192,22.62489,1561077
6942,boyarsky,5,0.00032,353197,22.62521,1561077
6943,bphalak,5,0.00032,353202,22.62553,1561077
6944,bpmarinho,5,0.00032,353207,22.62585,1561077
6945,bradical,5,0.00032,353212,22.62617,1561077
6946,brandocorp,5,0.00032,353217,22.62649,1561077
6947,breunigs,5,0.00032,353222,22.62681,1561077
6948,BrianAker,5,0.00032,353227,22.62713,1561077
6949,brianmisle,5,0.00032,353232,22.62746,1561077
6950,briannaf,5,0.00032,353237,22.62778,1561077
6951,brockoffdev,5,0.00032,353242,22.62810,1561077
6952,brunsgaard,5,0.00032,353247,22.62842,1561077
6953,bryanburke,5,0.00032,353252,22.62874,1561077
6954,buzztaiki,5,0.00032,353257,22.62906,1561077
6955,bwilliams7,5,0.00032,353262,22.62938,1561077
6956,bwolin,5,0.00032,353267,22.62970,1561077
6957,c5haw,5,0.00032,353272,22.63002,1561077
6958,caitlin615,5,0.00032,353277,22.63034,1561077
6959,calvinatintel,5,0.00032,353282,22.63066,1561077
6960,calvinatnvidia,5,0.00032,353287,22.63098,1561077
6961,captmorgan,5,0.00032,353292,22.63130,1561077
6962,CarlitosDroid,5,0.00032,353297,22.63162,1561077
6963,carlmon,5,0.00032,353302,22.63194,1561077
6964,carstenlenz,5,0.00032,353307,22.63226,1561077
6965,carstensh,5,0.00032,353312,22.63258,1561077
6966,castrapel,5,0.00032,353317,22.63290,1561077
6967,ccactus,5,0.00032,353322,22.63322,1561077
6968,cccCody,5,0.00032,353327,22.63354,1561077
6969,cdupont,5,0.00032,353332,22.63386,1561077
6970,ceqi,5,0.00032,353337,22.63418,1561077
6971,cfsb-jrose,5,0.00032,353342,22.63450,1561077
6972,cgperez,5,0.00032,353347,22.63482,1561077
6973,Chabane,5,0.00032,353352,22.63514,1561077
6974,ChakaZulu,5,0.00032,353357,22.63546,1561077
6975,Chandu-4444,5,0.00032,353362,22.63578,1561077
6976,Checksumz,5,0.00032,353367,22.63610,1561077
6977,chenfengxj,5,0.00032,353372,22.63642,1561077
6978,chenxiaolong,5,0.00032,353377,22.63674,1561077
6979,ChenZhangg,5,0.00032,353382,22.63706,1561077
6980,chetan,5,0.00032,353387,22.63738,1561077
6981,chillum,5,0.00032,353392,22.63770,1561077
6982,chinshr,5,0.00032,353397,22.63802,1561077
6983,Chocrates,5,0.00032,353402,22.63835,1561077
6984,chrismaes87,5,0.00032,353407,22.63867,1561077
6985,chrismathis,5,0.00032,353412,22.63899,1561077
6986,chrissena,5,0.00032,353417,22.63931,1561077
6987,christek91,5,0.00032,353422,22.63963,1561077
6988,christopher-hicks-techlabs,5,0.00032,353427,22.63995,1561077
6989,christopherney,5,0.00032,353432,22.64027,1561077
6990,christophwalpert,5,0.00032,353437,22.64059,1561077
6991,christosarvanitis,5,0.00032,353442,22.64091,1561077
6992,chriswhite199,5,0.00032,353447,22.64123,1561077
6993,chrisyang0604,5,0.00032,353452,22.64155,1561077
6994,cierzniak,5,0.00032,353457,22.64187,1561077
6995,citrus1981,5,0.00032,353462,22.64219,1561077
6996,ckulla,5,0.00032,353467,22.64251,1561077
6997,clabu,5,0.00032,353472,22.64283,1561077
6998,claflico,5,0.00032,353477,22.64315,1561077
6999,clausfod,5,0.00032,353482,22.64347,1561077
7000,clechasseur,5,0.00032,353487,22.64379,1561077
7001,cleeoak9,5,0.00032,353492,22.64411,1561077
7002,clonejo,5,0.00032,353497,22.64443,1561077
7003,cloudvar,5,0.00032,353502,22.64475,1561077
7004,cmadam,5,0.00032,353507,22.64507,1561077
7005,cml37,5,0.00032,353512,22.64539,1561077
7006,cnacu6o,5,0.00032,353517,22.64571,1561077
7007,codacy-badger,5,0.00032,353522,22.64603,1561077
7008,CodingFanSteve,5,0.00032,353527,22.64635,1561077
7009,codingtim,5,0.00032,353532,22.64667,1561077
7010,c-okelly,5,0.00032,353537,22.64699,1561077
7011,colincgn,5,0.00032,353542,22.64731,1561077
7012,colltie,5,0.00032,353547,22.64763,1561077
7013,comdeng,5,0.00032,353552,22.64795,1561077
7014,comerford,5,0.00032,353557,22.64827,1561077
7015,comutt,5,0.00032,353562,22.64859,1561077
7016,Conrad-T-Pino,5,0.00032,353567,22.64891,1561077
7017,contextshuffling,5,0.00032,353572,22.64924,1561077
7018,corporate-gadfly,5,0.00032,353577,22.64956,1561077
7019,coryasilva,5,0.00032,353582,22.64988,1561077
7020,coyoteecd,5,0.00032,353587,22.65020,1561077
7021,cpsburca,5,0.00032,353592,22.65052,1561077
7022,craigemery,5,0.00032,353597,22.65084,1561077
7023,craig-rueda,5,0.00032,353602,22.65116,1561077
7024,craigwatson,5,0.00032,353607,22.65148,1561077
7025,crgilman,5,0.00032,353612,22.65180,1561077
7026,cristianbalan,5,0.00032,353617,22.65212,1561077
7027,criztovyl,5,0.00032,353622,22.65244,1561077
7028,cross-wind,5,0.00032,353627,22.65276,1561077
7029,cr-zlilaharon,5,0.00032,353632,22.65308,1561077
7030,cswatt,5,0.00032,353637,22.65340,1561077
7031,csxiaoshang,5,0.00032,353642,22.65372,1561077
7032,cthorne66,5,0.00032,353647,22.65404,1561077
7033,cwildman,5,0.00032,353652,22.65436,1561077
7034,cxehud,5,0.00032,353657,22.65468,1561077
7035,cxEyala,5,0.00032,353662,22.65500,1561077
7036,cy214,5,0.00032,353667,22.65532,1561077
7037,CyberGeni,5,0.00032,353672,22.65564,1561077
7038,cynipe,5,0.00032,353677,22.65596,1561077
7039,czerwinski1977,5,0.00032,353682,22.65628,1561077
7040,d0nt-panic,5,0.00032,353687,22.65660,1561077
7041,D0rmouse,5,0.00032,353692,22.65692,1561077
7042,d11ahirst,5,0.00032,353697,22.65724,1561077
7043,d3adp007,5,0.00032,353702,22.65756,1561077
7044,Daggerphobia,5,0.00032,353707,22.65788,1561077
7045,dagwieers,5,0.00032,353712,22.65820,1561077
7046,damc-dev,5,0.00032,353717,22.65852,1561077
7047,danielbecroft,5,0.00032,353722,22.65884,1561077
7048,danieldatri,5,0.00032,353727,22.65916,1561077
7049,danielev04,5,0.00032,353732,22.65948,1561077
7050,danielluke,5,0.00032,353737,22.65980,1561077
7051,DanRoeSparks,5,0.00032,353742,22.66013,1561077
7052,darkounet,5,0.00032,353747,22.66045,1561077
7053,daronz,5,0.00032,353752,22.66077,1561077
7054,darraghs,5,0.00032,353757,22.66109,1561077
7055,DarrenJiang13,5,0.00032,353762,22.66141,1561077
7056,Darthholi,5,0.00032,353767,22.66173,1561077
7057,dave-tock,5,0.00032,353772,22.66205,1561077
7058,david-mntl,5,0.00032,353777,22.66237,1561077
7059,davidsayers,5,0.00032,353782,22.66269,1561077
7060,daymade,5,0.00032,353787,22.66301,1561077
7061,dcfsc,5,0.00032,353792,22.66333,1561077
7062,dcherniv,5,0.00032,353797,22.66365,1561077
7063,Dece,5,0.00032,353802,22.66397,1561077
7064,deepirms2619,5,0.00032,353807,22.66429,1561077
7065,degaglani,5,0.00032,353812,22.66461,1561077
7066,degilq,5,0.00032,353817,22.66493,1561077
7067,denisa,5,0.00032,353822,22.66525,1561077
7068,DennisWarren,5,0.00032,353827,22.66557,1561077
7069,DerPauli,5,0.00032,353832,22.66589,1561077
7070,derryx,5,0.00032,353837,22.66621,1561077
7071,devblueray,5,0.00032,353842,22.66653,1561077
7072,devops-team-92,5,0.00032,353847,22.66685,1561077
7073,dfuessl,5,0.00032,353852,22.66717,1561077
7074,dgutzmann,5,0.00032,353857,22.66749,1561077
7075,dhabolt,5,0.00032,353862,22.66781,1561077
7076,dhubbard-ag,5,0.00032,353867,22.66813,1561077
7077,DieBauer,5,0.00032,353872,22.66845,1561077
7078,dilbertside,5,0.00032,353877,22.66877,1561077
7079,dispalt,5,0.00032,353882,22.66909,1561077
7080,DivvSaxena,5,0.00032,353887,22.66941,1561077
7081,divyank31,5,0.00032,353892,22.66973,1561077
7082,dkothari777,5,0.00032,353897,22.67005,1561077
7083,dlapanik,5,0.00032,353902,22.67037,1561077
7084,dnalain,5,0.00032,353907,22.67069,1561077
7085,dniel,5,0.00032,353912,22.67101,1561077
7086,DoCode,5,0.00032,353917,22.67134,1561077
7087,doljae,5,0.00032,353922,22.67166,1561077
7088,dongsik2026,5,0.00032,353927,22.67198,1561077
7089,dooleyb1,5,0.00032,353932,22.67230,1561077
7090,doronshai,5,0.00032,353937,22.67262,1561077
7091,dotstone,5,0.00032,353942,22.67294,1561077
7092,doublefx,5,0.00032,353947,22.67326,1561077
7093,douglasbgray,5,0.00032,353952,22.67358,1561077
7094,DragD,5,0.00032,353957,22.67390,1561077
7095,dreilly1982,5,0.00032,353962,22.67422,1561077
7096,Drewrockon,5,0.00032,353967,22.67454,1561077
7097,drmmr763,5,0.00032,353972,22.67486,1561077
7098,drphrozen,5,0.00032,353977,22.67518,1561077
7099,drptbl,5,0.00032,353982,22.67550,1561077
7100,drujd,5,0.00032,353987,22.67582,1561077
7101,drulli,5,0.00032,353992,22.67614,1561077
7102,DrWeiZhou,5,0.00032,353997,22.67646,1561077
7103,dsathyan,5,0.00032,354002,22.67678,1561077
7104,Dschoordsch,5,0.00032,354007,22.67710,1561077
7105,dstengle,5,0.00032,354012,22.67742,1561077
7106,dstrychalski,5,0.00032,354017,22.67774,1561077
7107,DTaylorBusiness,5,0.00032,354022,22.67806,1561077
7108,DTherHtun,5,0.00032,354027,22.67838,1561077
7109,dtrogers2,5,0.00032,354032,22.67870,1561077
7110,DukeCheng,5,0.00032,354037,22.67902,1561077
7111,dullest,5,0.00032,354042,22.67934,1561077
7112,dulyts,5,0.00032,354047,22.67966,1561077
7113,dustym,5,0.00032,354052,22.67998,1561077
7114,dxxd116,5,0.00032,354057,22.68030,1561077
7115,DylanLacey,5,0.00032,354062,22.68062,1561077
7116,dzabel,5,0.00032,354067,22.68094,1561077
7117,dzonekl,5,0.00032,354072,22.68126,1561077
7118,EAnushan,5,0.00032,354077,22.68158,1561077
7119,ebcFlagman,5,0.00032,354082,22.68190,1561077
7120,ebundy,5,0.00032,354087,22.68223,1561077
7121,echang26,5,0.00032,354092,22.68255,1561077
7122,eddiewebb,5,0.00032,354097,22.68287,1561077
7123,ediri,5,0.00032,354102,22.68319,1561077
7124,edomaur,5,0.00032,354107,22.68351,1561077
7125,edreanernst,5,0.00032,354112,22.68383,1561077
7126,edvegas,5,0.00032,354117,22.68415,1561077
7127,edwardsuero,5,0.00032,354122,22.68447,1561077
7128,e-g-hategan,5,0.00032,354127,22.68479,1561077
7129,eheydrick,5,0.00032,354132,22.68511,1561077
7130,ehirsch,5,0.00032,354137,22.68543,1561077
7131,ehsanmnz,5,0.00032,354142,22.68575,1561077
7132,eightnoneone,5,0.00032,354147,22.68607,1561077
7133,elad-lachmi,5,0.00032,354152,22.68639,1561077
7134,Eldadc,5,0.00032,354157,22.68671,1561077
7135,eliasnogueira,5,0.00032,354162,22.68703,1561077
7136,emailtomit,5,0.00032,354167,22.68735,1561077
7137,Emil-Gustafsson,5,0.00032,354172,22.68767,1561077
7138,emsouza,5,0.00032,354177,22.68799,1561077
7139,emzeq,5,0.00032,354182,22.68831,1561077
7140,encryptblockr,5,0.00032,354187,22.68863,1561077
7141,enggabhishekshinde,5,0.00032,354192,22.68895,1561077
7142,enyrgy,5,0.00032,354197,22.68927,1561077
7143,eonpatapon,5,0.00032,354202,22.68959,1561077
7144,eratolekov,5,0.00032,354207,22.68991,1561077
7145,eric135,5,0.00032,354212,22.69023,1561077
7146,ericparton,5,0.00032,354217,22.69055,1561077
7147,erik-brangs,5,0.00032,354222,22.69087,1561077
7148,eriklogtenberg,5,0.00032,354227,22.69119,1561077
7149,erikvanzijst,5,0.00032,354232,22.69151,1561077
7150,erioness1125,5,0.00032,354237,22.69183,1561077
7151,erlichmen,5,0.00032,354242,22.69215,1561077
7152,espenalb,5,0.00032,354247,22.69247,1561077
7153,esquires,5,0.00032,354252,22.69279,1561077
7154,evantorrie,5,0.00032,354257,22.69312,1561077
7155,evermind-micw,5,0.00032,354262,22.69344,1561077
7156,eversC,5,0.00032,354267,22.69376,1561077
7157,exploiz65,5,0.00032,354272,22.69408,1561077
7158,exuperok,5,0.00032,354277,22.69440,1561077
7159,ezeeetm,5,0.00032,354282,22.69472,1561077
7160,fabitamas,5,0.00032,354287,22.69504,1561077
7161,fabricepipart,5,0.00032,354292,22.69536,1561077
7162,facastagnini,5,0.00032,354297,22.69568,1561077
7163,facewy,5,0.00032,354302,22.69600,1561077
7164,fadeltd,5,0.00032,354307,22.69632,1561077
7165,faikabouthalja,5,0.00032,354312,22.69664,1561077
7166,faisalthaheem,5,0.00032,354317,22.69696,1561077
7167,FaizVisram,5,0.00032,354322,22.69728,1561077
7168,FallDownT,5,0.00032,354327,22.69760,1561077
7169,falseperfection,5,0.00032,354332,22.69792,1561077
7170,fcappi,5,0.00032,354337,22.69824,1561077
7171,fdearle,5,0.00032,354342,22.69856,1561077
7172,fengkuok,5,0.00032,354347,22.69888,1561077
7173,fergzie,5,0.00032,354352,22.69920,1561077
7174,fknittel,5,0.00032,354357,22.69952,1561077
7175,flichtenheld,5,0.00032,354362,22.69984,1561077
7176,flocurity,5,0.00032,354367,22.70016,1561077
7177,FloKaemmerer,5,0.00032,354372,22.70048,1561077
7178,FloOows,5,0.00032,354377,22.70080,1561077
7179,flopaconsult,5,0.00032,354382,22.70112,1561077
7180,florind,5,0.00032,354387,22.70144,1561077
7181,fox4it,5,0.00032,354392,22.70176,1561077
7182,francais01,5,0.00032,354397,22.70208,1561077
7183,FranLucchini,5,0.00032,354402,22.70240,1561077
7184,fredden,5,0.00032,354407,22.70272,1561077
7185,freidenker,5,0.00032,354412,22.70304,1561077
7186,FridayPush,5,0.00032,354417,22.70336,1561077
7187,ftclausen,5,0.00032,354422,22.70368,1561077
7188,fugi,5,0.00032,354427,22.70400,1561077
7189,gabotz,5,0.00032,354432,22.70433,1561077
7190,gadgetwhiz,5,0.00032,354437,22.70465,1561077
7191,gallardo,5,0.00032,354442,22.70497,1561077
7192,gardellajuanpablo,5,0.00032,354447,22.70529,1561077
7193,garretruh,5,0.00032,354452,22.70561,1561077
7194,gattie,5,0.00032,354457,22.70593,1561077
7195,GBeauny,5,0.00032,354462,22.70625,1561077
7196,gcbw,5,0.00032,354467,22.70657,1561077
7197,gdams,5,0.00032,354472,22.70689,1561077
7198,gdisanto,5,0.00032,354477,22.70721,1561077
7199,genericpenguin,5,0.00032,354482,22.70753,1561077
7200,georgekankava,5,0.00032,354487,22.70785,1561077
7201,georgeliaw,5,0.00032,354492,22.70817,1561077
7202,gerardgine,5,0.00032,354497,22.70849,1561077
7203,gerhard6,5,0.00032,354502,22.70881,1561077
7204,gfjalar,5,0.00032,354507,22.70913,1561077
7205,gfonk,5,0.00032,354512,22.70945,1561077
7206,gforcada,5,0.00032,354517,22.70977,1561077
7207,gilgameshs,5,0.00032,354522,22.71009,1561077
7208,gilligan,5,0.00032,354527,22.71041,1561077
7209,gilmorem560,5,0.00032,354532,22.71073,1561077
7210,Giridharan002,5,0.00032,354537,22.71105,1561077
7211,gkocur,5,0.00032,354542,22.71137,1561077
7212,gkoloventzos,5,0.00032,354547,22.71169,1561077
7213,glebiller,5,0.00032,354552,22.71201,1561077
7214,gmasil,5,0.00032,354557,22.71233,1561077
7215,gmjck,5,0.00032,354562,22.71265,1561077
7216,gnzhoutian,5,0.00032,354567,22.71297,1561077
7217,GoDSiN,5,0.00032,354572,22.71329,1561077
7218,gofinho,5,0.00032,354577,22.71361,1561077
7219,goforgold,5,0.00032,354582,22.71393,1561077
7220,gokhurana,5,0.00032,354587,22.71425,1561077
7221,golak,5,0.00032,354592,22.71457,1561077
7222,gonzaoviedo,5,0.00032,354597,22.71489,1561077
7223,gopaljayanthi,5,0.00032,354602,22.71522,1561077
7224,grahamhar,5,0.00032,354607,22.71554,1561077
7225,grahamrhay,5,0.00032,354612,22.71586,1561077
7226,gregoryboue,5,0.00032,354617,22.71618,1561077
7227,gregory-schiano,5,0.00032,354622,22.71650,1561077
7228,grusy,5,0.00032,354627,22.71682,1561077
7229,guija,5,0.00032,354632,22.71714,1561077
7230,guillem-sopra,5,0.00032,354637,22.71746,1561077
7231,guneetbh,5,0.00032,354642,22.71778,1561077
7232,gupbeheer,5,0.00032,354647,22.71810,1561077
7233,guyhoskinsibm,5,0.00032,354652,22.71842,1561077
7234,guykisel,5,0.00032,354657,22.71874,1561077
7235,gyorgynadaban,5,0.00032,354662,22.71906,1561077
7236,hackinthegibson,5,0.00032,354667,22.71938,1561077
7237,haedaal,5,0.00032,354672,22.71970,1561077
7238,hallliu1984831,5,0.00032,354677,22.72002,1561077
7239,haminhcong,5,0.00032,354682,22.72034,1561077
7240,hannes-ucsc,5,0.00032,354687,22.72066,1561077
7241,HaroonSaid,5,0.00032,354692,22.72098,1561077
7242,haukeduden,5,0.00032,354697,22.72130,1561077
7243,hawkli-1994,5,0.00032,354702,22.72162,1561077
7244,hbazan-pp,5,0.00032,354707,22.72194,1561077
7245,HefeiJoe,5,0.00032,354712,22.72226,1561077
7246,helenabutowatep,5,0.00032,354717,22.72258,1561077
7247,helloyou2012,5,0.00032,354722,22.72290,1561077
7248,henrikcaesar,5,0.00032,354727,22.72322,1561077
7249,Henry-Kim-Youngwoo,5,0.00032,354732,22.72354,1561077
7250,henrykuijpers,5,0.00032,354737,22.72386,1561077
7251,hermesf,5,0.00032,354742,22.72418,1561077
7252,hesamchobanlou,5,0.00032,354747,22.72450,1561077
7253,Highsight,5,0.00032,354752,22.72482,1561077
7254,Hima-QA,5,0.00032,354757,22.72514,1561077
7255,HirokiSakonju,5,0.00032,354762,22.72546,1561077
7256,hlopetz,5,0.00032,354767,22.72578,1561077
7257,hmax,5,0.00032,354772,22.72611,1561077
7258,hnehete-bmc,5,0.00032,354777,22.72643,1561077
7259,hochak,5,0.00032,354782,22.72675,1561077
7260,hos7ein,5,0.00032,354787,22.72707,1561077
7261,houseofyin,5,0.00032,354792,22.72739,1561077
7262,hrabbouh,5,0.00032,354797,22.72771,1561077
7263,hsarbia,5,0.00032,354802,22.72803,1561077
7264,hsd99,5,0.00032,354807,22.72835,1561077
7265,Hubble1942,5,0.00032,354812,22.72867,1561077
7266,humphrey-parasoft,5,0.00032,354817,22.72899,1561077
7267,husnurrsyafni,5,0.00032,354822,22.72931,1561077
7268,huytn12-test,5,0.00032,354827,22.72963,1561077
7269,hyunil-shin,5,0.00032,354832,22.72995,1561077
7270,iaincoulter,5,0.00032,354837,22.73027,1561077
7271,ianwalter,5,0.00032,354842,22.73059,1561077
7272,ica10888,5,0.00032,354847,22.73091,1561077
7273,IcedSoul,5,0.00032,354852,22.73123,1561077
7274,Ichai5,5,0.00032,354857,22.73155,1561077
7275,ichasepucks,5,0.00032,354862,22.73187,1561077
7276,ICLXL,5,0.00032,354867,22.73219,1561077
7277,IgorMr,5,0.00032,354872,22.73251,1561077
7278,igwejk,5,0.00032,354877,22.73283,1561077
7279,iharrington,5,0.00032,354882,22.73315,1561077
7280,ilatypov,5,0.00032,354887,22.73347,1561077
7281,ilushka85,5,0.00032,354892,22.73379,1561077
7282,ineffyble,5,0.00032,354897,22.73411,1561077
7283,ingmars1709,5,0.00032,354902,22.73443,1561077
7284,ingorichter,5,0.00032,354907,22.73475,1561077
7285,inorton,5,0.00032,354912,22.73507,1561077
7286,invinciblycool,5,0.00032,354917,22.73539,1561077
7287,ipirva,5,0.00032,354922,22.73571,1561077
7288,iqiyiadsrv,5,0.00032,354927,22.73603,1561077
7289,IreshMM,5,0.00032,354932,22.73635,1561077
7290,ishallbethat,5,0.00032,354937,22.73667,1561077
7291,isigoing,5,0.00032,354942,22.73700,1561077
7292,ismaelsadeeq,5,0.00032,354947,22.73732,1561077
7293,isomarcte,5,0.00032,354952,22.73764,1561077
7294,Issen007,5,0.00032,354957,22.73796,1561077
7295,istrangiu,5,0.00032,354962,22.73828,1561077
7296,itensionanders,5,0.00032,354967,22.73860,1561077
7297,itoutki,5,0.00032,354972,22.73892,1561077
7298,ivorp,5,0.00032,354977,22.73924,1561077
7299,jacek-poreda-sonarsource,5,0.00032,354982,22.73956,1561077
7300,JakeStoeffler,5,0.00032,354987,22.73988,1561077
7301,jaksky,5,0.00032,354992,22.74020,1561077
7302,jalbador,5,0.00032,354997,22.74052,1561077
7303,jamaluddinfikri,5,0.00032,355002,22.74084,1561077
7304,jambstud,5,0.00032,355007,22.74116,1561077
7305,jamesbonica,5,0.00032,355012,22.74148,1561077
7306,JamesXNelson,5,0.00032,355017,22.74180,1561077
7307,jamur2,5,0.00032,355022,22.74212,1561077
7308,jangjaelee,5,0.00032,355027,22.74244,1561077
7309,janhollevoet,5,0.00032,355032,22.74276,1561077
7310,jansenm,5,0.00032,355037,22.74308,1561077
7311,jaredKreppein,5,0.00032,355042,22.74340,1561077
7312,JasmineKh,5,0.00032,355047,22.74372,1561077
7313,jason-1bit,5,0.00032,355052,22.74404,1561077
7314,JasonSmiley208,5,0.00032,355057,22.74436,1561077
7315,jatladams,5,0.00032,355062,22.74468,1561077
7316,javydreamercsw,5,0.00032,355067,22.74500,1561077
7317,jaxzin,5,0.00032,355072,22.74532,1561077
7318,JaydeepUniverse,5,0.00032,355077,22.74564,1561077
7319,jbalooka,5,0.00032,355082,22.74596,1561077
7320,jbiotid,5,0.00032,355087,22.74628,1561077
7321,JBodkin,5,0.00032,355092,22.74660,1561077
7322,jbreitung,5,0.00032,355097,22.74692,1561077
7323,jcragg,5,0.00032,355102,22.74724,1561077
7324,jcwoos,5,0.00032,355107,22.74756,1561077
7325,jdnrg,5,0.00032,355112,22.74788,1561077
7326,jedidiahB,5,0.00032,355117,22.74821,1561077
7327,jeffastorey,5,0.00032,355122,22.74853,1561077
7328,JeffCertain,5,0.00032,355127,22.74885,1561077
7329,jeff-deitch,5,0.00032,355132,22.74917,1561077
7330,jeichel-miovision,5,0.00032,355137,22.74949,1561077
7331,jellevanhees,5,0.00032,355142,22.74981,1561077
7332,jembal,5,0.00032,355147,22.75013,1561077
7333,jenkinsfu,5,0.00032,355152,22.75045,1561077
7334,jenkinsuserby2,5,0.00032,355157,22.75077,1561077
7335,jenkinsxsixense,5,0.00032,355162,22.75109,1561077
7336,jeremymcgee73,5,0.00032,355167,22.75141,1561077
7337,jeroenjans,5,0.00032,355172,22.75173,1561077
7338,JeroennC,5,0.00032,355177,22.75205,1561077
7339,JerryWeis,5,0.00032,355182,22.75237,1561077
7340,JFLarvoire,5,0.00032,355187,22.75269,1561077
7341,jfuerneisen,5,0.00032,355192,22.75301,1561077
7342,jgarver,5,0.00032,355197,22.75333,1561077
7343,JHeilCoveo,5,0.00032,355202,22.75365,1561077
7344,jhulings,5,0.00032,355207,22.75397,1561077
7345,jiabh,5,0.00032,355212,22.75429,1561077
7346,jigyasapriyadarshini,5,0.00032,355217,22.75461,1561077
7347,jihwong,5,0.00032,355222,22.75493,1561077
7348,jinyulei0710,5,0.00032,355227,22.75525,1561077
7349,jirikuncar,5,0.00032,355232,22.75557,1561077
7350,jkiddo,5,0.00032,355237,22.75589,1561077
7351,jlisam-insikt,5,0.00032,355242,22.75621,1561077
7352,jmarnold1021,5,0.00032,355247,22.75653,1561077
7353,jmellor,5,0.00032,355252,22.75685,1561077
7354,jnsdrtlf,5,0.00032,355257,22.75717,1561077
7355,jnsvd,5,0.00032,355262,22.75749,1561077
7356,Joeasaurus,5,0.00032,355267,22.75781,1561077
7357,Joehunk,5,0.00032,355272,22.75813,1561077
7358,JoeSSS,5,0.00032,355277,22.75845,1561077
7359,johannespfeiffer,5,0.00032,355282,22.75877,1561077
7360,johnkrzywanek,5,0.00032,355287,22.75910,1561077
7361,johnl2323,5,0.00032,355292,22.75942,1561077
7362,JonasBovin,5,0.00032,355297,22.75974,1561077
7363,JooeunAhn,5,0.00032,355302,22.76006,1561077
7364,JorgeRobins,5,0.00032,355307,22.76038,1561077
7365,JorisAndrade,5,0.00032,355312,22.76070,1561077
7366,joshmoore,5,0.00032,355317,22.76102,1561077
7367,jpancoast-kenzan,5,0.00032,355322,22.76134,1561077
7368,jpfeuffer,5,0.00032,355327,22.76166,1561077
7369,jplorier,5,0.00032,355332,22.76198,1561077
7370,jpratt2,5,0.00032,355337,22.76230,1561077
7371,jredl-va,5,0.00032,355342,22.76262,1561077
7372,jrefi,5,0.00032,355347,22.76294,1561077
7373,jromigh,5,0.00032,355352,22.76326,1561077
7374,jschutijzer,5,0.00032,355357,22.76358,1561077
7375,jsindy,5,0.00032,355362,22.76390,1561077
7376,jsnod,5,0.00032,355367,22.76422,1561077
7377,jspiewak,5,0.00032,355372,22.76454,1561077
7378,jsteinich,5,0.00032,355377,22.76486,1561077
7379,jtgans,5,0.00032,355382,22.76518,1561077
7380,juanserra,5,0.00032,355387,22.76550,1561077
7381,jukkasi,5,0.00032,355392,22.76582,1561077
7382,julian-computes,5,0.00032,355397,22.76614,1561077
7383,juneeighteen,5,0.00032,355402,22.76646,1561077
7384,junguchina,5,0.00032,355407,22.76678,1561077
7385,justinseanmartin,5,0.00032,355412,22.76710,1561077
7386,jvale,5,0.00032,355417,22.76742,1561077
7387,jwalteri,5,0.00032,355422,22.76774,1561077
7388,jwg4,5,0.00032,355427,22.76806,1561077
7389,jzinkweg,5,0.00032,355432,22.76838,1561077
7390,jzylkin,5,0.00032,355437,22.76870,1561077
7391,kamaradclimber,5,0.00032,355442,22.76902,1561077
7392,KamatR,5,0.00032,355447,22.76934,1561077
7393,kamatsuoka,5,0.00032,355452,22.76966,1561077
7394,KangoV,5,0.00032,355457,22.76999,1561077
7395,kankhand,5,0.00032,355462,22.77031,1561077
7396,kaoruu,5,0.00032,355467,22.77063,1561077
7397,kardigen,5,0.00032,355472,22.77095,1561077
7398,kariustobias,5,0.00032,355477,22.77127,1561077
7400,karthickkulandaivelu,5,0.00032,355487,22.77191,1561077
7401,kdalton-Quest,5,0.00032,355492,22.77223,1561077
7402,kdeenkhoorn,5,0.00032,355497,22.77255,1561077
7403,kevhong,5,0.00032,355502,22.77287,1561077
7404,kevinhankens,5,0.00032,355507,22.77319,1561077
7405,kevinm90,5,0.00032,355512,22.77351,1561077
7406,keyur2maru,5,0.00032,355517,22.77383,1561077
7407,kfrank2017,5,0.00032,355522,22.77415,1561077
7408,kgermanov,5,0.00032,355527,22.77447,1561077
7409,kgluszczyk,5,0.00032,355532,22.77479,1561077
7410,Khyme,5,0.00032,355537,22.77511,1561077
7411,kimjinyam,5,0.00032,355542,22.77543,1561077
7412,Kiran-B,5,0.00032,355547,22.77575,1561077
7413,KiraResari,5,0.00032,355552,22.77607,1561077
7414,kirk-patton,5,0.00032,355557,22.77639,1561077
7415,kiview,5,0.00032,355562,22.77671,1561077
7416,kmbulebu,5,0.00032,355567,22.77703,1561077
7417,kmcquade,5,0.00032,355572,22.77735,1561077
7418,Knappek,5,0.00032,355577,22.77767,1561077
7419,knowyi,5,0.00032,355582,22.77799,1561077
7420,knoxfighter,5,0.00032,355587,22.77831,1561077
7421,koenpunt,5,0.00032,355592,22.77863,1561077
7422,KoniAnastasia,5,0.00032,355597,22.77895,1561077
7423,koral--,5,0.00032,355602,22.77927,1561077
7424,koromkorom,5,0.00032,355607,22.77959,1561077
7425,kovalskyi,5,0.00032,355612,22.77991,1561077
7426,krishshenoy,5,0.00032,355617,22.78023,1561077
7427,kristianhald,5,0.00032,355622,22.78055,1561077
7428,krzysieksulejczak,5,0.00032,355627,22.78087,1561077
7429,kscaldef,5,0.00032,355632,22.78120,1561077
7430,kstedman9,5,0.00032,355637,22.78152,1561077
7431,kufi,5,0.00032,355642,22.78184,1561077
7432,kuhu19,5,0.00032,355647,22.78216,1561077
7433,kumarpratyush,5,0.00032,355652,22.78248,1561077
7434,kvarec,5,0.00032,355657,22.78280,1561077
7435,kveretennicov,5,0.00032,355662,22.78312,1561077
7436,kwamaking,5,0.00032,355667,22.78344,1561077
7437,l3msh0,5,0.00032,355672,22.78376,1561077
7438,lachaib,5,0.00032,355677,22.78408,1561077
7439,laferrieren,5,0.00032,355682,22.78440,1561077
7440,Lambeaux,5,0.00032,355687,22.78472,1561077
7441,lambertpan,5,0.00032,355692,22.78504,1561077
7442,lamLeX,5,0.00032,355697,22.78536,1561077
7443,lanycrost,5,0.00032,355702,22.78568,1561077
7444,laughingblade,5,0.00032,355707,22.78600,1561077
7445,laurent-theglue,5,0.00032,355712,22.78632,1561077
7446,lcaille,5,0.00032,355717,22.78664,1561077
7447,lcintrat,5,0.00032,355722,22.78696,1561077
7448,lcofre,5,0.00032,355727,22.78728,1561077
7449,lcsfreire,5,0.00032,355732,22.78760,1561077
7450,ldormoy,5,0.00032,355737,22.78792,1561077
7451,lealanko,5,0.00032,355742,22.78824,1561077
7452,leonardobsjr,5,0.00032,355747,22.78856,1561077
7453,leonardoluan,5,0.00032,355752,22.78888,1561077
7454,leonj1,5,0.00032,355757,22.78920,1561077
7455,leonkyr,5,0.00032,355762,22.78952,1561077
7456,leoprincep,5,0.00032,355767,22.78984,1561077
7457,leoqa,5,0.00032,355772,22.79016,1561077
7458,link89,5,0.00032,355777,22.79048,1561077
7459,liron-shalom,5,0.00032,355782,22.79080,1561077
7460,liskin,5,0.00032,355787,22.79112,1561077
7461,literalplus,5,0.00032,355792,22.79144,1561077
7462,liuchintao,5,0.00032,355797,22.79176,1561077
7463,lixin9311,5,0.00032,355802,22.79209,1561077
7464,LJBD,5,0.00032,355807,22.79241,1561077
7465,llienard,5,0.00032,355812,22.79273,1561077
7466,lmazureNX,5,0.00032,355817,22.79305,1561077
7467,lmeyemezu,5,0.00032,355822,22.79337,1561077
7468,lomignet,5,0.00032,355827,22.79369,1561077
7469,LorensV8,5,0.00032,355832,22.79401,1561077
7470,lorenzir,5,0.00032,355837,22.79433,1561077
7471,lougroshek,5,0.00032,355842,22.79465,1561077
7472,lpl-hosting,5,0.00032,355847,22.79497,1561077
7473,lptr,5,0.00032,355852,22.79529,1561077
7474,lsmith62,5,0.00032,355857,22.79561,1561077
7475,lucasam,5,0.00032,355862,22.79593,1561077
7476,lucasheringer,5,0.00032,355867,22.79625,1561077
7477,lucasleelz,5,0.00032,355872,22.79657,1561077
7478,luciahroyalty101,5,0.00032,355877,22.79689,1561077
7479,luisgois,5,0.00032,355882,22.79721,1561077
7480,lukaszkarnasiewicz,5,0.00032,355887,22.79753,1561077
7481,LukeJang,5,0.00032,355892,22.79785,1561077
7482,lukelin2048,5,0.00032,355897,22.79817,1561077
7483,lysimon,5,0.00032,355902,22.79849,1561077
7484,m0rt1-m3r,5,0.00032,355907,22.79881,1561077
7485,m2ger,5,0.00032,355912,22.79913,1561077
7486,maacarbo,5,0.00032,355917,22.79945,1561077
7487,macetw,5,0.00032,355922,22.79977,1561077
7488,macieklukasik88,5,0.00032,355927,22.80009,1561077
7489,MacThrawn,5,0.00032,355932,22.80041,1561077
7490,madisona,5,0.00032,355937,22.80073,1561077
7491,madmunki,5,0.00032,355942,22.80105,1561077
7492,mageSFC2020,5,0.00032,355947,22.80137,1561077
7493,magnetikonline,5,0.00032,355952,22.80169,1561077
7494,Makovec,5,0.00032,355957,22.80201,1561077
7495,malashi,5,0.00032,355962,22.80233,1561077
7496,malnick,5,0.00032,355967,22.80265,1561077
7497,MancunianSam,5,0.00032,355972,22.80298,1561077
7498,manovotn,5,0.00032,355977,22.80330,1561077
7499,maojx0630,5,0.00032,355982,22.80362,1561077
7500,marceloavilaoliveira,5,0.00032,355987,22.80394,1561077
7501,marcelochaves95,5,0.00032,355992,22.80426,1561077
7502,marcolenzo,5,0.00032,355997,22.80458,1561077
7503,marcosantar93,5,0.00032,356002,22.80490,1561077
7504,mariachini,5,0.00032,356007,22.80522,1561077
7505,mariiatuzovska,5,0.00032,356012,22.80554,1561077
7506,MarioBartolovic,5,0.00032,356017,22.80586,1561077
7507,markstos,5,0.00032,356022,22.80618,1561077
7508,MarkusAmshove,5,0.00032,356027,22.80650,1561077
7509,marmccor,5,0.00032,356032,22.80682,1561077
7510,martinstolz,5,0.00032,356037,22.80714,1561077
7511,martoeng,5,0.00032,356042,22.80746,1561077
7512,martonilles,5,0.00032,356047,22.80778,1561077
7513,marvinpinto,5,0.00032,356052,22.80810,1561077
7514,Masahigo,5,0.00032,356057,22.80842,1561077
7515,masarakki,5,0.00032,356062,22.80874,1561077
7516,massivetim,5,0.00032,356067,22.80906,1561077
7517,matble,5,0.00032,356072,22.80938,1561077
7518,matez,5,0.00032,356077,22.80970,1561077
7519,matteoturra,5,0.00032,356082,22.81002,1561077
7520,matthewreiter,5,0.00032,356087,22.81034,1561077
7521,matttbe,5,0.00032,356092,22.81066,1561077
7522,mau21mau,5,0.00032,356097,22.81098,1561077
7523,mayt,5,0.00032,356102,22.81130,1561077
7524,mbasc,5,0.00032,356107,22.81162,1561077
7525,mbudnick,5,0.00032,356112,22.81194,1561077
7526,mbwhite,5,0.00032,356117,22.81226,1561077
7527,mcabrito,5,0.00032,356122,22.81258,1561077
7528,mcansozeri,5,0.00032,356127,22.81290,1561077
7529,mccartney,5,0.00032,356132,22.81322,1561077
7530,mcombell-cafex,5,0.00032,356137,22.81354,1561077
7531,mcpolandc,5,0.00032,356142,22.81387,1561077
7532,mcqueenorama,5,0.00032,356147,22.81419,1561077
7533,mcr-paulanand,5,0.00032,356152,22.81451,1561077
7534,mcwarg,5,0.00032,356157,22.81483,1561077
7535,mdesanti,5,0.00032,356162,22.81515,1561077
7536,mdlavin,5,0.00032,356167,22.81547,1561077
7537,meebok,5,0.00032,356172,22.81579,1561077
7538,meenaljain0303,5,0.00032,356177,22.81611,1561077
7539,melammari,5,0.00032,356182,22.81643,1561077
7540,MemorySpring,5,0.00032,356187,22.81675,1561077
7541,menehune23,5,0.00032,356192,22.81707,1561077
7542,metacyclic,5,0.00032,356197,22.81739,1561077
7543,meyerbro,5,0.00032,356202,22.81771,1561077
7544,mfortin,5,0.00032,356207,22.81803,1561077
7545,mgrebenets,5,0.00032,356212,22.81835,1561077
7546,mhmdabdh,5,0.00032,356217,22.81867,1561077
7547,michaelpj,5,0.00032,356222,22.81899,1561077
7548,midopa,5,0.00032,356227,22.81931,1561077
7549,mihaiwww,5,0.00032,356232,22.81963,1561077
7550,miikeat,5,0.00032,356237,22.81995,1561077
7551,mikebro,5,0.00032,356242,22.82027,1561077
7552,MikeSafonov,5,0.00032,356247,22.82059,1561077
7553,mikeweltejr,5,0.00032,356252,22.82091,1561077
7554,milankonir,5,0.00032,356257,22.82123,1561077
7555,milsonian,5,0.00032,356262,22.82155,1561077
7556,mingfang,5,0.00032,356267,22.82187,1561077
7557,minwoolee,5,0.00032,356272,22.82219,1561077
7558,mirzazeyrek,5,0.00032,356277,22.82251,1561077
7559,Mitulsharma123,5,0.00032,356282,22.82283,1561077
7560,mkj28,5,0.00032,356287,22.82315,1561077
7561,mkjensen,5,0.00032,356292,22.82347,1561077
7562,mkozell,5,0.00032,356297,22.82379,1561077
7563,mkrauser,5,0.00032,356302,22.82411,1561077
7564,mkutter,5,0.00032,356307,22.82443,1561077
7565,mkyc,5,0.00032,356312,22.82475,1561077
7566,mletterle,5,0.00032,356317,22.82508,1561077
7567,mlubavin-vg,5,0.00032,356322,22.82540,1561077
7568,mmoghadas,5,0.00032,356327,22.82572,1561077
7569,mmucklo,5,0.00032,356332,22.82604,1561077
7570,mnencia,5,0.00032,356337,22.82636,1561077
7571,moesy,5,0.00032,356342,22.82668,1561077
7572,MofX,5,0.00032,356347,22.82700,1561077
7573,mohammad-eghlima,5,0.00032,356352,22.82732,1561077
7574,molecul,5,0.00032,356357,22.82764,1561077
7575,mominkhan,5,0.00032,356362,22.82796,1561077
7576,monger39,5,0.00032,356367,22.82828,1561077
7577,Montikore,5,0.00032,356372,22.82860,1561077
7578,morarucostel,5,0.00032,356377,22.82892,1561077
7579,moritzrupp,5,0.00032,356382,22.82924,1561077
7580,mpavlov,5,0.00032,356387,22.82956,1561077
7581,mpdeimos,5,0.00032,356392,22.82988,1561077
7582,mpettigr,5,0.00032,356397,22.83020,1561077
7583,mpuglin,5,0.00032,356402,22.83052,1561077
7584,mrcodedev,5,0.00032,356407,22.83084,1561077
7585,mr-const,5,0.00032,356412,22.83116,1561077
7586,mrmateo,5,0.00032,356417,22.83148,1561077
7587,mscharp,5,0.00032,356422,22.83180,1561077
7588,mshuler,5,0.00032,356427,22.83212,1561077
7589,mstave,5,0.00032,356432,22.83244,1561077
7590,mtauzin,5,0.00032,356437,22.83276,1561077
7591,mtaylor98,5,0.00032,356442,22.83308,1561077
7592,mturra-Pro,5,0.00032,356447,22.83340,1561077
7593,MuchContact,5,0.00032,356452,22.83372,1561077
7594,muicoder,5,0.00032,356457,22.83404,1561077
7595,Mukhtarali212,5,0.00032,356462,22.83436,1561077
7596,musicccman,5,0.00032,356467,22.83468,1561077
7597,mvallim,5,0.00032,356472,22.83500,1561077
7598,mveunen,5,0.00032,356477,22.83532,1561077
7599,nabz09,5,0.00032,356482,22.83564,1561077
7600,nandar999,5,0.00032,356487,22.83597,1561077
7601,Nandini99-git,5,0.00032,356492,22.83629,1561077
7602,naturalwarren,5,0.00032,356497,22.83661,1561077
7603,navrkald,5,0.00032,356502,22.83693,1561077
7604,NazarovNikita,5,0.00032,356507,22.83725,1561077
7605,neiljfwhite,5,0.00032,356512,22.83757,1561077
7606,neotys-rd,5,0.00032,356517,22.83789,1561077
7607,neuhausjulian,5,0.00032,356522,22.83821,1561077
7608,nickgravelyn,5,0.00032,356527,22.83853,1561077
7609,nickjmv,5,0.00032,356532,22.83885,1561077
7610,nickstolwijk,5,0.00032,356537,22.83917,1561077
7611,nicmunroe,5,0.00032,356542,22.83949,1561077
7612,NicoXcc,5,0.00032,356547,22.83981,1561077
7613,nightman68,5,0.00032,356552,22.84013,1561077
7614,nikore,5,0.00032,356557,22.84045,1561077
7615,niralmaruda,5,0.00032,356562,22.84077,1561077
7616,nirvanagit,5,0.00032,356567,22.84109,1561077
7617,NitroPye,5,0.00032,356572,22.84141,1561077
7618,njappboy,5,0.00032,356577,22.84173,1561077
7619,nkamp,5,0.00032,356582,22.84205,1561077
7620,nmousouros,5,0.00032,356587,22.84237,1561077
7621,NoevilMe,5,0.00032,356592,22.84269,1561077
7622,Nogbit,5,0.00032,356597,22.84301,1561077
7623,noob1211,5,0.00032,356602,22.84333,1561077
7624,noquirks,5,0.00032,356607,22.84365,1561077
7625,nothing-fr,5,0.00032,356612,22.84397,1561077
7626,novasharper,5,0.00032,356617,22.84429,1561077
7627,Novitoll,5,0.00032,356622,22.84461,1561077
7628,nparks-kenzan,5,0.00032,356627,22.84493,1561077
7629,ntwerdochlib,5,0.00032,356632,22.84525,1561077
7630,nussera,5,0.00032,356637,22.84557,1561077
7631,nuzz,5,0.00032,356642,22.84589,1561077
7632,nvs4a3,5,0.00032,356647,22.84621,1561077
7633,nwbvt,5,0.00032,356652,22.84653,1561077
7634,nwholloway,5,0.00032,356657,22.84686,1561077
7635,nwithers-ecr,5,0.00032,356662,22.84718,1561077
7636,nxtn,5,0.00032,356667,22.84750,1561077
7637,oatmealraisin,5,0.00032,356672,22.84782,1561077
7638,obrejla,5,0.00032,356677,22.84814,1561077
7639,oeuftete,5,0.00032,356682,22.84846,1561077
7640,ogonkov,5,0.00032,356687,22.84878,1561077
7641,ohartl,5,0.00032,356692,22.84910,1561077
7642,oiricaud,5,0.00032,356697,22.84942,1561077
7643,okrasnyiblues,5,0.00032,356702,22.84974,1561077
7644,olafrauch,5,0.00032,356707,22.85006,1561077
7645,OlegCx,5,0.00032,356712,22.85038,1561077
7646,oleo65,5,0.00032,356717,22.85070,1561077
7647,olliefreeman,5,0.00032,356722,22.85102,1561077
7648,OndrejKotek,5,0.00032,356727,22.85134,1561077
7649,one-random-dev,5,0.00032,356732,22.85166,1561077
7650,ooxi,5,0.00032,356737,22.85198,1561077
7651,Opalo,5,0.00032,356742,22.85230,1561077
7652,orih,5,0.00032,356747,22.85262,1561077
7653,ortex,5,0.00032,356752,22.85294,1561077
7654,oslobodian,5,0.00032,356757,22.85326,1561077
7655,osmolyar,5,0.00032,356762,22.85358,1561077
7656,outbreaker,5,0.00032,356767,22.85390,1561077
7657,outofjungle,5,0.00032,356772,22.85422,1561077
7658,ouyangz314,5,0.00032,356777,22.85454,1561077
7659,owennewo,5,0.00032,356782,22.85486,1561077
7660,pageanengineer,5,0.00032,356787,22.85518,1561077
7661,Painyjames,5,0.00032,356792,22.85550,1561077
7662,pandoras-toolbox,5,0.00032,356797,22.85582,1561077
7663,Panfilwk,5,0.00032,356802,22.85614,1561077
7664,pankhuri-opsmx,5,0.00032,356807,22.85646,1561077
7665,PaoloAtRebelpug,5,0.00032,356812,22.85678,1561077
7666,parkhomenko,5,0.00032,356817,22.85710,1561077
7667,patkinson01,5,0.00032,356822,22.85742,1561077
7668,paulgoldbaum,5,0.00032,356827,22.85775,1561077
7669,paulmarsicloud,5,0.00032,356832,22.85807,1561077
7670,paul-schwendenman,5,0.00032,356837,22.85839,1561077
7671,pbaity,5,0.00032,356842,22.85871,1561077
7672,pbalint,5,0.00032,356847,22.85903,1561077
7673,pcavezzan,5,0.00032,356852,22.85935,1561077
7674,pciazynski,5,0.00032,356857,22.85967,1561077
7675,pdinc-oss,5,0.00032,356862,22.85999,1561077
7676,pecastro,5,0.00032,356867,22.86031,1561077
7677,pedringcoding,5,0.00032,356872,22.86063,1561077
7678,pega-roska,5,0.00032,356877,22.86095,1561077
7679,peimansh,5,0.00032,356882,22.86127,1561077
7680,perrefe,5,0.00032,356887,22.86159,1561077
7681,PetrVlasek,5,0.00032,356892,22.86191,1561077
7682,peymano,5,0.00032,356897,22.86223,1561077
7683,pgardnerjr,5,0.00032,356902,22.86255,1561077
7684,philbert,5,0.00032,356907,22.86287,1561077
7685,philidem,5,0.00032,356912,22.86319,1561077
7686,phillip-elliott,5,0.00032,356917,22.86351,1561077
7687,PhilR73,5,0.00032,356922,22.86383,1561077
7688,phoewass,5,0.00032,356927,22.86415,1561077
7689,phthaocse,5,0.00032,356932,22.86447,1561077
7690,pingbat,5,0.00032,356937,22.86479,1561077
7691,piushkumar,5,0.00032,356942,22.86511,1561077
7692,piyush0101,5,0.00032,356947,22.86543,1561077
7693,pluto-atom-4,5,0.00032,356952,22.86575,1561077
7694,pmbsa,5,0.00032,356957,22.86607,1561077
7695,poloHex,5,0.00032,356962,22.86639,1561077
7696,Poohblah,5,0.00032,356967,22.86671,1561077
7697,pouete,5,0.00032,356972,22.86703,1561077
7698,pporee,5,0.00032,356977,22.86735,1561077
7699,pradeep-kit,5,0.00032,356982,22.86767,1561077
7700,prakashan-prowareness,5,0.00032,356987,22.86799,1561077
7701,prakashtcs,5,0.00032,356992,22.86831,1561077
7702,prathi-mani,5,0.00032,356997,22.86863,1561077
7703,pravka,5,0.00032,357002,22.86896,1561077
7704,priya-jagyasi,5,0.00032,357007,22.86928,1561077
7705,priyajagyasi01,5,0.00032,357012,22.86960,1561077
7706,ProfessorKesha,5,0.00032,357017,22.86992,1561077
7707,Provoostg,5,0.00032,357022,22.87024,1561077
7708,psr,5,0.00032,357027,22.87056,1561077
7709,pstrh,5,0.00032,357032,22.87088,1561077
7710,psych0der,5,0.00032,357037,22.87120,1561077
7711,pulgupta,5,0.00032,357042,22.87152,1561077
7712,punitx,5,0.00032,357047,22.87184,1561077
7713,pvelder,5,0.00032,357052,22.87216,1561077
7714,pwaterz,5,0.00032,357057,22.87248,1561077
7715,pwl89,5,0.00032,357062,22.87280,1561077
7716,pysysops,5,0.00032,357067,22.87312,1561077
7717,qantnull,5,0.00032,357072,22.87344,1561077
7718,qBTp,5,0.00032,357077,22.87376,1561077
7719,qsliu2017,5,0.00032,357082,22.87408,1561077
7720,queueburt,5,0.00032,357087,22.87440,1561077
7721,r4d1um,5,0.00032,357092,22.87472,1561077
7722,radekl,5,0.00032,357097,22.87504,1561077
7723,radnov,5,0.00032,357102,22.87536,1561077
7724,rafitadiaz,5,0.00032,357107,22.87568,1561077
7725,raghulkrishna,5,0.00032,357112,22.87600,1561077
7726,RainerW,5,0.00032,357117,22.87632,1561077
7727,RamanVaskevich1984,5,0.00032,357122,22.87664,1561077
7728,RamchandV,5,0.00032,357127,22.87696,1561077
7729,ramessesii2,5,0.00032,357132,22.87728,1561077
7730,ramtandukarntt,5,0.00032,357137,22.87760,1561077
7731,ramyennapusa,5,0.00032,357142,22.87792,1561077
7732,Rand01ph,5,0.00032,357147,22.87824,1561077
7733,randymay,5,0.00032,357152,22.87856,1561077
7734,ranjitkumar518,5,0.00032,357157,22.87888,1561077
7735,rasheedamir,5,0.00032,357162,22.87920,1561077
7736,ravanscafi,5,0.00032,357167,22.87952,1561077
7737,ravepen,5,0.00032,357172,22.87985,1561077
7738,raymondwu1,5,0.00032,357177,22.88017,1561077
7739,rcao5,5,0.00032,357182,22.88049,1561077
7740,rchopde,5,0.00032,357187,22.88081,1561077
7741,rcsalome,5,0.00032,357192,22.88113,1561077
7742,rdaviscc,5,0.00032,357197,22.88145,1561077
7743,rdonahoe-placed,5,0.00032,357202,22.88177,1561077
7744,reach2jeyan,5,0.00032,357207,22.88209,1561077
7745,realSchoki,5,0.00032,357212,22.88241,1561077
7746,recyard,5,0.00032,357217,22.88273,1561077
7747,redcape,5,0.00032,357222,22.88305,1561077
7748,rednuht,5,0.00032,357227,22.88337,1561077
7749,regazzoj,5,0.00032,357232,22.88369,1561077
7750,reggiebIV,5,0.00032,357237,22.88401,1561077
7751,remm,5,0.00032,357242,22.88433,1561077
7752,rendner,5,0.00032,357247,22.88465,1561077
7753,renedare,5,0.00032,357252,22.88497,1561077
7754,reshadat,5,0.00032,357257,22.88529,1561077
7755,RevinKey,5,0.00032,357262,22.88561,1561077
7756,rezmuh,5,0.00032,357267,22.88593,1561077
7757,rfateam2,5,0.00032,357272,22.88625,1561077
7758,rgaduput,5,0.00032,357277,22.88657,1561077
7759,rgajason,5,0.00032,357282,22.88689,1561077
7760,rgreil,5,0.00032,357287,22.88721,1561077
7761,rhubert,5,0.00032,357292,22.88753,1561077
7762,ricardochimal,5,0.00032,357297,22.88785,1561077
7763,ricardogarfe,5,0.00032,357302,22.88817,1561077
7764,richard1122,5,0.00032,357307,22.88849,1561077
7765,richardfearn,5,0.00032,357312,22.88881,1561077
7766,richardpringle,5,0.00032,357317,22.88913,1561077
7767,richardwhiuk,5,0.00032,357322,22.88945,1561077
7768,RichardWilder,5,0.00032,357327,22.88977,1561077
7769,Riduidel,5,0.00032,357332,22.89009,1561077
7770,rigoford,5,0.00032,357337,22.89041,1561077
7771,rishi-manidhar,5,0.00032,357342,22.89074,1561077
7772,riy,5,0.00032,357347,22.89106,1561077
7773,rjackowens,5,0.00032,357352,22.89138,1561077
7774,rkrzewski,5,0.00032,357357,22.89170,1561077
7775,rmestrum,5,0.00032,357362,22.89202,1561077
7776,rnelson0,5,0.00032,357367,22.89234,1561077
7777,rnikoopour,5,0.00032,357372,22.89266,1561077
7778,rnt,5,0.00032,357377,22.89298,1561077
7779,roger-king,5,0.00032,357382,22.89330,1561077
7780,rogerswingle,5,0.00032,357387,22.89362,1561077
7781,rolnick,5,0.00032,357392,22.89394,1561077
7782,rongronglai,5,0.00032,357397,22.89426,1561077
7783,rorsten,5,0.00032,357402,22.89458,1561077
7784,rowlandwatkins,5,0.00032,357407,22.89490,1561077
7785,roxspring,5,0.00032,357412,22.89522,1561077
7786,rpk2msu,5,0.00032,357417,22.89554,1561077
7787,rraja002,5,0.00032,357422,22.89586,1561077
7788,rremella,5,0.00032,357427,22.89618,1561077
7789,rrybalkin,5,0.00032,357432,22.89650,1561077
7790,rryter,5,0.00032,357437,22.89682,1561077
7791,RTBathula,5,0.00032,357442,22.89714,1561077
7792,rubinus,5,0.00032,357447,22.89746,1561077
7793,ruhrohraggy,5,0.00032,357452,22.89778,1561077
7794,ruoxijiang,5,0.00032,357457,22.89810,1561077
7795,rvanrosmalen,5,0.00032,357462,22.89842,1561077
7796,rvincentatprokarmadotcom,5,0.00032,357467,22.89874,1561077
7797,ryanbuhl-auro,5,0.00032,357472,22.89906,1561077
7798,ryanhankins,5,0.00032,357477,22.89938,1561077
7799,rzhang-nevermore,5,0.00032,357482,22.89970,1561077
7800,s2oBCN,5,0.00032,357487,22.90002,1561077
7801,saadi60pk,5,0.00032,357492,22.90034,1561077
7802,SahuBhaskar,5,0.00032,357497,22.90066,1561077
7803,saisantoshi76,5,0.00032,357502,22.90098,1561077
7804,sakshi-bansal,5,0.00032,357507,22.90130,1561077
7805,salvag-ntt,5,0.00032,357512,22.90162,1561077
7806,sameer1046,5,0.00032,357517,22.90195,1561077
7807,samgabriel,5,0.00032,357522,22.90227,1561077
7808,samling,5,0.00032,357527,22.90259,1561077
7809,samof76,5,0.00032,357532,22.90291,1561077
7810,samueltauil,5,0.00032,357537,22.90323,1561077
7811,sandmule,5,0.00032,357542,22.90355,1561077
7812,Sangaibisi,5,0.00032,357547,22.90387,1561077
7813,sanski,5,0.00032,357552,22.90419,1561077
7814,sbaitmangalkar,5,0.00032,357557,22.90451,1561077
7815,sbussetti,5,0.00032,357562,22.90483,1561077
7816,scawley-r7,5,0.00032,357567,22.90515,1561077
7817,sce81,5,0.00032,357572,22.90547,1561077
7818,schlitzered,5,0.00032,357577,22.90579,1561077
7819,SchwaFa,5,0.00032,357582,22.90611,1561077
7820,scothren,5,0.00032,357587,22.90643,1561077
7821,scotty-g,5,0.00032,357592,22.90675,1561077
7822,sdarwin,5,0.00032,357597,22.90707,1561077
7823,sealor,5,0.00032,357602,22.90739,1561077
7824,seanchan,5,0.00032,357607,22.90771,1561077
7825,SebastienGllmt,5,0.00032,357612,22.90803,1561077
7826,seelmann,5,0.00032,357617,22.90835,1561077
7827,selste,5,0.00032,357622,22.90867,1561077
7828,senips,5,0.00032,357627,22.90899,1561077
7829,sepulvedablanco,5,0.00032,357632,22.90931,1561077
7830,sereinity,5,0.00032,357637,22.90963,1561077
7831,SergK,5,0.00032,357642,22.90995,1561077
7832,serhatates-invicti,5,0.00032,357647,22.91027,1561077
7833,serhii-kuzniechykov,5,0.00032,357652,22.91059,1561077
7834,serhiy-krupka-vitech,5,0.00032,357657,22.91091,1561077
7835,sesinando2,5,0.00032,357662,22.91123,1561077
7836,seunaw,5,0.00032,357667,22.91155,1561077
7837,sgargel,5,0.00032,357672,22.91187,1561077
7838,sgybas,5,0.00032,357677,22.91219,1561077
7839,shaharon,5,0.00032,357682,22.91251,1561077
7840,shanedownes-dmi,5,0.00032,357687,22.91284,1561077
7841,shanman190,5,0.00032,357692,22.91316,1561077
7842,sharad-amu,5,0.00032,357697,22.91348,1561077
7843,shark-horse,5,0.00032,357702,22.91380,1561077
7844,sharksforarms,5,0.00032,357707,22.91412,1561077
7845,shashipratap,5,0.00032,357712,22.91444,1561077
7846,shasi24,5,0.00032,357717,22.91476,1561077
7847,shehzan10,5,0.00032,357722,22.91508,1561077
7848,sheuser,5,0.00032,357727,22.91540,1561077
7849,shevek,5,0.00032,357732,22.91572,1561077
7850,shikage,5,0.00032,357737,22.91604,1561077
7851,shoffmeister,5,0.00032,357742,22.91636,1561077
7852,Shovinus,5,0.00032,357747,22.91668,1561077
7853,ShreyanBudhouliya,5,0.00032,357752,22.91700,1561077
7854,shubhamunthinkable1,5,0.00032,357757,22.91732,1561077
7855,Siegfriedk,5,0.00032,357762,22.91764,1561077
7856,siepkes,5,0.00032,357767,22.91796,1561077
7857,silphid,5,0.00032,357772,22.91828,1561077
7858,SimonCMoore,5,0.00032,357777,22.91860,1561077
7859,SimonElfvingElekta,5,0.00032,357782,22.91892,1561077
7860,sinisa229,5,0.00032,357787,22.91924,1561077
7861,sipage,5,0.00032,357792,22.91956,1561077
7862,sitaorg2022,5,0.00032,357797,22.91988,1561077
7863,sivachandran-s,5,0.00032,357802,22.92020,1561077
7864,six-lqx,5,0.00032,357807,22.92052,1561077
7865,SJrX,5,0.00032,357812,22.92084,1561077
7866,Skreet2k,5,0.00032,357817,22.92116,1561077
7867,slaout,5,0.00032,357822,22.92148,1561077
7868,slaughter550,5,0.00032,357827,22.92180,1561077
7869,SlayerBirden,5,0.00032,357832,22.92212,1561077
7870,sleepypikachu,5,0.00032,357837,22.92244,1561077
7871,smacnak,5,0.00032,357842,22.92276,1561077
7872,smarklund,5,0.00032,357847,22.92308,1561077
7873,smastrorocco,5,0.00032,357852,22.92340,1561077
7874,smehrbrodt,5,0.00032,357857,22.92373,1561077
7875,smpeters,5,0.00032,357862,22.92405,1561077
7876,smurf667,5,0.00032,357867,22.92437,1561077
7877,smurugesh1686,5,0.00032,357872,22.92469,1561077
7878,smuthuswamy,5,0.00032,357877,22.92501,1561077
7879,snowymike,5,0.00032,357882,22.92533,1561077
7880,sonykus,5,0.00032,357887,22.92565,1561077
7881,soyeonlim,5,0.00032,357892,22.92597,1561077
7882,spalanisamymf,5,0.00032,357897,22.92629,1561077
7883,sporkisfaster,5,0.00032,357902,22.92661,1561077
7884,sps,5,0.00032,357907,22.92693,1561077
7885,SqREL,5,0.00032,357912,22.92725,1561077
7886,srinvasdevop,5,0.00032,357917,22.92757,1561077
7887,srisek,5,0.00032,357922,22.92789,1561077
7888,srz-zumix,5,0.00032,357927,22.92821,1561077
7889,sschroep,5,0.00032,357932,22.92853,1561077
7890,sstncr,5,0.00032,357937,22.92885,1561077
7891,staniere,5,0.00032,357942,22.92917,1561077
7892,stdunbar,5,0.00032,357947,22.92949,1561077
7893,StefanHirche,5,0.00032,357952,22.92981,1561077
7894,StefanIGit,5,0.00032,357957,22.93013,1561077
7895,stefantinger,5,0.00032,357962,22.93045,1561077
7896,stefanverhoeff,5,0.00032,357967,22.93077,1561077
7897,steigr,5,0.00032,357972,22.93109,1561077
7898,steinKo,5,0.00032,357977,22.93141,1561077
7899,stephanie-Mo,5,0.00032,357982,22.93173,1561077
7900,sterrana11,5,0.00032,357987,22.93205,1561077
7901,steveames,5,0.00032,357992,22.93237,1561077
7902,stevendpclark,5,0.00032,357997,22.93269,1561077
7903,steveny91,5,0.00032,358002,22.93301,1561077
7904,stewartmiles,5,0.00032,358007,22.93333,1561077
7905,strandlie,5,0.00032,358012,22.93365,1561077
7906,STRML,5,0.00032,358017,22.93397,1561077
7907,stupiddog1979,5,0.00032,358022,22.93429,1561077
7908,Stupnikov-NA,5,0.00032,358027,22.93462,1561077
7909,StyleT,5,0.00032,358032,22.93494,1561077
7910,subahm,5,0.00032,358037,22.93526,1561077
7911,suhuruli,5,0.00032,358042,22.93558,1561077
7912,sunnoy,5,0.00032,358047,22.93590,1561077
7913,supermodo,5,0.00032,358052,22.93622,1561077
7914,surrettcharles,5,0.00032,358057,22.93654,1561077
7915,susandip,5,0.00032,358062,22.93686,1561077
7916,svallepu,5,0.00032,358067,22.93718,1561077
7917,svenbs,5,0.00032,358072,22.93750,1561077
7918,sverdlov93,5,0.00032,358077,22.93782,1561077
7919,swatipersistent,5,0.00032,358082,22.93814,1561077
7920,sysadmin1139,5,0.00032,358087,22.93846,1561077
7921,szigetigabor,5,0.00032,358092,22.93878,1561077
7922,taebox,5,0.00032,358097,22.93910,1561077
7923,talarian1,5,0.00032,358102,22.93942,1561077
7924,taoes,5,0.00032,358107,22.93974,1561077
7925,tartur,5,0.00032,358112,22.94006,1561077
7926,tatebosler,5,0.00032,358117,22.94038,1561077
7927,taurus-forever,5,0.00032,358122,22.94070,1561077
7928,teameh,5,0.00032,358127,22.94102,1561077
7929,teodor20,5,0.00032,358132,22.94134,1561077
7930,teramawi,5,0.00032,358137,22.94166,1561077
7931,test2016new,5,0.00032,358142,22.94198,1561077
7932,testowyludek1234,5,0.00032,358147,22.94230,1561077
7933,tetrar124,5,0.00032,358152,22.94262,1561077
7934,TGippert,5,0.00032,358157,22.94294,1561077
7935,t-hall,5,0.00032,358162,22.94326,1561077
7936,thavlik,5,0.00032,358167,22.94358,1561077
7937,TheeRFG,5,0.00032,358172,22.94390,1561077
7938,thepwagner,5,0.00032,358177,22.94422,1561077
7939,TheSpy,5,0.00032,358182,22.94454,1561077
7940,thiagotrentin,5,0.00032,358187,22.94486,1561077
7941,thibaut-sticky,5,0.00032,358192,22.94518,1561077
7942,thilomack,5,0.00032,358197,22.94550,1561077
7943,ThmX,5,0.00032,358202,22.94583,1561077
7944,thomasboni,5,0.00032,358207,22.94615,1561077
7945,thomasfox,5,0.00032,358212,22.94647,1561077
7946,ThomWee,5,0.00032,358217,22.94679,1561077
7947,ThorstenHacke,5,0.00032,358222,22.94711,1561077
7948,tibidi,5,0.00032,358227,22.94743,1561077
7949,tiger74s,5,0.00032,358232,22.94775,1561077
7950,TiMBuS,5,0.00032,358237,22.94807,1561077
7951,timguy,5,0.00032,358242,22.94839,1561077
7952,timini,5,0.00032,358247,22.94871,1561077
7953,timsutton,5,0.00032,358252,22.94903,1561077
7954,tisto,5,0.00032,358257,22.94935,1561077
7955,tjmilligan,5,0.00032,358262,22.94967,1561077
7956,tkensiski,5,0.00032,358267,22.94999,1561077
7957,tlwhitec,5,0.00032,358272,22.95031,1561077
7958,tobiasherzke,5,0.00032,358277,22.95063,1561077
7959,Tobisaninfo,5,0.00032,358282,22.95095,1561077
7960,tofuatgit,5,0.00032,358287,22.95127,1561077
7961,Tohaker,5,0.00032,358292,22.95159,1561077
7962,toidiu,5,0.00032,358297,22.95191,1561077
7963,tom20180101,5,0.00032,358302,22.95223,1561077
7964,TomaszKlosinski,5,0.00032,358307,22.95255,1561077
7965,tombevers,5,0.00032,358312,22.95287,1561077
7966,TomGudman,5,0.00032,358317,22.95319,1561077
7967,tomswallaRH,5,0.00032,358322,22.95351,1561077
7968,tonyjchong,5,0.00032,358327,22.95383,1561077
7969,Tony-Proum,5,0.00032,358332,22.95415,1561077
7970,toomer,5,0.00032,358337,22.95447,1561077
7971,topalach,5,0.00032,358342,22.95479,1561077
7972,toshihirock,5,0.00032,358347,22.95511,1561077
7973,tpaimpar,5,0.00032,358352,22.95543,1561077
7974,tpeyrard,5,0.00032,358357,22.95575,1561077
7975,tpoerio-argo,5,0.00032,358362,22.95607,1561077
7976,trey2001,5,0.00032,358367,22.95639,1561077
7977,triantium,5,0.00032,358372,22.95672,1561077
7978,tricketg,5,0.00032,358377,22.95704,1561077
7979,triplem,5,0.00032,358382,22.95736,1561077
7980,triquell,5,0.00032,358387,22.95768,1561077
7981,tritruong,5,0.00032,358392,22.95800,1561077
7982,trunov-ms,5,0.00032,358397,22.95832,1561077
7983,tsboris,5,0.00032,358402,22.95864,1561077
7984,tsmoreland,5,0.00032,358407,22.95896,1561077
7985,tsondergaard,5,0.00032,358412,22.95928,1561077
7986,tspanindra,5,0.00032,358417,22.95960,1561077
7987,tullydwyer,5,0.00032,358422,22.95992,1561077
7988,turboscholz,5,0.00032,358427,22.96024,1561077
7989,turulb,5,0.00032,358432,22.96056,1561077
7990,tusharsisode,5,0.00032,358437,22.96088,1561077
7991,Twb3,5,0.00032,358442,22.96120,1561077
7992,TwoStone,5,0.00032,358447,22.96152,1561077
7993,tybook,5,0.00032,358452,22.96184,1561077
7994,TylerLu,5,0.00032,358457,22.96216,1561077
7995,uhanisch,5,0.00032,358462,22.96248,1561077
7996,ujkim,5,0.00032,358467,22.96280,1561077
7997,ukayani,5,0.00032,358472,22.96312,1561077
7998,unickq,5,0.00032,358477,22.96344,1561077
7999,uniglot,5,0.00032,358482,22.96376,1561077
8000,unix0r,5,0.00032,358487,22.96408,1561077
8001,Unknwon,5,0.00032,358492,22.96440,1561077
8002,UpdateCw,5,0.00032,358497,22.96472,1561077
8003,urand0m,5,0.00032,358502,22.96504,1561077
8004,urklc,5,0.00032,358507,22.96536,1561077
8005,User284699672,5,0.00032,358512,22.96568,1561077
8006,usernamecantbeXXX,5,0.00032,358517,22.96600,1561077
8007,ustramooner,5,0.00032,358522,22.96632,1561077
8008,usultis,5,0.00032,358527,22.96664,1561077
8009,utkarsh-sharma-dragon,5,0.00032,358532,22.96696,1561077
8010,v1nc3nt27,5,0.00032,358537,22.96728,1561077
8011,vadipp,5,0.00032,358542,22.96761,1561077
8012,ValdarXY,5,0.00032,358547,22.96793,1561077
8013,valenca,5,0.00032,358552,22.96825,1561077
8014,ValeryKomarov,5,0.00032,358557,22.96857,1561077
8015,valtri,5,0.00032,358562,22.96889,1561077
8016,vamsilella,5,0.00032,358567,22.96921,1561077
8017,vanangelov,5,0.00032,358572,22.96953,1561077
8018,varrix,5,0.00032,358577,22.96985,1561077
8019,vasily-v-ryabov,5,0.00032,358582,22.97017,1561077
8020,vaskrist,5,0.00032,358587,22.97049,1561077
8021,Vestail,5,0.00032,358592,22.97081,1561077
8022,vgantam,5,0.00032,358597,22.97113,1561077
8023,Victor88400,5,0.00032,358602,22.97145,1561077
8024,victorlopezsalazar,5,0.00032,358607,22.97177,1561077
8025,vijaypitla,5,0.00032,358612,22.97209,1561077
8026,vinay879088,5,0.00032,358617,22.97241,1561077
8027,VinoSakthi,5,0.00032,358622,22.97273,1561077
8028,viraj2,5,0.00032,358627,22.97305,1561077
8029,vishal-elimu,5,0.00032,358632,22.97337,1561077
8030,vitalis,5,0.00032,358637,22.97369,1561077
8031,vitalykr,5,0.00032,358642,22.97401,1561077
8032,vivganes,5,0.00032,358647,22.97433,1561077
8033,vladkoto-rtu,5,0.00032,358652,22.97465,1561077
8034,vogtmh,5,0.00032,358657,22.97497,1561077
8035,voiski,5,0.00032,358662,22.97529,1561077
8036,VonLatvala,5,0.00032,358667,22.97561,1561077
8037,Voyen,5,0.00032,358672,22.97593,1561077
8038,vpernankil,5,0.00032,358677,22.97625,1561077
8039,vrockai,5,0.00032,358682,22.97657,1561077
8040,vsfalexanderpilch,5,0.00032,358687,22.97689,1561077
8041,w32-blaster,5,0.00032,358692,22.97721,1561077
8042,wadehephner,5,0.00032,358697,22.97753,1561077
8043,wahammed,5,0.00032,358702,22.97785,1561077
8044,walli545,5,0.00032,358707,22.97817,1561077
8045,wang-xinhong,5,0.00032,358712,22.97849,1561077
8046,wangzhenzhe,5,0.00032,358717,22.97882,1561077
8047,way2awscloud,5,0.00032,358722,22.97914,1561077
8048,wburgers,5,0.00032,358727,22.97946,1561077
8049,webmailcontatos,5,0.00032,358732,22.97978,1561077
8050,weigxnow,5,0.00032,358737,22.98010,1561077
8051,weitie-okta,5,0.00032,358742,22.98042,1561077
8052,wheelhorse,5,0.00032,358747,22.98074,1561077
8053,widerlund,5,0.00032,358752,22.98106,1561077
8054,wikimore,5,0.00032,358757,22.98138,1561077
8055,wilrnh,5,0.00032,358762,22.98170,1561077
8056,wilstdu,5,0.00032,358767,22.98202,1561077
8057,win5do,5,0.00032,358772,22.98234,1561077
8058,wincrasher,5,0.00032,358777,22.98266,1561077
8059,winotu,5,0.00032,358782,22.98298,1561077
8060,wlchan,5,0.00032,358787,22.98330,1561077
8061,wushujames,5,0.00032,358792,22.98362,1561077
8062,x4team,5,0.00032,358797,22.98394,1561077
8063,xabinapal,5,0.00032,358802,22.98426,1561077
8064,xdumaine,5,0.00032,358807,22.98458,1561077
8065,Xennis,5,0.00032,358812,22.98490,1561077
8066,xenoterracide,5,0.00032,358817,22.98522,1561077
8067,XiaoBoya,5,0.00032,358822,22.98554,1561077
8068,xinnjie,5,0.00032,358827,22.98586,1561077
8069,Xylakant,5,0.00032,358832,22.98618,1561077
8070,Yablargo,5,0.00032,358837,22.98650,1561077
8071,yashra,5,0.00032,358842,22.98682,1561077
8072,yili1992,5,0.00032,358847,22.98714,1561077
8073,yinheli,5,0.00032,358852,22.98746,1561077
8074,yipmarvel,5,0.00032,358857,22.98778,1561077
8075,yknaveentel,5,0.00032,358862,22.98810,1561077
8076,Yonnatan,5,0.00032,358867,22.98842,1561077
8077,yrainik-godaddy,5,0.00032,358872,22.98874,1561077
8078,ysde,5,0.00032,358877,22.98906,1561077
8079,yudizianravi,5,0.00032,358882,22.98938,1561077
8080,YugandharBandari,5,0.00032,358887,22.98971,1561077
8081,YunLemon,5,0.00032,358892,22.99003,1561077
8082,yuwenhui,5,0.00032,358897,22.99035,1561077
8083,ZachDev1,5,0.00032,358902,22.99067,1561077
8084,Zauxst,5,0.00032,358907,22.99099,1561077
8085,ZeBidule,5,0.00032,358912,22.99131,1561077
8086,zeroum,5,0.00032,358917,22.99163,1561077
8087,zhangzhang,5,0.00032,358922,22.99195,1561077
8088,zhaogp,5,0.00032,358927,22.99227,1561077
8089,zhaoyi0113,5,0.00032,358932,22.99259,1561077
8090,zherkezhi,5,0.00032,358937,22.99291,1561077
8091,zhidongnick,5,0.00032,358942,22.99323,1561077
8092,zhming0,5,0.00032,358947,22.99355,1561077
8093,zhouchong90,5,0.00032,358952,22.99387,1561077
8094,ziyi-bear,5,0.00032,358957,22.99419,1561077
8095,zjgoodman,5,0.00032,358962,22.99451,1561077
8096,zmanxiang,5,0.00032,358967,22.99483,1561077
8097,zucher,5,0.00032,358972,22.99515,1561077
8098,013k-m,4,0.00026,358976,22.99541,1561077
8099,07souravkunda,4,0.00026,358980,22.99566,1561077
8100,0bp,4,0.00026,358984,22.99592,1561077
8101,0x41head,4,0.00026,358988,22.99618,1561077
8102,0x5e,4,0.00026,358992,22.99643,1561077
8103,120011676,4,0.00026,358996,22.99669,1561077
8104,1arrcy1,4,0.00026,359000,22.99694,1561077
8105,1w2w3y,4,0.00026,359004,22.99720,1561077
8106,2ZZ,4,0.00026,359008,22.99746,1561077
8107,370672701,4,0.00026,359012,22.99771,1561077
8108,4lex4nolr,4,0.00026,359016,22.99797,1561077
8109,95rade,4,0.00026,359020,22.99822,1561077
8110,a8trejo,4,0.00026,359024,22.99848,1561077
8111,aabrahamian,4,0.00026,359028,22.99874,1561077
8112,Aaron1989,4,0.00026,359032,22.99899,1561077
8113,AaronME14,4,0.00026,359036,22.99925,1561077
8114,Abel0916,4,0.00026,359040,22.99951,1561077
8115,abg1979,4,0.00026,359044,22.99976,1561077
8116,abhaysr,4,0.00026,359048,23.00002,1561077
8117,abhishek-bidgely,4,0.00026,359052,23.00027,1561077
8118,AbirDas,4,0.00026,359056,23.00053,1561077
8119,ablundgren,4,0.00026,359060,23.00079,1561077
8120,abohne,4,0.00026,359064,23.00104,1561077
8121,abrys,4,0.00026,359068,23.00130,1561077
8122,aburkevics,4,0.00026,359072,23.00156,1561077
8123,AdamGoldsmith,4,0.00026,359076,23.00181,1561077
8124,adamvoss,4,0.00026,359080,23.00207,1561077
8125,adamxchen,4,0.00026,359084,23.00232,1561077
8126,adericbourg,4,0.00026,359088,23.00258,1561077
8127,adnan1605,4,0.00026,359092,23.00284,1561077
8128,adoorbijoy,4,0.00026,359096,23.00309,1561077
8130,aedwards-act,4,0.00026,359104,23.00361,1561077
8131,aeos,4,0.00026,359108,23.00386,1561077
8132,aeroclee,4,0.00026,359112,23.00412,1561077
8133,afbot,4,0.00026,359116,23.00437,1561077
8134,afewellvmware,4,0.00026,359120,23.00463,1561077
8135,afischer211,4,0.00026,359124,23.00489,1561077
8136,agarthetiger,4,0.00026,359128,23.00514,1561077
8137,agk2,4,0.00026,359132,23.00540,1561077
8138,agrawalpalash,4,0.00026,359136,23.00566,1561077
8139,ahcorde,4,0.00026,359140,23.00591,1561077
8140,ahirreddy,4,0.00026,359144,23.00617,1561077
8141,ahmetcetin,4,0.00026,359148,23.00642,1561077
8142,ahoisl,4,0.00026,359152,23.00668,1561077
8143,aholen,4,0.00026,359156,23.00694,1561077
8144,Aigrefin,4,0.00026,359160,23.00719,1561077
8145,aimetci,4,0.00026,359164,23.00745,1561077
8146,aiqdevops,4,0.00026,359168,23.00771,1561077
8147,AirOnSkin,4,0.00026,359172,23.00796,1561077
8148,ajaygm,4,0.00026,359176,23.00822,1561077
8149,ajazmohammed022,4,0.00026,359180,23.00847,1561077
8150,ajhd,4,0.00026,359184,23.00873,1561077
8151,ajsandham,4,0.00026,359188,23.00899,1561077
8152,akaRem,4,0.00026,359192,23.00924,1561077
8153,akatsadimas,4,0.00026,359196,23.00950,1561077
8154,akdor1154,4,0.00026,359200,23.00976,1561077
8155,akshayahuja2187,4,0.00026,359204,23.01001,1561077
8156,akshayubale1,4,0.00026,359208,23.01027,1561077
8157,akuntsch,4,0.00026,359212,23.01052,1561077
8158,alainlecluse,4,0.00026,359216,23.01078,1561077
8159,alanmoment,4,0.00026,359220,23.01104,1561077
8160,alanranciato,4,0.00026,359224,23.01129,1561077
8161,AlberTajuelo,4,0.00026,359228,23.01155,1561077
8162,aldanchenko,4,0.00026,359232,23.01181,1561077
8163,Alegrowin,4,0.00026,359236,23.01206,1561077
8164,aleklukashevich,4,0.00026,359240,23.01232,1561077
8165,Aleksei-Badyaev,4,0.00026,359244,23.01257,1561077
8166,aleksejlopasov,4,0.00026,359248,23.01283,1561077
8167,alertedsnake,4,0.00026,359252,23.01309,1561077
8168,alexandre-zia-movile,4,0.00026,359256,23.01334,1561077
8169,alexandruluca,4,0.00026,359260,23.01360,1561077
8170,alexashley,4,0.00026,359264,23.01386,1561077
8171,alexb2539,4,0.00026,359268,23.01411,1561077
8172,alexindigo,4,0.00026,359272,23.01437,1561077
8173,alexis2b,4,0.00026,359276,23.01462,1561077
8174,alexKazarin,4,0.00026,359280,23.01488,1561077
8175,alex-leonhardt,4,0.00026,359284,23.01514,1561077
8176,alex-marchenko,4,0.00026,359288,23.01539,1561077
8177,alexschwantes,4,0.00026,359292,23.01565,1561077
8178,alex-stark,4,0.00026,359296,23.01591,1561077
8179,alexwhitman,4,0.00026,359300,23.01616,1561077
8180,alex-yh99,4,0.00026,359304,23.01642,1561077
8181,AliDev0ps,4,0.00026,359308,23.01667,1561077
8182,allsuper,4,0.00026,359312,23.01693,1561077
8183,Allure996,4,0.00026,359316,23.01719,1561077
8184,almed4,4,0.00026,359320,23.01744,1561077
8185,alonm-totango,4,0.00026,359324,23.01770,1561077
8186,alonweiss-sl,4,0.00026,359328,23.01795,1561077
8187,alpushkarev,4,0.00026,359332,23.01821,1561077
8188,alshain,4,0.00026,359336,23.01847,1561077
8189,alterdego,4,0.00026,359340,23.01872,1561077
8190,aluczakSumo,4,0.00026,359344,23.01898,1561077
8191,amaanbs,4,0.00026,359348,23.01924,1561077
8192,amantur,4,0.00026,359352,23.01949,1561077
8193,AmarettoSlim,4,0.00026,359356,23.01975,1561077
8194,a-melnyk,4,0.00026,359360,23.02000,1561077
8195,amerrit2,4,0.00026,359364,23.02026,1561077
8196,amiryeshooroon,4,0.00026,359368,23.02052,1561077
8197,amitgera,4,0.00026,359372,23.02077,1561077
8198,AmitJMagar,4,0.00026,359376,23.02103,1561077
8199,amitmodak,4,0.00026,359380,23.02129,1561077
8200,Amiya-873,4,0.00026,359384,23.02154,1561077
8201,amoosbr,4,0.00026,359388,23.02180,1561077
8202,Amos-85,4,0.00026,359392,23.02205,1561077
8203,amotl,4,0.00026,359396,23.02231,1561077
8204,anallely,4,0.00026,359400,23.02257,1561077
8205,anandagirish2,4,0.00026,359404,23.02282,1561077
8206,ananthakeshavabs-path,4,0.00026,359408,23.02308,1561077
8207,anderssonjohan,4,0.00026,359412,23.02334,1561077
8208,Andra-Maria-Puscas,4,0.00026,359416,23.02359,1561077
8209,andreasgalek,4,0.00026,359420,23.02385,1561077
8210,andreatera,4,0.00026,359424,23.02410,1561077
8211,andregmoeller,4,0.00026,359428,23.02436,1561077
8212,andregri,4,0.00026,359432,23.02462,1561077
8213,andrehcampos,4,0.00026,359436,23.02487,1561077
8214,andrei-barna,4,0.00026,359440,23.02513,1561077
8215,AndreiVidrasco,4,0.00026,359444,23.02539,1561077
8216,andreroggeri,4,0.00026,359448,23.02564,1561077
8217,andretadeu,4,0.00026,359452,23.02590,1561077
8218,andrewbonney,4,0.00026,359456,23.02615,1561077
8219,AndrewChubatiuk,4,0.00026,359460,23.02641,1561077
8220,andrewfraley,4,0.00026,359464,23.02667,1561077
8221,andrewlorien,4,0.00026,359468,23.02692,1561077
8222,andrewmelnyk,4,0.00026,359472,23.02718,1561077
8223,andrewrch,4,0.00026,359476,23.02744,1561077
8224,andreybpanfilov,4,0.00026,359480,23.02769,1561077
8225,androa,4,0.00026,359484,23.02795,1561077
8226,Andykaban,4,0.00026,359488,23.02820,1561077
8227,andyuk1986,4,0.00026,359492,23.02846,1561077
8228,aneeshd16,4,0.00026,359496,23.02872,1561077
8229,Angelina1984,4,0.00026,359500,23.02897,1561077
8230,angheladrianclaudiu,4,0.00026,359504,23.02923,1561077
8231,AngledLuffa,4,0.00026,359508,23.02949,1561077
8232,anilkumars,4,0.00026,359512,23.02974,1561077
8233,ankitbrgy123,4,0.00026,359516,23.03000,1561077
8234,ankitgupta07,4,0.00026,359520,23.03025,1561077
8235,ankitsuhane,4,0.00026,359524,23.03051,1561077
8236,annicarol,4,0.00026,359528,23.03077,1561077
8237,anoyo-lin,4,0.00026,359532,23.03102,1561077
8238,anshckr,4,0.00026,359536,23.03128,1561077
8239,ansig,4,0.00026,359540,23.03154,1561077
8240,ansky,4,0.00026,359544,23.03179,1561077
8241,anth0d,4,0.00026,359548,23.03205,1561077
8242,anthonyagresta,4,0.00026,359552,23.03230,1561077
8243,anthonyemerson,4,0.00026,359556,23.03256,1561077
8244,antonio-osorio,4,0.00026,359560,23.03282,1561077
8245,appcara,4,0.00026,359564,23.03307,1561077
8246,apr-1985,4,0.00026,359568,23.03333,1561077
8247,aprowe,4,0.00026,359572,23.03359,1561077
8248,aquintiliano,4,0.00026,359576,23.03384,1561077
8249,areese,4,0.00026,359580,23.03410,1561077
8250,areswxin,4,0.00026,359584,23.03435,1561077
8251,aridastidar,4,0.00026,359588,23.03461,1561077
8252,aripringle,4,0.00026,359592,23.03487,1561077
8253,arjantijms,4,0.00026,359596,23.03512,1561077
8254,ArkadiuszSkalski-TomTom,4,0.00026,359600,23.03538,1561077
8255,Arodus,4,0.00026,359604,23.03564,1561077
8256,arolsmith,4,0.00026,359608,23.03589,1561077
8257,arpheno,4,0.00026,359612,23.03615,1561077
8258,arsdehnel,4,0.00026,359616,23.03640,1561077
8259,arshakanjum,4,0.00026,359620,23.03666,1561077
8260,Artem1000I,4,0.00026,359624,23.03692,1561077
8261,arunmastermind,4,0.00026,359628,23.03717,1561077
8262,ARUNMOHANRAJ471,4,0.00026,359632,23.03743,1561077
8263,arvindrajpurohit,4,0.00026,359636,23.03768,1561077
8264,arzarif,4,0.00026,359640,23.03794,1561077
8265,asambstack,4,0.00026,359644,23.03820,1561077
8266,aservera,4,0.00026,359648,23.03845,1561077
8267,AshishKmrSingh,4,0.00026,359652,23.03871,1561077
8268,ashleysommer,4,0.00026,359656,23.03897,1561077
8269,ashutoshcp,4,0.00026,359660,23.03922,1561077
8270,ashutoshg,4,0.00026,359664,23.03948,1561077
8271,AshwinPai1981,4,0.00026,359668,23.03973,1561077
8272,asiekkowa,4,0.00026,359672,23.03999,1561077
8273,asmorkalov,4,0.00026,359676,23.04025,1561077
8274,astellingwerf,4,0.00026,359680,23.04050,1561077
8275,asthomasdk,4,0.00026,359684,23.04076,1561077
8276,Astro03,4,0.00026,359688,23.04102,1561077
8277,athom,4,0.00026,359692,23.04127,1561077
8278,atl-code-2828,4,0.00026,359696,23.04153,1561077
8279,ATRG,4,0.00026,359700,23.04178,1561077
8280,Attoy,4,0.00026,359704,23.04204,1561077
8281,aucfan-makise,4,0.00026,359708,23.04230,1561077
8282,aundrus,4,0.00026,359712,23.04255,1561077
8283,aurelije,4,0.00026,359716,23.04281,1561077
8284,aushafy,4,0.00026,359720,23.04307,1561077
8285,austinnichols101,4,0.00026,359724,23.04332,1561077
8286,avadhut007,4,0.00026,359728,23.04358,1561077
8287,avinashsingh6,4,0.00026,359732,23.04383,1561077
8288,aweiker,4,0.00026,359736,23.04409,1561077
8289,azelezni,4,0.00026,359740,23.04435,1561077
8290,Azleal,4,0.00026,359744,23.04460,1561077
8291,b18050,4,0.00026,359748,23.04486,1561077
8292,bahetianurag,4,0.00026,359752,23.04512,1561077
8293,BalamuralikrishnaDommeti,4,0.00026,359756,23.04537,1561077
8294,baldeynz,4,0.00026,359760,23.04563,1561077
8295,balleman-tt,4,0.00026,359764,23.04588,1561077
8296,Balthov60,4,0.00026,359768,23.04614,1561077
8297,balux,4,0.00026,359772,23.04640,1561077
8298,Bandy8,4,0.00026,359776,23.04665,1561077
8299,banjoh,4,0.00026,359780,23.04691,1561077
8300,barnacs,4,0.00026,359784,23.04717,1561077
8301,barney2k7,4,0.00026,359788,23.04742,1561077
8302,BartjeD,4,0.00026,359792,23.04768,1561077
8303,bartsqueezy,4,0.00026,359796,23.04793,1561077
8304,bartvangeneugden,4,0.00026,359800,23.04819,1561077
8305,bascht,4,0.00026,359804,23.04845,1561077
8306,BasiliusCarver,4,0.00026,359808,23.04870,1561077
8307,basiq-brad,4,0.00026,359812,23.04896,1561077
8308,BastienAr,4,0.00026,359816,23.04922,1561077
8309,bavaria95,4,0.00026,359820,23.04947,1561077
8310,bbaumann,4,0.00026,359824,23.04973,1561077
8311,bbzg,4,0.00026,359828,23.04998,1561077
8312,BCircleTech,4,0.00026,359832,23.05024,1561077
8313,bconey,4,0.00026,359836,23.05050,1561077
8314,bdragon28,4,0.00026,359840,23.05075,1561077
8315,bdsl,4,0.00026,359844,23.05101,1561077
8316,Beelzebu,4,0.00026,359848,23.05127,1561077
8317,bekriebel,4,0.00026,359852,23.05152,1561077
8318,belaytzev,4,0.00026,359856,23.05178,1561077
8319,benclarkwood,4,0.00026,359860,23.05203,1561077
8320,bendem,4,0.00026,359864,23.05229,1561077
8321,benemon,4,0.00026,359868,23.05255,1561077
8322,benFromMabl,4,0.00026,359872,23.05280,1561077
8323,bengineer-,4,0.00026,359876,23.05306,1561077
8324,benjcleveland,4,0.00026,359880,23.05332,1561077
8325,benkebhb,4,0.00026,359884,23.05357,1561077
8326,benzht,4,0.00026,359888,23.05383,1561077
8327,bericoberin,4,0.00026,359892,23.05408,1561077
8328,bernolanger,4,0.00026,359896,23.05434,1561077
8329,betonpl,4,0.00026,359900,23.05460,1561077
8330,bgood,4,0.00026,359904,23.05485,1561077
8331,bhamail,4,0.00026,359908,23.05511,1561077
8332,bharathijo,4,0.00026,359912,23.05536,1561077
8333,bharatmicrosystems,4,0.00026,359916,23.05562,1561077
8334,bhpike65,4,0.00026,359920,23.05588,1561077
8335,bhumarevb,4,0.00026,359924,23.05613,1561077
8336,biancl,4,0.00026,359928,23.05639,1561077
8337,BigFatDog,4,0.00026,359932,23.05665,1561077
8338,BIGPHATTOBY,4,0.00026,359936,23.05690,1561077
8339,bilalsbl,4,0.00026,359940,23.05716,1561077
8340,BilelYahia,4,0.00026,359944,23.05741,1561077
8341,bipolar,4,0.00026,359948,23.05767,1561077
8342,bitemyapp,4,0.00026,359952,23.05793,1561077
8343,bitrunner,4,0.00026,359956,23.05818,1561077
8344,bitsydarel,4,0.00026,359960,23.05844,1561077
8345,bjrke,4,0.00026,359964,23.05870,1561077
8346,bkcummins,4,0.00026,359968,23.05895,1561077
8347,blacelle,4,0.00026,359972,23.05921,1561077
8348,Blackbaud-TreySanterre,4,0.00026,359976,23.05946,1561077
8349,blacksheep--,4,0.00026,359980,23.05972,1561077
8350,blee1170,4,0.00026,359984,23.05998,1561077
8351,blubzel,4,0.00026,359988,23.06023,1561077
8352,bm7150,4,0.00026,359992,23.06049,1561077
8353,bmagistro,4,0.00026,359996,23.06075,1561077
8354,bmauldin,4,0.00026,360000,23.06100,1561077
8355,bober2000,4,0.00026,360004,23.06126,1561077
8356,bojanfilipovic,4,0.00026,360008,23.06151,1561077
8357,bombshockdubstep,4,0.00026,360012,23.06177,1561077
8358,Bonifacio2,4,0.00026,360016,23.06203,1561077
8359,borgeorgiev,4,0.00026,360020,23.06228,1561077
8360,boris-github,4,0.00026,360024,23.06254,1561077
8361,botkosmos,4,0.00026,360028,23.06280,1561077
8362,boucains,4,0.00026,360032,23.06305,1561077
8363,boyand,4,0.00026,360036,23.06331,1561077
8364,branden,4,0.00026,360040,23.06356,1561077
8365,braunman,4,0.00026,360044,23.06382,1561077
8366,brianjjoyce,4,0.00026,360048,23.06408,1561077
8367,bruceforlearn,4,0.00026,360052,23.06433,1561077
8368,BrunoLavitForgerock,4,0.00026,360056,23.06459,1561077
8369,Brutus5000,4,0.00026,360060,23.06485,1561077
8370,bryceschober,4,0.00026,360064,23.06510,1561077
8371,bstinsonmhk,4,0.00026,360068,23.06536,1561077
8372,btiernay,4,0.00026,360072,23.06561,1561077
8373,btlogy,4,0.00026,360076,23.06587,1561077
8374,buerkle,4,0.00026,360080,23.06613,1561077
8375,builderall,4,0.00026,360084,23.06638,1561077
8376,bukzor,4,0.00026,360088,23.06664,1561077
8377,buno047,4,0.00026,360092,23.06690,1561077
8378,bwaldvogel,4,0.00026,360096,23.06715,1561077
8379,bweber-psd,4,0.00026,360100,23.06741,1561077
8380,bwolfe,4,0.00026,360104,23.06766,1561077
8381,BZaldua,4,0.00026,360108,23.06792,1561077
8382,c109,4,0.00026,360112,23.06818,1561077
8383,cachavezley,4,0.00026,360116,23.06843,1561077
8384,cafuego,4,0.00026,360120,23.06869,1561077
8385,cakemanny,4,0.00026,360124,23.06895,1561077
8386,caleyg,4,0.00026,360128,23.06920,1561077
8387,calum-cgi,4,0.00026,360132,23.06946,1561077
8388,CameronGo,4,0.00026,360136,23.06971,1561077
8389,camiloribeiro,4,0.00026,360140,23.06997,1561077
8390,caochikai,4,0.00026,360144,23.07023,1561077
8391,CarlInglisBJSS,4,0.00026,360148,23.07048,1561077
8392,carlmacdiarmada,4,0.00026,360152,23.07074,1561077
8393,carlosmmelo,4,0.00026,360156,23.07100,1561077
8394,CarloWakefield,4,0.00026,360160,23.07125,1561077
8395,CarstenEnglert,4,0.00026,360164,23.07151,1561077
8396,carvercj,4,0.00026,360168,23.07176,1561077
8397,cashwu,4,0.00026,360172,23.07202,1561077
8398,caylorme,4,0.00026,360176,23.07228,1561077
8399,cbdchang,4,0.00026,360180,23.07253,1561077
8400,cbernard-psee,4,0.00026,360184,23.07279,1561077
8401,cburch-bb,4,0.00026,360188,23.07305,1561077
8402,ccayg-sainsburys,4,0.00026,360192,23.07330,1561077
8403,ccelebi,4,0.00026,360196,23.07356,1561077
8404,cdll,4,0.00026,360200,23.07381,1561077
8405,CedricLevasseur,4,0.00026,360204,23.07407,1561077
8406,cesarsotovalero,4,0.00026,360208,23.07433,1561077
8407,cfripp,4,0.00026,360212,23.07458,1561077
8408,cgriego,4,0.00026,360216,23.07484,1561077
8409,cgundogan,4,0.00026,360220,23.07509,1561077
8410,chadjiang,4,0.00026,360224,23.07535,1561077
8411,chainsaw-dev,4,0.00026,360228,23.07561,1561077
8412,ChampiYann,4,0.00026,360232,23.07586,1561077
8413,charbl,4,0.00026,360236,23.07612,1561077
8414,chayliu1991,4,0.00026,360240,23.07638,1561077
8415,cheekymonkat,4,0.00026,360244,23.07663,1561077
8416,cheerego,4,0.00026,360248,23.07689,1561077
8417,chenlujjj,4,0.00026,360252,23.07714,1561077
8418,chesney,4,0.00026,360256,23.07740,1561077
8419,chetanbhatia,4,0.00026,360260,23.07766,1561077
8420,chgans,4,0.00026,360264,23.07791,1561077
8421,chiducaf,4,0.00026,360268,23.07817,1561077
8422,chilupa,4,0.00026,360272,23.07843,1561077
8423,chkpnt,4,0.00026,360276,23.07868,1561077
8424,Choi-Sung-Hoon,4,0.00026,360280,23.07894,1561077
8425,cholf,4,0.00026,360284,23.07919,1561077
8426,chrisa-arm,4,0.00026,360288,23.07945,1561077
8427,chris-bosman,4,0.00026,360292,23.07971,1561077
8428,Chris-Carmichael,4,0.00026,360296,23.07996,1561077
8429,chriscelebisonos,4,0.00026,360300,23.08022,1561077
8430,Chrislevi,4,0.00026,360304,23.08048,1561077
8431,chrispewebb,4,0.00026,360308,23.08073,1561077
8432,ChrisRamsayITV,4,0.00026,360312,23.08099,1561077
8433,christianwiese,4,0.00026,360316,23.08124,1561077
8434,christophfritze,4,0.00026,360320,23.08150,1561077
8435,ChrisWeissNike,4,0.00026,360324,23.08176,1561077
8436,churowa,4,0.00026,360328,23.08201,1561077
8437,Ciphero,4,0.00026,360332,23.08227,1561077
8438,Circo1,4,0.00026,360336,23.08253,1561077
8439,Cirrith,4,0.00026,360340,23.08278,1561077
8440,cjanz,4,0.00026,360344,23.08304,1561077
8441,cjthorne,4,0.00026,360348,23.08329,1561077
8442,cket,4,0.00026,360352,23.08355,1561077
8443,clarkli86,4,0.00026,360356,23.08381,1561077
8444,claudiopro,4,0.00026,360360,23.08406,1561077
8445,clementlesne,4,0.00026,360364,23.08432,1561077
8446,clipitar,4,0.00026,360368,23.08458,1561077
8447,clockwisemusic,4,0.00026,360372,23.08483,1561077
8448,cloph,4,0.00026,360376,23.08509,1561077
8449,cloudtagger,4,0.00026,360380,23.08534,1561077
8450,cloudyster,4,0.00026,360384,23.08560,1561077
8451,cmoscardi,4,0.00026,360388,23.08586,1561077
8452,cnserd,4,0.00026,360392,23.08611,1561077
8453,cnych,4,0.00026,360396,23.08637,1561077
8454,coco80021,4,0.00026,360400,23.08663,1561077
8455,codebryo,4,0.00026,360404,23.08688,1561077
8456,coledodd,4,0.00026,360408,23.08714,1561077
8457,conslo,4,0.00026,360412,23.08739,1561077
8458,coredump,4,0.00026,360416,23.08765,1561077
8459,courteouselk,4,0.00026,360420,23.08791,1561077
8460,cova-fe,4,0.00026,360424,23.08816,1561077
8461,coyote240,4,0.00026,360428,23.08842,1561077
8462,cperrin88,4,0.00026,360432,23.08868,1561077
8463,cpp597455873,4,0.00026,360436,23.08893,1561077
8464,cpuydebois,4,0.00026,360440,23.08919,1561077
8465,crackerplace,4,0.00026,360444,23.08944,1561077
8466,Crazybus,4,0.00026,360448,23.08970,1561077
8467,Crazy-Hopper,4,0.00026,360452,23.08996,1561077
8468,crazy-john,4,0.00026,360456,23.09021,1561077
8469,cripher,4,0.00026,360460,23.09047,1561077
8470,crummy,4,0.00026,360464,23.09073,1561077
8471,cs8898,4,0.00026,360468,23.09098,1561077
8472,csaaler,4,0.00026,360472,23.09124,1561077
8473,csaintc,4,0.00026,360476,23.09149,1561077
8474,csomme,4,0.00026,360480,23.09175,1561077
8475,csullivannet,4,0.00026,360484,23.09201,1561077
8476,csullivanupgrade,4,0.00026,360488,23.09226,1561077
8477,ctudor,4,0.00026,360492,23.09252,1561077
8478,curlytopps,4,0.00026,360496,23.09278,1561077
8479,cvakiitho,4,0.00026,360500,23.09303,1561077
8480,cvega,4,0.00026,360504,23.09329,1561077
8481,cybo42,4,0.00026,360508,23.09354,1561077
8482,cyrilbrugman,4,0.00026,360512,23.09380,1561077
8483,CyrilBrulebois,4,0.00026,360516,23.09406,1561077
8484,cytown,4,0.00026,360520,23.09431,1561077
8485,d3c1978,4,0.00026,360524,23.09457,1561077
8486,daddykotex,4,0.00026,360528,23.09482,1561077
8487,daixtrose,4,0.00026,360532,23.09508,1561077
8488,dalbertom,4,0.00026,360536,23.09534,1561077
8489,daltonconley,4,0.00026,360540,23.09559,1561077
8490,dalwar23,4,0.00026,360544,23.09585,1561077
8491,danbovey,4,0.00026,360548,23.09611,1561077
8492,danielcbright,4,0.00026,360552,23.09636,1561077
8493,DanieleVistalli,4,0.00026,360556,23.09662,1561077
8494,danielgomezrico,4,0.00026,360560,23.09687,1561077
8495,danielhan,4,0.00026,360564,23.09713,1561077
8496,DanielRedOak,4,0.00026,360568,23.09739,1561077
8497,DanJohnstonArmory,4,0.00026,360572,23.09764,1561077
8498,dankirkd,4,0.00026,360576,23.09790,1561077
8499,danlenar,4,0.00026,360580,23.09816,1561077
8500,DanSt,4,0.00026,360584,23.09841,1561077
8501,DanteSingleton,4,0.00026,360588,23.09867,1561077
8502,Darian-Morrison,4,0.00026,360592,23.09892,1561077
8503,dariusz-pasciak-vivid,4,0.00026,360596,23.09918,1561077
8504,darkibot,4,0.00026,360600,23.09944,1561077
8505,darmbrust,4,0.00026,360604,23.09969,1561077
8506,DaSchTour,4,0.00026,360608,23.09995,1561077
8507,daus-salar,4,0.00026,360612,23.10021,1561077
8508,davehunt,4,0.00026,360616,23.10046,1561077
8509,dave-miles,4,0.00026,360620,23.10072,1561077
8510,daveshepherd,4,0.00026,360624,23.10097,1561077
8511,davetobin,4,0.00026,360628,23.10123,1561077
8512,daveygit2050,4,0.00026,360632,23.10149,1561077
8513,DavidFluck,4,0.00026,360636,23.10174,1561077
8514,DavidGangel,4,0.00026,360640,23.10200,1561077
8515,davidp1404,4,0.00026,360644,23.10226,1561077
8516,davidtaddei,4,0.00026,360648,23.10251,1561077
8517,DavyLandman,4,0.00026,360652,23.10277,1561077
8518,dbazile,4,0.00026,360656,23.10302,1561077
8519,dblenkus,4,0.00026,360660,23.10328,1561077
8520,dbwiddis,4,0.00026,360664,23.10354,1561077
8521,dcherman,4,0.00026,360668,23.10379,1561077
8522,dclem-23andme,4,0.00026,360672,23.10405,1561077
8523,ddavis-intel,4,0.00026,360676,23.10431,1561077
8524,ddbeatty,4,0.00026,360680,23.10456,1561077
8525,ddbrown30,4,0.00026,360684,23.10482,1561077
8526,ddwolf,4,0.00026,360688,23.10507,1561077
8527,debuggerpk,4,0.00026,360692,23.10533,1561077
8528,debugmaster,4,0.00026,360696,23.10559,1561077
8529,deeco,4,0.00026,360700,23.10584,1561077
8530,dejan2609,4,0.00026,360704,23.10610,1561077
8531,derChristoph,4,0.00026,360708,23.10636,1561077
8532,Dereliass,4,0.00026,360712,23.10661,1561077
8533,DerJJ,4,0.00026,360716,23.10687,1561077
8534,derron,4,0.00026,360720,23.10712,1561077
8535,Der-Schubi,4,0.00026,360724,23.10738,1561077
8536,dervan,4,0.00026,360728,23.10764,1561077
8537,dervistalha,4,0.00026,360732,23.10789,1561077
8538,deskoh,4,0.00026,360736,23.10815,1561077
8539,destroyerofbuilds,4,0.00026,360740,23.10841,1561077
8540,devent,4,0.00026,360744,23.10866,1561077
8541,DevKyleS,4,0.00026,360748,23.10892,1561077
8542,dg4101,4,0.00026,360752,23.10917,1561077
8543,dgedeon,4,0.00026,360756,23.10943,1561077
8544,dgokcin,4,0.00026,360760,23.10969,1561077
8545,dhardy92,4,0.00026,360764,23.10994,1561077
8546,dhc8,4,0.00026,360768,23.11020,1561077
8547,dhiebert,4,0.00026,360772,23.11046,1561077
8548,dhkim0225,4,0.00026,360776,23.11071,1561077
8549,dhompanera,4,0.00026,360780,23.11097,1561077
8550,DhruvM1994,4,0.00026,360784,23.11122,1561077
8551,dhubbard-ic,4,0.00026,360788,23.11148,1561077
8552,dianqihanwangzi,4,0.00026,360792,23.11174,1561077
8553,digheTest,4,0.00026,360796,23.11199,1561077
8554,Digitalroot,4,0.00026,360800,23.11225,1561077
8555,dimaov,4,0.00026,360804,23.11251,1561077
8556,DimeOne,4,0.00026,360808,23.11276,1561077
8557,dimikhan,4,0.00026,360812,23.11302,1561077
8558,dinwath,4,0.00026,360816,23.11327,1561077
8559,DionJones615,4,0.00026,360820,23.11353,1561077
8560,diraol,4,0.00026,360824,23.11379,1561077
8561,dirvo,4,0.00026,360828,23.11404,1561077
8562,dischello,4,0.00026,360832,23.11430,1561077
8563,DishaDudhal8,4,0.00026,360836,23.11455,1561077
8564,djk,4,0.00026,360840,23.11481,1561077
8565,DJRickyB,4,0.00026,360844,23.11507,1561077
8566,djwgit,4,0.00026,360848,23.11532,1561077
8567,dkder3k,4,0.00026,360852,23.11558,1561077
8568,dkelim1,4,0.00026,360856,23.11584,1561077
8569,dkim-dev,4,0.00026,360860,23.11609,1561077
8570,DkUzoukwu,4,0.00026,360864,23.11635,1561077
8571,dlednik,4,0.00026,360868,23.11660,1561077
8572,dliakh,4,0.00026,360872,23.11686,1561077
8573,dlovitch,4,0.00026,360876,23.11712,1561077
8574,dluchinienoc,4,0.00026,360880,23.11737,1561077
8575,dmikalova,4,0.00026,360884,23.11763,1561077
8576,DmitriyStoyanov,4,0.00026,360888,23.11789,1561077
8577,docbobo,4,0.00026,360892,23.11814,1561077
8578,DockerAsura,4,0.00026,360896,23.11840,1561077
8579,doctori,4,0.00026,360900,23.11865,1561077
8580,domruf,4,0.00026,360904,23.11891,1561077
8581,donepudi369,4,0.00026,360908,23.11917,1561077
8582,donnyv12,4,0.00026,360912,23.11942,1561077
8583,doodoori2,4,0.00026,360916,23.11968,1561077
8584,douglarek,4,0.00026,360920,23.11994,1561077
8585,doy,4,0.00026,360924,23.12019,1561077
8586,dpodder,4,0.00026,360928,23.12045,1561077
8587,dragonfly-net,4,0.00026,360932,23.12070,1561077
8588,dreef3,4,0.00026,360936,23.12096,1561077
8589,drei01,4,0.00026,360940,23.12122,1561077
8590,drewbutlerbb4,4,0.00026,360944,23.12147,1561077
8591,drewdogg,4,0.00026,360948,23.12173,1561077
8592,drewripa,4,0.00026,360952,23.12199,1561077
8593,drewsonne,4,0.00026,360956,23.12224,1561077
8594,DrFaust92,4,0.00026,360960,23.12250,1561077
8595,Drimix20,4,0.00026,360964,23.12275,1561077
8596,droberts2013,4,0.00026,360968,23.12301,1561077
8597,dromie,4,0.00026,360972,23.12327,1561077
8598,dromosys,4,0.00026,360976,23.12352,1561077
8599,dr-zeta,4,0.00026,360980,23.12378,1561077
8600,dsbaars,4,0.00026,360984,23.12404,1561077
8601,dsekhart,4,0.00026,360988,23.12429,1561077
8602,dterrysynopsys,4,0.00026,360992,23.12455,1561077
8603,DuAell,4,0.00026,360996,23.12480,1561077
8604,Dubarov,4,0.00026,361000,23.12506,1561077
8605,dumbdev,4,0.00026,361004,23.12532,1561077
8606,dump247,4,0.00026,361008,23.12557,1561077
8607,duronrulez,4,0.00026,361012,23.12583,1561077
8608,dvdliao,4,0.00026,361016,23.12609,1561077
8609,dzudek,4,0.00026,361020,23.12634,1561077
8610,eaglei15,4,0.00026,361024,23.12660,1561077
8611,eagleshine,4,0.00026,361028,23.12685,1561077
8612,EamonNerbonne,4,0.00026,361032,23.12711,1561077
8613,eas5,4,0.00026,361036,23.12737,1561077
8614,easybe,4,0.00026,361040,23.12762,1561077
8615,easylife2020,4,0.00026,361044,23.12788,1561077
8616,ebalakumar,4,0.00026,361048,23.12814,1561077
8617,ebarboni,4,0.00026,361052,23.12839,1561077
8618,ebesson,4,0.00026,361056,23.12865,1561077
8619,eckschi,4,0.00026,361060,23.12890,1561077
8620,eddie3716,4,0.00026,361064,23.12916,1561077
8621,edf825,4,0.00026,361068,23.12942,1561077
8622,eecarus,4,0.00026,361072,23.12967,1561077
8623,egergo,4,0.00026,361076,23.12993,1561077
8624,egoine,4,0.00026,361080,23.13019,1561077
8625,ehsanagh,4,0.00026,361084,23.13044,1561077
8626,eiriarte-mendez,4,0.00026,361088,23.13070,1561077
8627,ejKang,4,0.00026,361092,23.13095,1561077
8628,electron2302,4,0.00026,361096,23.13121,1561077
8629,elementalvoid,4,0.00026,361100,23.13147,1561077
8630,elfhack,4,0.00026,361104,23.13172,1561077
8631,eliaquimmauricio,4,0.00026,361108,23.13198,1561077
8632,elliot-smith77,4,0.00026,361112,23.13223,1561077
8633,eloebl,4,0.00026,361116,23.13249,1561077
8634,elopio,4,0.00026,361120,23.13275,1561077
8635,eltermann,4,0.00026,361124,23.13300,1561077
8636,emakaay,4,0.00026,361128,23.13326,1561077
8637,emeagher,4,0.00026,361132,23.13352,1561077
8638,EmilyEmily,4,0.00026,361136,23.13377,1561077
8639,emirozer,4,0.00026,361140,23.13403,1561077
8640,emoreth,4,0.00026,361144,23.13428,1561077
8641,e-moshaya,4,0.00026,361148,23.13454,1561077
8642,emperorente,4,0.00026,361152,23.13480,1561077
8643,entasisj,4,0.00026,361156,23.13505,1561077
8644,epeay,4,0.00026,361160,23.13531,1561077
8645,erab,4,0.00026,361164,23.13557,1561077
8646,erduranogulcan,4,0.00026,361168,23.13582,1561077
8647,ericgerling,4,0.00026,361172,23.13608,1561077
8648,EricSalemi,4,0.00026,361176,23.13633,1561077
8649,ericsysmin,4,0.00026,361180,23.13659,1561077
8650,Erifirin,4,0.00026,361184,23.13685,1561077
8651,erikauer,4,0.00026,361188,23.13710,1561077
8652,ErikBergfurInfor,4,0.00026,361192,23.13736,1561077
8653,eryksz,4,0.00026,361196,23.13762,1561077
8654,eskaaren,4,0.00026,361200,23.13787,1561077
8655,eskatos,4,0.00026,361204,23.13813,1561077
8656,esmaras,4,0.00026,361208,23.13838,1561077
8657,ethiebaut,4,0.00026,361212,23.13864,1561077
8658,eThomasHerrlin,4,0.00026,361216,23.13890,1561077
8659,Etienne-Carriere,4,0.00026,361220,23.13915,1561077
8660,eugmes,4,0.00026,361224,23.13941,1561077
8661,evangoer,4,0.00026,361228,23.13967,1561077
8662,evidex,4,0.00026,361232,23.13992,1561077
8663,ewolak-sq,4,0.00026,361236,23.14018,1561077
8664,ExitoLab,4,0.00026,361240,23.14043,1561077
8665,ezralanglois,4,0.00026,361244,23.14069,1561077
8666,fabifrank,4,0.00026,361248,23.14095,1561077
8667,fabiodouek,4,0.00026,361252,23.14120,1561077
8668,fabiogomezdiaz,4,0.00026,361256,23.14146,1561077
8669,faizalkassamalisc,4,0.00026,361260,23.14172,1561077
8670,fanatic,4,0.00026,361264,23.14197,1561077
8671,fanooel,4,0.00026,361268,23.14223,1561077
8672,fans3210,4,0.00026,361272,23.14248,1561077
8673,farley13,4,0.00026,361276,23.14274,1561077
8674,farrrb,4,0.00026,361280,23.14300,1561077
8675,farshid616,4,0.00026,361284,23.14325,1561077
8676,fbradyirl,4,0.00026,361288,23.14351,1561077
8677,fbuchmeier-abi,4,0.00026,361292,23.14377,1561077
8678,fdumontmd,4,0.00026,361296,23.14402,1561077
8679,fduranti,4,0.00026,361300,23.14428,1561077
8680,feiqitian,4,0.00026,361304,23.14453,1561077
8681,fernandoguedes,4,0.00026,361308,23.14479,1561077
8682,FGM,4,0.00026,361312,23.14505,1561077
8683,fhervieux,4,0.00026,361316,23.14530,1561077
8684,fhickman,4,0.00026,361320,23.14556,1561077
8685,Filter94,4,0.00026,361324,23.14582,1561077
8686,fionaliupw,4,0.00026,361328,23.14607,1561077
8687,firehist,4,0.00026,361332,23.14633,1561077
8688,firon,4,0.00026,361336,23.14658,1561077
8689,five-iron,4,0.00026,361340,23.14684,1561077
8690,fjcapdevila,4,0.00026,361344,23.14710,1561077
8691,FLavalliere,4,0.00026,361348,23.14735,1561077
8692,floriangosse,4,0.00026,361352,23.14761,1561077
8693,fortaa,4,0.00026,361356,23.14787,1561077
8694,foures,4,0.00026,361360,23.14812,1561077
8695,foxrafi,4,0.00026,361364,23.14838,1561077
8696,franciscocpg,4,0.00026,361368,23.14863,1561077
8697,frankthrock,4,0.00026,361372,23.14889,1561077
8698,freeo,4,0.00026,361376,23.14915,1561077
8699,fr-kshibata,4,0.00026,361380,23.14940,1561077
8700,gabecase,4,0.00026,361384,23.14966,1561077
8701,Gakhramanzode,4,0.00026,361388,23.14992,1561077
8702,galaxyNeha,4,0.00026,361392,23.15017,1561077
8703,gambledramble,4,0.00026,361396,23.15043,1561077
8704,garceger,4,0.00026,361400,23.15068,1561077
8705,GaToRAiD,4,0.00026,361404,23.15094,1561077
8706,gaurav20085,4,0.00026,361408,23.15120,1561077
8707,gaurav517,4,0.00026,361412,23.15145,1561077
8708,gboucherie,4,0.00026,361416,23.15171,1561077
8709,geckhan,4,0.00026,361420,23.15196,1561077
8710,geisterfurz007,4,0.00026,361424,23.15222,1561077
8711,gek0,4,0.00026,361428,23.15248,1561077
8712,gemanepa,4,0.00026,361432,23.15273,1561077
8713,gennady,4,0.00026,361436,23.15299,1561077
8714,georgecodes,4,0.00026,361440,23.15325,1561077
8715,georgelee1,4,0.00026,361444,23.15350,1561077
8716,geralvin,4,0.00026,361448,23.15376,1561077
8717,GeTOUO,4,0.00026,361452,23.15401,1561077
8718,getstek,4,0.00026,361456,23.15427,1561077
8719,ggerogery,4,0.00026,361460,23.15453,1561077
8720,ggramlich,4,0.00026,361464,23.15478,1561077
8721,ghaabor,4,0.00026,361468,23.15504,1561077
8722,ghunteranderson,4,0.00026,361472,23.15530,1561077
8723,Giancarlo1974,4,0.00026,361476,23.15555,1561077
8724,gianpaolof,4,0.00026,361480,23.15581,1561077
8725,gigaaks,4,0.00026,361484,23.15606,1561077
8726,gilbahat,4,0.00026,361488,23.15632,1561077
8727,giotab,4,0.00026,361492,23.15658,1561077
8728,gips0n,4,0.00026,361496,23.15683,1561077
8729,git-trainee,4,0.00026,361500,23.15709,1561077
8730,gladnik,4,0.00026,361504,23.15735,1561077
8731,glandais-sparklane,4,0.00026,361508,23.15760,1561077
8732,Glandos,4,0.00026,361512,23.15786,1561077
8733,GleitonCampos,4,0.00026,361516,23.15811,1561077
8734,glewandowski,4,0.00026,361520,23.15837,1561077
8735,gm42,4,0.00026,361524,23.15863,1561077
8736,GMaxera,4,0.00026,361528,23.15888,1561077
8737,gmercey,4,0.00026,361532,23.15914,1561077
8738,gmessner,4,0.00026,361536,23.15940,1561077
8739,GokhanAtes,4,0.00026,361540,23.15965,1561077
8740,gonzalovilaseca,4,0.00026,361544,23.15991,1561077
8741,got-root,4,0.00026,361548,23.16016,1561077
8742,GPWebb,4,0.00026,361552,23.16042,1561077
8743,gpxricky,4,0.00026,361556,23.16068,1561077
8744,grafra,4,0.00026,361560,23.16093,1561077
8745,grahammather,4,0.00026,361564,23.16119,1561077
8746,grams,4,0.00026,361568,23.16145,1561077
8747,graphdb2,4,0.00026,361572,23.16170,1561077
8748,GrataHonoria,4,0.00026,361576,23.16196,1561077
8749,grazius,4,0.00026,361580,23.16221,1561077
8750,gregpardo,4,0.00026,361584,23.16247,1561077
8751,gremito,4,0.00026,361588,23.16273,1561077
8752,greycat001,4,0.00026,361592,23.16298,1561077
8753,Griffin23,4,0.00026,361596,23.16324,1561077
8754,grostarin,4,0.00026,361600,23.16350,1561077
8755,grunlab,4,0.00026,361604,23.16375,1561077
8756,grzegorznowak,4,0.00026,361608,23.16401,1561077
8757,gsomoza,4,0.00026,361612,23.16426,1561077
8758,gtbuchanan,4,0.00026,361616,23.16452,1561077
8759,guilcy,4,0.00026,361620,23.16478,1561077
8760,guillaumebrunerie,4,0.00026,361624,23.16503,1561077
8761,Guillaume-BVS,4,0.00026,361628,23.16529,1561077
8762,GuitarrasDeAmor,4,0.00026,361632,23.16555,1561077
8763,gustafg,4,0.00026,361636,23.16580,1561077
8764,GustavoLlorente,4,0.00026,361640,23.16606,1561077
8765,Gustra,4,0.00026,361644,23.16631,1561077
8766,gvreddy579,4,0.00026,361648,23.16657,1561077
8767,Gwanhir,4,0.00026,361652,23.16683,1561077
8768,gyancoupa,4,0.00026,361656,23.16708,1561077
8769,H1rkul2,4,0.00026,361660,23.16734,1561077
8770,h4n23s,4,0.00026,361664,23.16760,1561077
8771,H5ang,4,0.00026,361668,23.16785,1561077
8772,HaeyoonJo,4,0.00026,361672,23.16811,1561077
8773,hafizullah,4,0.00026,361676,23.16836,1561077
8774,halltony,4,0.00026,361680,23.16862,1561077
8775,haloflightleader,4,0.00026,361684,23.16888,1561077
8776,halverneus,4,0.00026,361688,23.16913,1561077
8777,hamzapurra,4,0.00026,361692,23.16939,1561077
8778,hanneskaeufler-bmw,4,0.00026,361696,23.16965,1561077
8779,haos616,4,0.00026,361700,23.16990,1561077
8780,harishrao,4,0.00026,361704,23.17016,1561077
8781,HaroldPutman,4,0.00026,361708,23.17041,1561077
8782,HavenLin,4,0.00026,361712,23.17067,1561077
8783,hazmeister,4,0.00026,361716,23.17093,1561077
8784,hcbraun,4,0.00026,361720,23.17118,1561077
8785,hdkshjm,4,0.00026,361724,23.17144,1561077
8786,heavyengineer,4,0.00026,361728,23.17169,1561077
8787,heenachauhan18,4,0.00026,361732,23.17195,1561077
8788,hehe717,4,0.00026,361736,23.17221,1561077
8789,helenSpry,4,0.00026,361740,23.17246,1561077
8790,helgein,4,0.00026,361744,23.17272,1561077
8791,Hello-Linux,4,0.00026,361748,23.17298,1561077
8792,henrikb123,4,0.00026,361752,23.17323,1561077
8793,Herr-Sepp,4,0.00026,361756,23.17349,1561077
8794,HerveMARTIN,4,0.00026,361760,23.17374,1561077
8795,hesantan,4,0.00026,361764,23.17400,1561077
8796,heschulz,4,0.00026,361768,23.17426,1561077
8797,hettlage,4,0.00026,361772,23.17451,1561077
8798,heysujal,4,0.00026,361776,23.17477,1561077
8799,hicolour,4,0.00026,361780,23.17503,1561077
8800,hidekiy,4,0.00026,361784,23.17528,1561077
8801,hila3000,4,0.00026,361788,23.17554,1561077
8802,HildaHay,4,0.00026,361792,23.17579,1561077
8803,himanshush13,4,0.00026,361796,23.17605,1561077
8804,himperion92,4,0.00026,361800,23.17631,1561077
8805,hippoz,4,0.00026,361804,23.17656,1561077
8806,hmcmanus,4,0.00026,361808,23.17682,1561077
8807,HMSAnalyticalSoftware,4,0.00026,361812,23.17708,1561077
8808,HNygard,4,0.00026,361816,23.17733,1561077
8809,hoanpvzz,4,0.00026,361820,23.17759,1561077
8810,hodnett,4,0.00026,361824,23.17784,1561077
8811,hollisc,4,0.00026,361828,23.17810,1561077
8812,HonkingGoose,4,0.00026,361832,23.17836,1561077
8813,honnel,4,0.00026,361836,23.17861,1561077
8814,hoodja,4,0.00026,361840,23.17887,1561077
8815,hoolie,4,0.00026,361844,23.17913,1561077
8816,hparashu,4,0.00026,361848,23.17938,1561077
8817,hram,4,0.00026,361852,23.17964,1561077
8818,hron84,4,0.00026,361856,23.17989,1561077
8819,hsmith90,4,0.00026,361860,23.18015,1561077
8820,huage1994,4,0.00026,361864,23.18041,1561077
8821,Huanqiang,4,0.00026,361868,23.18066,1561077
8822,huehnerlady,4,0.00026,361872,23.18092,1561077
8823,hughperkins,4,0.00026,361876,23.18118,1561077
8824,HugoY,4,0.00026,361880,23.18143,1561077
8825,huyennguyen-katalon,4,0.00026,361884,23.18169,1561077
8826,hypergig,4,0.00026,361888,23.18194,1561077
8827,iamanikeev,4,0.00026,361892,23.18220,1561077
8828,ia-mfriegang,4,0.00026,361896,23.18246,1561077
8829,iamthereplicant,4,0.00026,361900,23.18271,1561077
8830,iamWh1sp3r,4,0.00026,361904,23.18297,1561077
8831,idrissneumann,4,0.00026,361908,23.18323,1561077
8832,IevgenGoltsev,4,0.00026,361912,23.18348,1561077
8833,ifegit,4,0.00026,361916,23.18374,1561077
8834,igor-dmitriev,4,0.00026,361920,23.18399,1561077
8835,ijack9631,4,0.00026,361924,23.18425,1561077
8836,ikutergin,4,0.00026,361928,23.18451,1561077
8837,ilal4791,4,0.00026,361932,23.18476,1561077
8838,ilanshtok,4,0.00026,361936,23.18502,1561077
8839,Illusionme,4,0.00026,361940,23.18528,1561077
8840,ilyache,4,0.00026,361944,23.18553,1561077
8841,imakewebthings,4,0.00026,361948,23.18579,1561077
8842,imifarago,4,0.00026,361952,23.18604,1561077
8843,IM-RamakrishnaK,4,0.00026,361956,23.18630,1561077
8844,imskr,4,0.00026,361960,23.18656,1561077
8845,include,4,0.00026,361964,23.18681,1561077
8846,indiebox,4,0.00026,361968,23.18707,1561077
8847,ip1981,4,0.00026,361972,23.18733,1561077
8848,Irialad,4,0.00026,361976,23.18758,1561077
8849,irobayna,4,0.00026,361980,23.18784,1561077
8850,irotem,4,0.00026,361984,23.18809,1561077
8851,irrationalism,4,0.00026,361988,23.18835,1561077
8852,isaacdong,4,0.00026,361992,23.18861,1561077
8853,isav48,4,0.00026,361996,23.18886,1561077
8854,isbaran,4,0.00026,362000,23.18912,1561077
8855,ismailsalloo,4,0.00026,362004,23.18938,1561077
8856,iszak,4,0.00026,362008,23.18963,1561077
8857,itsparser,4,0.00026,362012,23.18989,1561077
8858,ivanstefko,4,0.00026,362016,23.19014,1561077
8859,iwwwwwwi,4,0.00026,362020,23.19040,1561077
8860,jackkitley,4,0.00026,362024,23.19066,1561077
8861,JackYou2020,4,0.00026,362028,23.19091,1561077
8862,Jagrig48,4,0.00026,362032,23.19117,1561077
8863,jakelima18,4,0.00026,362036,23.19142,1561077
8864,jakubjosef,4,0.00026,362040,23.19168,1561077
8865,JakubVanek,4,0.00026,362044,23.19194,1561077
8866,jalona,4,0.00026,362048,23.19219,1561077
8867,jAlpedrinha,4,0.00026,362052,23.19245,1561077
8868,jamesHsiaoAcquia,4,0.00026,362056,23.19271,1561077
8869,jamesrwhite,4,0.00026,362060,23.19296,1561077
8870,Jamie-sas,4,0.00026,362064,23.19322,1561077
8871,jamiesnape,4,0.00026,362068,23.19347,1561077
8872,janbernloehr,4,0.00026,362072,23.19373,1561077
8873,janjoerke,4,0.00026,362076,23.19399,1561077
8874,japzio,4,0.00026,362080,23.19424,1561077
8875,jared-clarifai,4,0.00026,362084,23.19450,1561077
8876,jaredrsowers,4,0.00026,362088,23.19476,1561077
8877,jarrodconnolly,4,0.00026,362092,23.19501,1561077
8878,jasholl,4,0.00026,362096,23.19527,1561077
8879,JasnaPaka,4,0.00026,362100,23.19552,1561077
8880,jasondtgt,4,0.00026,362104,23.19578,1561077
8881,jason-opslevel,4,0.00026,362108,23.19604,1561077
8882,jasonwee,4,0.00026,362112,23.19629,1561077
8883,javauser05,4,0.00026,362116,23.19655,1561077
8884,Javedmaharaja,4,0.00026,362120,23.19681,1561077
8885,jaybocc2,4,0.00026,362124,23.19706,1561077
8886,jayeshkhairnar,4,0.00026,362128,23.19732,1561077
8887,jayeshmurli,4,0.00026,362132,23.19757,1561077
8888,jb-101,4,0.00026,362136,23.19783,1561077
8889,jbeuckm,4,0.00026,362140,23.19809,1561077
8890,jbpadgett,4,0.00026,362144,23.19834,1561077
8891,jchenrev,4,0.00026,362148,23.19860,1561077
8892,jdamour98,4,0.00026,362152,23.19886,1561077
8893,jday29,4,0.00026,362156,23.19911,1561077
8894,jdebois,4,0.00026,362160,23.19937,1561077
8895,jdupont,4,0.00026,362164,23.19962,1561077
8896,jebitok-dev,4,0.00026,362168,23.19988,1561077
8897,jefdo,4,0.00026,362172,23.20014,1561077
8898,jeffie9,4,0.00026,362176,23.20039,1561077
8899,jekkel,4,0.00026,362180,23.20065,1561077
8900,jelmer,4,0.00026,362184,23.20091,1561077
8901,jelopu,4,0.00026,362188,23.20116,1561077
8902,jenkinslover6,4,0.00026,362192,23.20142,1561077
8903,jeremy-page,4,0.00026,362196,23.20167,1561077
8904,jerome-arzel,4,0.00026,362200,23.20193,1561077
8905,jerome-morgado,4,0.00026,362204,23.20219,1561077
8906,jesperes,4,0.00026,362208,23.20244,1561077
8907,jessebot,4,0.00026,362212,23.20270,1561077
8908,jessiepuls,4,0.00026,362216,23.20296,1561077
8909,jesusdiez,4,0.00026,362220,23.20321,1561077
8910,jgrant216,4,0.00026,362224,23.20347,1561077
8911,jgray1206,4,0.00026,362228,23.20372,1561077
8912,jgreen210,4,0.00026,362232,23.20398,1561077
8913,jgreenbow-userful,4,0.00026,362236,23.20424,1561077
8914,jgwhite,4,0.00026,362240,23.20449,1561077
8915,jhartnett,4,0.00026,362244,23.20475,1561077
8916,jhendrick,4,0.00026,362248,23.20501,1561077
8917,jhonis,4,0.00026,362252,23.20526,1561077
8918,jhrcz,4,0.00026,362256,23.20552,1561077
8919,jiangty-addepar,4,0.00026,362260,23.20577,1561077
8920,jilleJr,4,0.00026,362264,23.20603,1561077
8921,jilyaluk,4,0.00026,362268,23.20629,1561077
8922,Jim-Bar,4,0.00026,362272,23.20654,1561077
8923,jin-ahn,4,0.00026,362276,23.20680,1561077
8924,JingangLi,4,0.00026,362280,23.20706,1561077
8925,jing-cui,4,0.00026,362284,23.20731,1561077
8926,jinjorge,4,0.00026,362288,23.20757,1561077
8927,jinogueiraa,4,0.00026,362292,23.20782,1561077
8928,jinxac,4,0.00026,362296,23.20808,1561077
8929,jjathman,4,0.00026,362300,23.20834,1561077
8930,jjensen554,4,0.00026,362304,23.20859,1561077
8931,jjrussell,4,0.00026,362308,23.20885,1561077
8932,Jlaird,4,0.00026,362312,23.20910,1561077
8933,jlestrada,4,0.00026,362316,23.20936,1561077
8934,jllado,4,0.00026,362320,23.20962,1561077
8935,jlloyola,4,0.00026,362324,23.20987,1561077
8936,jmaclabs,4,0.00026,362328,23.21013,1561077
8937,jmartinspt,4,0.00026,362332,23.21039,1561077
8938,jmatzdorff-cpi,4,0.00026,362336,23.21064,1561077
8939,jmkgreen,4,0.00026,362340,23.21090,1561077
8940,jmsizun,4,0.00026,362344,23.21115,1561077
8941,joanayma,4,0.00026,362348,23.21141,1561077
8942,JoaoPPinto,4,0.00026,362352,23.21167,1561077
8943,jodybro,4,0.00026,362356,23.21192,1561077
8944,joedragons,4,0.00026,362360,23.21218,1561077
8945,joemirizio,4,0.00026,362364,23.21244,1561077
8946,joeratt,4,0.00026,362368,23.21269,1561077
8947,joetancy,4,0.00026,362372,23.21295,1561077
8948,johanek,4,0.00026,362376,23.21320,1561077
8949,johankok,4,0.00026,362380,23.21346,1561077
8950,johannesc,4,0.00026,362384,23.21372,1561077
8951,johannsig,4,0.00026,362388,23.21397,1561077
8952,jonahbull,4,0.00026,362392,23.21423,1561077
8953,jonbartlett,4,0.00026,362396,23.21449,1561077
8954,joncolas,4,0.00026,362400,23.21474,1561077
8955,joneskoo,4,0.00026,362404,23.21500,1561077
8956,jonkipu,4,0.00026,362408,23.21525,1561077
8957,jonl-percsolutions-com,4,0.00026,362412,23.21551,1561077
8958,jonyto123,4,0.00026,362416,23.21577,1561077
8959,JordanRoss1992,4,0.00026,362420,23.21602,1561077
8960,JorgeCarousel,4,0.00026,362424,23.21628,1561077
8961,jorianvo,4,0.00026,362428,23.21654,1561077
8962,joshfrench,4,0.00026,362432,23.21679,1561077
8963,joshuabergeron,4,0.00026,362436,23.21705,1561077
8964,joshuak2018,4,0.00026,362440,23.21730,1561077
8965,Jossuecito,4,0.00026,362444,23.21756,1561077
8966,jpvz,4,0.00026,362448,23.21782,1561077
8967,JPWKU,4,0.00026,362452,23.21807,1561077
8968,jravetch,4,0.00026,362456,23.21833,1561077
8969,jrcast,4,0.00026,362460,23.21859,1561077
8970,JR-Utily,4,0.00026,362464,23.21884,1561077
8971,jsalado,4,0.00026,362468,23.21910,1561077
8972,jsbjair,4,0.00026,362472,23.21935,1561077
8973,jschwarz-eitco-de,4,0.00026,362476,23.21961,1561077
8974,jsg2021,4,0.00026,362480,23.21987,1561077
8975,jsmigel,4,0.00026,362484,23.22012,1561077
8976,jsmirnov,4,0.00026,362488,23.22038,1561077
8977,jsmrcka,4,0.00026,362492,23.22064,1561077
8978,jsniecikowski,4,0.00026,362496,23.22089,1561077
8979,jswager-cisco,4,0.00026,362500,23.22115,1561077
8980,jtreminio,4,0.00026,362504,23.22140,1561077
8981,jubel-han,4,0.00026,362508,23.22166,1561077
8982,judahgreenblatt,4,0.00026,362512,23.22192,1561077
8983,jueyaye,4,0.00026,362516,23.22217,1561077
8984,julie-ng,4,0.00026,362520,23.22243,1561077
8985,juliusecker,4,0.00026,362524,23.22269,1561077
8986,juliusloman,4,0.00026,362528,23.22294,1561077
8987,justjenu,4,0.00026,362532,23.22320,1561077
8988,justoaguilar,4,0.00026,362536,23.22345,1561077
8989,juulderuysscher,4,0.00026,362540,23.22371,1561077
8990,jvasnani,4,0.00026,362544,23.22397,1561077
8991,jvhaggard,4,0.00026,362548,23.22422,1561077
8992,jviolas,4,0.00026,362552,23.22448,1561077
8993,jwoodsw,4,0.00026,362556,23.22474,1561077
8994,jxqb,4,0.00026,362560,23.22499,1561077
8995,jyaworski,4,0.00026,362564,23.22525,1561077
8996,jzielke84,4,0.00026,362568,23.22550,1561077
8997,kaaloo,4,0.00026,362572,23.22576,1561077
8998,kadrach,4,0.00026,362576,23.22602,1561077
8999,KaelenProctor,4,0.00026,362580,23.22627,1561077
9000,kalibyrn,4,0.00026,362584,23.22653,1561077
9001,Kali-lightsaber,4,0.00026,362588,23.22679,1561077
9002,kalyanhi,4,0.00026,362592,23.22704,1561077
9003,kalyano,4,0.00026,362596,23.22730,1561077
9004,kangwoo,4,0.00026,362600,23.22755,1561077
9005,kanjih-ciandt,4,0.00026,362604,23.22781,1561077
9006,kannanprasanna,4,0.00026,362608,23.22807,1561077
9007,karnwaltushti,4,0.00026,362612,23.22832,1561077
9008,karolflis,4,0.00026,362616,23.22858,1561077
9009,karthickrc,4,0.00026,362620,23.22883,1561077
9010,karthikeaswaran,4,0.00026,362624,23.22909,1561077
9011,karthiksadhasivam,4,0.00026,362628,23.22935,1561077
9012,kasireddy508,4,0.00026,362632,23.22960,1561077
9013,kaspter,4,0.00026,362636,23.22986,1561077
9014,kaushalringle,4,0.00026,362640,23.23012,1561077
9015,kazesberger,4,0.00026,362644,23.23037,1561077
9016,kboom,4,0.00026,362648,23.23063,1561077
9017,kbratanis,4,0.00026,362652,23.23088,1561077
9018,kct12345,4,0.00026,362656,23.23114,1561077
9019,kd5rsa,4,0.00026,362660,23.23140,1561077
9020,Kegley,4,0.00026,362664,23.23165,1561077
9021,keithkreissl,4,0.00026,362668,23.23191,1561077
9022,kellyjandrews,4,0.00026,362672,23.23217,1561077
9023,kelvingl,4,0.00026,362676,23.23242,1561077
9024,KennethMojanaga,4,0.00026,362680,23.23268,1561077
9025,kenyee,4,0.00026,362684,23.23293,1561077
9026,ketan,4,0.00026,362688,23.23319,1561077
9027,ketyboss,4,0.00026,362692,23.23345,1561077
9028,kevin-brown,4,0.00026,362696,23.23370,1561077
9029,KevinBusse,4,0.00026,362700,23.23396,1561077
9030,KevinHagen,4,0.00026,362704,23.23422,1561077
9031,kevinushey,4,0.00026,362708,23.23447,1561077
9032,kieraCurtis,4,0.00026,362712,23.23473,1561077
9033,KieranPringle,4,0.00026,362716,23.23498,1561077
9034,kingjeffrey,4,0.00026,362720,23.23524,1561077
9035,kins-dev,4,0.00026,362724,23.23550,1561077
9036,kintarowins,4,0.00026,362728,23.23575,1561077
9037,kizzie,4,0.00026,362732,23.23601,1561077
9038,kkalugerov,4,0.00026,362736,23.23627,1561077
9039,kkrhdd,4,0.00026,362740,23.23652,1561077
9040,klassm,4,0.00026,362744,23.23678,1561077
9041,klieber,4,0.00026,362748,23.23703,1561077
9042,kmarker1101,4,0.00026,362752,23.23729,1561077
9043,koceg,4,0.00026,362756,23.23755,1561077
9044,koeberlue,4,0.00026,362760,23.23780,1561077
9045,konrada,4,0.00026,362764,23.23806,1561077
9046,kotarot,4,0.00026,362768,23.23832,1561077
9047,kraftman,4,0.00026,362772,23.23857,1561077
9048,kranian,4,0.00026,362776,23.23883,1561077
9049,kratsg,4,0.00026,362780,23.23908,1561077
9050,KrestenKjaer,4,0.00026,362784,23.23934,1561077
9051,kriazhev,4,0.00026,362788,23.23960,1561077
9052,krishnawhite,4,0.00026,362792,23.23985,1561077
9053,kristofmoens,4,0.00026,362796,23.24011,1561077
9054,krithiva,4,0.00026,362800,23.24037,1561077
9055,kronn,4,0.00026,362804,23.24062,1561077
9056,krsmith2,4,0.00026,362808,23.24088,1561077
9057,krupaldesai,4,0.00026,362812,23.24113,1561077
9058,krzysztofreczek,4,0.00026,362816,23.24139,1561077
9059,ksegun,4,0.00026,362820,23.24165,1561077
9060,kshcherban,4,0.00026,362824,23.24190,1561077
9061,ksmyth,4,0.00026,362828,23.24216,1561077
9062,kth496,4,0.00026,362832,23.24242,1561077
9063,kuldazbraslav,4,0.00026,362836,23.24267,1561077
9064,KunalSin9h,4,0.00026,362840,23.24293,1561077
9065,kuoruan,4,0.00026,362844,23.24318,1561077
9066,kuroiokami,4,0.00026,362848,23.24344,1561077
9067,kusemuckl,4,0.00026,362852,23.24370,1561077
9068,kwoodie,4,0.00026,362856,23.24395,1561077
9069,Kyslik,4,0.00026,362860,23.24421,1561077
9070,kywon25,4,0.00026,362864,23.24447,1561077
9071,Laffs2k5,4,0.00026,362868,23.24472,1561077
9072,lafrenierejm,4,0.00026,362872,23.24498,1561077
9073,laikw,4,0.00026,362876,23.24523,1561077
9074,Lakritzator,4,0.00026,362880,23.24549,1561077
9075,lalet,4,0.00026,362884,23.24575,1561077
9076,languitar,4,0.00026,362888,23.24600,1561077
9077,Lark-super,4,0.00026,362892,23.24626,1561077
9078,larrywest,4,0.00026,362896,23.24652,1561077
9079,LarsUlrichKrieg,4,0.00026,362900,23.24677,1561077
9080,laurentPereira,4,0.00026,362904,23.24703,1561077
9081,LazyJoJo,4,0.00026,362908,23.24728,1561077
9082,lcy0321,4,0.00026,362912,23.24754,1561077
9083,leachbj,4,0.00026,362916,23.24780,1561077
9084,leadVisionary,4,0.00026,362920,23.24805,1561077
9085,leandromoreirati,4,0.00026,362924,23.24831,1561077
9086,lee442,4,0.00026,362928,23.24856,1561077
9087,leelavathidh192,4,0.00026,362932,23.24882,1561077
9088,LegendRegent,4,0.00026,362936,23.24908,1561077
9089,lehmannk,4,0.00026,362940,23.24933,1561077
9090,lenslord,4,0.00026,362944,23.24959,1561077
9091,lesaux,4,0.00026,362948,23.24985,1561077
9092,lewisgj,4,0.00026,362952,23.25010,1561077
9093,lewisvail3,4,0.00026,362956,23.25036,1561077
9094,lexandro,4,0.00026,362960,23.25061,1561077
9095,lfcgomes,4,0.00026,362964,23.25087,1561077
9096,lianlab,4,0.00026,362968,23.25113,1561077
9097,liashuk-se,4,0.00026,362972,23.25138,1561077
9098,liborbitala,4,0.00026,362976,23.25164,1561077
9099,Lieth,4,0.00026,362980,23.25190,1561077
9100,lifefire1,4,0.00026,362984,23.25215,1561077
9101,lifeguardmedia,4,0.00026,362988,23.25241,1561077
9102,lightsprint09,4,0.00026,362992,23.25266,1561077
9103,li-jun,4,0.00026,362996,23.25292,1561077
9104,LilyHolms,4,0.00026,363000,23.25318,1561077
9105,linbjo,4,0.00026,363004,23.25343,1561077
9106,lindt,4,0.00026,363008,23.25369,1561077
9107,lisotton,4,0.00026,363012,23.25395,1561077
9108,little-fish,4,0.00026,363016,23.25420,1561077
9109,liubin-cm,4,0.00026,363020,23.25446,1561077
9110,liuqunqi,4,0.00026,363024,23.25471,1561077
9111,ljohnston,4,0.00026,363028,23.25497,1561077
9112,lkillgore,4,0.00026,363032,23.25523,1561077
9113,lkzcgfvf,4,0.00026,363036,23.25548,1561077
9114,llchan,4,0.00026,363040,23.25574,1561077
9115,lmmc,4,0.00026,363044,23.25600,1561077
9116,lne3,4,0.00026,363048,23.25625,1561077
9117,LongLiveCHIEF,4,0.00026,363052,23.25651,1561077
9118,lony,4,0.00026,363056,23.25676,1561077
9119,lookAtThat,4,0.00026,363060,23.25702,1561077
9120,loonychewy,4,0.00026,363064,23.25728,1561077
9121,lopiter,4,0.00026,363068,23.25753,1561077
9122,lordkada,4,0.00026,363072,23.25779,1561077
9123,Lorgouil,4,0.00026,363076,23.25805,1561077
9124,lornadsilvasonos,4,0.00026,363080,23.25830,1561077
9125,lovesunshine,4,0.00026,363084,23.25856,1561077
9126,lowsky,4,0.00026,363088,23.25881,1561077
9127,lpinguin,4,0.00026,363092,23.25907,1561077
9128,LPMadness,4,0.00026,363096,23.25933,1561077
9129,lschwahn,4,0.00026,363100,23.25958,1561077
9130,lslebodn,4,0.00026,363104,23.25984,1561077
9131,ltensok,4,0.00026,363108,23.26010,1561077
9132,LuboVarga,4,0.00026,363112,23.26035,1561077
9133,luckmager,4,0.00026,363116,23.26061,1561077
9134,LuckyLakshoo,4,0.00026,363120,23.26086,1561077
9135,ludrao,4,0.00026,363124,23.26112,1561077
9136,lukaasc,4,0.00026,363128,23.26138,1561077
9137,lukashonak,4,0.00026,363132,23.26163,1561077
9138,lukesantoro,4,0.00026,363136,23.26189,1561077
9139,lukosan,4,0.00026,363140,23.26215,1561077
9140,lunodesouza,4,0.00026,363144,23.26240,1561077
9141,lvcz,4,0.00026,363148,23.26266,1561077
9142,lvryasaswi,4,0.00026,363152,23.26291,1561077
9143,lybaokhanh,4,0.00026,363156,23.26317,1561077
9144,lydialiu199403,4,0.00026,363160,23.26343,1561077
9145,m00dawg,4,0.00026,363164,23.26368,1561077
9146,m4ndr4ck,4,0.00026,363168,23.26394,1561077
9147,maartenc,4,0.00026,363172,23.26420,1561077
9148,MaartenDCrius,4,0.00026,363176,23.26445,1561077
9149,MaartenJansenPinkRoccade,4,0.00026,363180,23.26471,1561077
9150,macg33zr,4,0.00026,363184,23.26496,1561077
9151,mack1040,4,0.00026,363188,23.26522,1561077
9152,maclean,4,0.00026,363192,23.26548,1561077
9153,madbrenner,4,0.00026,363196,23.26573,1561077
9154,maddingo,4,0.00026,363200,23.26599,1561077
9155,mafuyuasahina,4,0.00026,363204,23.26625,1561077
9156,magnum99,4,0.00026,363208,23.26650,1561077
9157,mahernoz-d,4,0.00026,363212,23.26676,1561077
9158,maiksaray,4,0.00026,363216,23.26701,1561077
9159,maiksensi,4,0.00026,363220,23.26727,1561077
9160,mailat,4,0.00026,363224,23.26753,1561077
9161,majje,4,0.00026,363228,23.26778,1561077
9162,maljaberi,4,0.00026,363232,23.26804,1561077
9163,maluguos,4,0.00026,363236,23.26829,1561077
9164,maly7,4,0.00026,363240,23.26855,1561077
9165,mansoormb,4,0.00026,363244,23.26881,1561077
9166,manuel2258,4,0.00026,363248,23.26906,1561077
9167,mape2k,4,0.00026,363252,23.26932,1561077
9168,mar1ged,4,0.00026,363256,23.26958,1561077
9169,marc0s,4,0.00026,363260,23.26983,1561077
9170,marcinwalczyk,4,0.00026,363264,23.27009,1561077
9171,marcmillien,4,0.00026,363268,23.27034,1561077
9172,MarcosDaNight,4,0.00026,363272,23.27060,1561077
9173,ma-re-k,4,0.00026,363276,23.27086,1561077
9174,marfx000,4,0.00026,363280,23.27111,1561077
9175,MarianMacik,4,0.00026,363284,23.27137,1561077
9176,Mariushrek,4,0.00026,363288,23.27163,1561077
9177,mark-1003,4,0.00026,363292,23.27188,1561077
9178,marktb1,4,0.00026,363296,23.27214,1561077
9179,maroschutte,4,0.00026,363300,23.27239,1561077
9180,marounayli,4,0.00026,363304,23.27265,1561077
9181,marqaaron,4,0.00026,363308,23.27291,1561077
9182,martedesco,4,0.00026,363312,23.27316,1561077
9183,Martin4Prog,4,0.00026,363316,23.27342,1561077
9184,MartinMuzatko,4,0.00026,363320,23.27368,1561077
9185,mashinarius,4,0.00026,363324,23.27393,1561077
9186,massimo-pacher-tw,4,0.00026,363328,23.27419,1561077
9187,MassimoSporchia,4,0.00026,363332,23.27444,1561077
9188,masterdrdark,4,0.00026,363336,23.27470,1561077
9189,matfur92,4,0.00026,363340,23.27496,1561077
9190,Mathiasdm,4,0.00026,363344,23.27521,1561077
9191,mathieudevos,4,0.00026,363348,23.27547,1561077
9192,mathjeff,4,0.00026,363352,23.27573,1561077
9193,MatteoPierro,4,0.00026,363356,23.27598,1561077
9194,MatthewChickoree,4,0.00026,363360,23.27624,1561077
9195,mattjmorrison,4,0.00026,363364,23.27649,1561077
9196,mattjohnson,4,0.00026,363368,23.27675,1561077
9197,mattrick16,4,0.00026,363372,23.27701,1561077
9198,matty1979,4,0.00026,363376,23.27726,1561077
9199,matzipan,4,0.00026,363380,23.27752,1561077
9200,mauriciojovel,4,0.00026,363384,23.27778,1561077
9201,Maverobot,4,0.00026,363388,23.27803,1561077
9202,maxiv,4,0.00026,363392,23.27829,1561077
9203,mazen-ammar,4,0.00026,363396,23.27854,1561077
9204,mbauhardt,4,0.00026,363400,23.27880,1561077
9205,mbharatk,4,0.00026,363404,23.27906,1561077
9206,mbogner,4,0.00026,363408,23.27931,1561077
9207,mbukosky,4,0.00026,363412,23.27957,1561077
9208,mbxsuite,4,0.00026,363416,23.27983,1561077
9209,MCardenasBlanco,4,0.00026,363420,23.28008,1561077
9210,mcedica,4,0.00026,363424,23.28034,1561077
9211,mcginkel,4,0.00026,363428,23.28059,1561077
9212,mchoyal,4,0.00026,363432,23.28085,1561077
9213,mckramer,4,0.00026,363436,23.28111,1561077
9214,mcsage,4,0.00026,363440,23.28136,1561077
9215,mdcsaenz,4,0.00026,363444,23.28162,1561077
9216,mdiers,4,0.00026,363448,23.28188,1561077
9217,mdtetlow,4,0.00026,363452,23.28213,1561077
9218,mdumpati,4,0.00026,363456,23.28239,1561077
9219,Mehdi-BR,4,0.00026,363460,23.28264,1561077
9220,meitingshuoguo,4,0.00026,363464,23.28290,1561077
9221,melodywin,4,0.00026,363468,23.28316,1561077
9222,mettacrawler,4,0.00026,363472,23.28341,1561077
9223,mfa-inverso,4,0.00026,363476,23.28367,1561077
9224,mgaunin-cloudbees,4,0.00026,363480,23.28393,1561077
9225,mgorovoy,4,0.00026,363484,23.28418,1561077
9226,mhagnumdw,4,0.00026,363488,23.28444,1561077
9227,mheuser,4,0.00026,363492,23.28469,1561077
9228,mibj01,4,0.00026,363496,23.28495,1561077
9229,MichaelGissingNC,4,0.00026,363500,23.28521,1561077
9230,michaelholtermann,4,0.00026,363504,23.28546,1561077
9231,MichaelKorn,4,0.00026,363508,23.28572,1561077
9232,MichaelMarkieta,4,0.00026,363512,23.28598,1561077
9233,michaljrk,4,0.00026,363516,23.28623,1561077
9234,michelepagot,4,0.00026,363520,23.28649,1561077
9235,michelleXIE2014,4,0.00026,363524,23.28674,1561077
9236,micheltol,4,0.00026,363528,23.28700,1561077
9237,mickael-caro-sonarsource,4,0.00026,363532,23.28726,1561077
9238,mienaikage,4,0.00026,363536,23.28751,1561077
9239,mig4ng,4,0.00026,363540,23.28777,1561077
9240,mihai-dinu,4,0.00026,363544,23.28802,1561077
9241,Mike4Online,4,0.00026,363548,23.28828,1561077
9242,mikerossiter,4,0.00026,363552,23.28854,1561077
9243,mike-sol,4,0.00026,363556,23.28879,1561077
9244,mikespartan,4,0.00026,363560,23.28905,1561077
9245,MikeyCarter,4,0.00026,363564,23.28931,1561077
9246,MilesRoberts,4,0.00026,363568,23.28956,1561077
9247,mindbirth,4,0.00026,363572,23.28982,1561077
9248,mingatfullcontact,4,0.00026,363576,23.29007,1561077
9249,Minh-Chien,4,0.00026,363580,23.29033,1561077
9250,minjimwu,4,0.00026,363584,23.29059,1561077
9251,minotaurrr,4,0.00026,363588,23.29084,1561077
9252,MiralDesai,4,0.00026,363592,23.29110,1561077
9253,MishkaTheCub,4,0.00026,363596,23.29136,1561077
9254,mitoma,4,0.00026,363600,23.29161,1561077
9255,mjgallag,4,0.00026,363604,23.29187,1561077
9256,mkoenig96,4,0.00026,363608,23.29212,1561077
9257,mkp05,4,0.00026,363612,23.29238,1561077
9258,mk-qi,4,0.00026,363616,23.29264,1561077
9259,mlevitzzky,4,0.00026,363620,23.29289,1561077
9260,mmuehlberger,4,0.00026,363624,23.29315,1561077
9261,mmugabo-rockhs,4,0.00026,363628,23.29341,1561077
9262,mmweiyin,4,0.00026,363632,23.29366,1561077
9263,mnsanghvi,4,0.00026,363636,23.29392,1561077
9264,mocnimar,4,0.00026,363640,23.29417,1561077
9265,Modelizer,4,0.00026,363644,23.29443,1561077
9266,mohitdevops3,4,0.00026,363648,23.29469,1561077
9267,Mohjive,4,0.00026,363652,23.29494,1561077
9268,moimart1,4,0.00026,363656,23.29520,1561077
9269,mojocorp,4,0.00026,363660,23.29546,1561077
9270,molexx,4,0.00026,363664,23.29571,1561077
9271,monester,4,0.00026,363668,23.29597,1561077
9272,monluk,4,0.00026,363672,23.29622,1561077
9273,monstrfolk,4,0.00026,363676,23.29648,1561077
9274,Moofasax,4,0.00026,363680,23.29674,1561077
9275,moosilauke18,4,0.00026,363684,23.29699,1561077
9276,morlajb,4,0.00026,363688,23.29725,1561077
9277,mortymacs,4,0.00026,363692,23.29751,1561077
9278,mostafahussein,4,0.00026,363696,23.29776,1561077
9279,motlib,4,0.00026,363700,23.29802,1561077
9280,motokotoboom,4,0.00026,363704,23.29827,1561077
9281,Mouheb22,4,0.00026,363708,23.29853,1561077
9282,mountaineer123,4,0.00026,363712,23.29879,1561077
9283,mourasman,4,0.00026,363716,23.29904,1561077
9284,moussetc,4,0.00026,363720,23.29930,1561077
9285,MovaUA,4,0.00026,363724,23.29956,1561077
9286,Mozanrath,4,0.00026,363728,23.29981,1561077
9287,moznion,4,0.00026,363732,23.30007,1561077
9288,mpagnucco,4,0.00026,363736,23.30032,1561077
9289,mpires,4,0.00026,363740,23.30058,1561077
9290,mp-mba,4,0.00026,363744,23.30084,1561077
9291,mrinalvirnave,4,0.00026,363748,23.30109,1561077
9292,Mr-LiuDC,4,0.00026,363752,23.30135,1561077
9293,mruepp,4,0.00026,363756,23.30161,1561077
9294,mscholze,4,0.00026,363760,23.30186,1561077
9295,msdinesh07,4,0.00026,363764,23.30212,1561077
9296,msebire,4,0.00026,363768,23.30237,1561077
9297,msegura501,4,0.00026,363772,23.30263,1561077
9298,msilininaceur,4,0.00026,363776,23.30289,1561077
9299,msqb,4,0.00026,363780,23.30314,1561077
9300,mtechn,4,0.00026,363784,23.30340,1561077
9301,mtheiss,4,0.00026,363788,23.30366,1561077
9302,mudlo,4,0.00026,363792,23.30391,1561077
9303,muffgaga,4,0.00026,363796,23.30417,1561077
9304,muhammedeminakbulut,4,0.00026,363800,23.30442,1561077
9305,muhammedfarahat-kg,4,0.00026,363804,23.30468,1561077
9306,muru,4,0.00026,363808,23.30494,1561077
9307,Mutabazi3,4,0.00026,363812,23.30519,1561077
9308,muxmuse,4,0.00026,363816,23.30545,1561077
9309,mwebber,4,0.00026,363820,23.30570,1561077
9310,mwmanley,4,0.00026,363824,23.30596,1561077
9311,mwoodland,4,0.00026,363828,23.30622,1561077
9312,n1try,4,0.00026,363832,23.30647,1561077
9313,n888,4,0.00026,363836,23.30673,1561077
9314,n8mellis,4,0.00026,363840,23.30699,1561077
9315,Naensma,4,0.00026,363844,23.30724,1561077
9316,nagypeterjob,4,0.00026,363848,23.30750,1561077
9317,nahuelcassinarijamf,4,0.00026,363852,23.30775,1561077
9318,naighes,4,0.00026,363856,23.30801,1561077
9319,nandeeshb09,4,0.00026,363860,23.30827,1561077
9320,NandoTheessen,4,0.00026,363864,23.30852,1561077
9321,nanguaSky,4,0.00026,363868,23.30878,1561077
9322,nanori,4,0.00026,363872,23.30904,1561077
9323,NasAmin,4,0.00026,363876,23.30929,1561077
9324,nbars,4,0.00026,363880,23.30955,1561077
9325,nchandra-seg,4,0.00026,363884,23.30980,1561077
9326,ncouture,4,0.00026,363888,23.31006,1561077
9327,ncreuschling,4,0.00026,363892,23.31032,1561077
9328,ncsurfus,4,0.00026,363896,23.31057,1561077
9329,Nebojsa92,4,0.00026,363900,23.31083,1561077
9330,neil-greenwood,4,0.00026,363904,23.31109,1561077
9331,neiltingley,4,0.00026,363908,23.31134,1561077
9332,nerumo,4,0.00026,363912,23.31160,1561077
9333,NesManrique,4,0.00026,363916,23.31185,1561077
9334,netfalo,4,0.00026,363920,23.31211,1561077
9335,neurolabs,4,0.00026,363924,23.31237,1561077
9336,NeverOddOrEven,4,0.00026,363928,23.31262,1561077
9337,NewmanJ1987,4,0.00026,363932,23.31288,1561077
9338,nfelsen,4,0.00026,363936,23.31314,1561077
9339,NFollett89,4,0.00026,363940,23.31339,1561077
9340,nguyenhoan,4,0.00026,363944,23.31365,1561077
9341,NHLJang,4,0.00026,363948,23.31390,1561077
9342,nhunsperger,4,0.00026,363952,23.31416,1561077
9343,nick3389,4,0.00026,363956,23.31442,1561077
9344,nick-thompson,4,0.00026,363960,23.31467,1561077
9345,nickzelei,4,0.00026,363964,23.31493,1561077
9346,niclan,4,0.00026,363968,23.31519,1561077
9347,nicolasiltis,4,0.00026,363972,23.31544,1561077
9348,NigelZHANG,4,0.00026,363976,23.31570,1561077
9349,nightskyguy,4,0.00026,363980,23.31595,1561077
9350,nikhilbhambure,4,0.00026,363984,23.31621,1561077
9351,nikita-v,4,0.00026,363988,23.31647,1561077
9352,nikola-da,4,0.00026,363992,23.31672,1561077
9353,NikolayStanoev,4,0.00026,363996,23.31698,1561077
9354,nilskasseckert,4,0.00026,364000,23.31724,1561077
9355,ningjunwei2,4,0.00026,364004,23.31749,1561077
9356,nitro2003,4,0.00026,364008,23.31775,1561077
9357,nitrocode,4,0.00026,364012,23.31800,1561077
9358,niveshvashist,4,0.00026,364016,23.31826,1561077
9359,njpau,4,0.00026,364020,23.31852,1561077
9360,NKJensen,4,0.00026,364024,23.31877,1561077
9361,n-marion,4,0.00026,364028,23.31903,1561077
9362,nmcafee,4,0.00026,364032,23.31929,1561077
9363,nMustaki,4,0.00026,364036,23.31954,1561077
9364,noahgorka,4,0.00026,364040,23.31980,1561077
9365,noamhurwitz,4,0.00026,364044,23.32005,1561077
9366,noamtamim,4,0.00026,364048,23.32031,1561077
9367,nocono,4,0.00026,364052,23.32057,1561077
9368,noidic,4,0.00026,364056,23.32082,1561077
9369,noiseoverip,4,0.00026,364060,23.32108,1561077
9370,NonGrate,4,0.00026,364064,23.32134,1561077
9371,NoodlesNZ,4,0.00026,364068,23.32159,1561077
9372,noseworthy,4,0.00026,364072,23.32185,1561077
9373,notsudo,4,0.00026,364076,23.32210,1561077
9374,novirael,4,0.00026,364080,23.32236,1561077
9375,nowakca,4,0.00026,364084,23.32262,1561077
9376,noyard,4,0.00026,364088,23.32287,1561077
9377,nsoubelet,4,0.00026,364092,23.32313,1561077
9378,ntherning,4,0.00026,364096,23.32339,1561077
9379,nvdhaider,4,0.00026,364100,23.32364,1561077
9380,nyurik,4,0.00026,364104,23.32390,1561077
9381,obataku,4,0.00026,364108,23.32415,1561077
9382,obegron,4,0.00026,364112,23.32441,1561077
9383,ocsxxi,4,0.00026,364116,23.32467,1561077
9384,octavifs,4,0.00026,364120,23.32492,1561077
9385,OctoElla,4,0.00026,364124,23.32518,1561077
9386,odam06,4,0.00026,364128,23.32543,1561077
9387,ofasterling,4,0.00026,364132,23.32569,1561077
9388,oferziss,4,0.00026,364136,23.32595,1561077
9389,ohsawa0515,4,0.00026,364140,23.32620,1561077
9390,okapia,4,0.00026,364144,23.32646,1561077
9391,okram999,4,0.00026,364148,23.32672,1561077
9392,okuramasafumi,4,0.00026,364152,23.32697,1561077
9393,oleg-kondaurov,4,0.00026,364156,23.32723,1561077
9394,olenz,4,0.00026,364160,23.32748,1561077
9395,oli-g,4,0.00026,364164,23.32774,1561077
9396,OlivierdcMV,4,0.00026,364168,23.32800,1561077
9397,om3171991,4,0.00026,364172,23.32825,1561077
9398,OmarCherdal1997,4,0.00026,364176,23.32851,1561077
9399,OneMoreByte,4,0.00026,364180,23.32877,1561077
9400,onlynone,4,0.00026,364184,23.32902,1561077
9401,onthedock,4,0.00026,364188,23.32928,1561077
9402,oredigger8806,4,0.00026,364192,23.32953,1561077
9403,orinbou,4,0.00026,364196,23.32979,1561077
9404,orisano,4,0.00026,364200,23.33005,1561077
9405,orkenstein,4,0.00026,364204,23.33030,1561077
9406,orthoxerox,4,0.00026,364208,23.33056,1561077
9407,ottofds1,4,0.00026,364212,23.33082,1561077
9408,ouyangshixiong,4,0.00026,364216,23.33107,1561077
9409,oviupstack,4,0.00026,364220,23.33133,1561077
9410,owengo,4,0.00026,364224,23.33158,1561077
9411,oxmane,4,0.00026,364228,23.33184,1561077
9412,ozcanovunc,4,0.00026,364232,23.33210,1561077
9413,paba19,4,0.00026,364236,23.33235,1561077
9414,pablogrs,4,0.00026,364240,23.33261,1561077
9415,pagio81,4,0.00026,364244,23.33287,1561077
9416,paladin-devops,4,0.00026,364248,23.33312,1561077
9417,palladius,4,0.00026,364252,23.33338,1561077
9418,pallam-bigfoot,4,0.00026,364256,23.33363,1561077
9419,PandarinDev,4,0.00026,364260,23.33389,1561077
9420,paramosr,4,0.00026,364264,23.33415,1561077
9421,parasp443,4,0.00026,364268,23.33440,1561077
9422,parikmaan,4,0.00026,364272,23.33466,1561077
9423,parin921996,4,0.00026,364276,23.33492,1561077
9424,parkerlarry,4,0.00026,364280,23.33517,1561077
9425,parshimers,4,0.00026,364284,23.33543,1561077
9426,pash-slack,4,0.00026,364288,23.33568,1561077
9427,pasindujw,4,0.00026,364292,23.33594,1561077
9428,pasokan-ddn,4,0.00026,364296,23.33620,1561077
9429,patrickathompson,4,0.00026,364300,23.33645,1561077
9430,patrickhuy,4,0.00026,364304,23.33671,1561077
9431,patrickwall57,4,0.00026,364308,23.33697,1561077
9432,paulchubatyy,4,0.00026,364312,23.33722,1561077
9433,paulogodinhoaq,4,0.00026,364316,23.33748,1561077
9434,pavankurimilla,4,0.00026,364320,23.33773,1561077
9435,pavelkokush,4,0.00026,364324,23.33799,1561077
9436,pawan163,4,0.00026,364328,23.33825,1561077
9437,pawansingh1989,4,0.00026,364332,23.33850,1561077
9438,pazfelipe,4,0.00026,364336,23.33876,1561077
9439,pbayarri,4,0.00026,364340,23.33902,1561077
9440,pbradly,4,0.00026,364344,23.33927,1561077
9441,pcas,4,0.00026,364348,23.33953,1561077
9442,pecak2,4,0.00026,364352,23.33978,1561077
9443,peinheber-mersive,4,0.00026,364356,23.34004,1561077
9444,pete965,4,0.00026,364360,23.34030,1561077
9445,pete-by,4,0.00026,364364,23.34055,1561077
9446,peter-walls,4,0.00026,364368,23.34081,1561077
9447,peterwvj,4,0.00026,364372,23.34107,1561077
9448,pfhorman,4,0.00026,364376,23.34132,1561077
9449,pgAdmin,4,0.00026,364380,23.34158,1561077
9450,pgchb,4,0.00026,364384,23.34183,1561077
9451,pgraemer,4,0.00026,364388,23.34209,1561077
9452,philipa,4,0.00026,364392,23.34235,1561077
9453,philiplrb,4,0.00026,364396,23.34260,1561077
9454,PhilippeRaven,4,0.00026,364400,23.34286,1561077
9455,phil-pona,4,0.00026,364404,23.34312,1561077
9456,phishy,4,0.00026,364408,23.34337,1561077
9457,pierreluctg,4,0.00026,364412,23.34363,1561077
9458,PierreR,4,0.00026,364416,23.34388,1561077
9459,pingcrosby,4,0.00026,364420,23.34414,1561077
9460,Pinny3,4,0.00026,364424,23.34440,1561077
9461,PiotrMarcinczyk-TomTom,4,0.00026,364428,23.34465,1561077
9462,pitkley,4,0.00026,364432,23.34491,1561077
9463,pjmeisch-cc,4,0.00026,364436,23.34516,1561077
9464,pj-phx,4,0.00026,364440,23.34542,1561077
9465,pjsier,4,0.00026,364444,23.34568,1561077
9466,pleckey,4,0.00026,364448,23.34593,1561077
9467,pong-takepart,4,0.00026,364452,23.34619,1561077
9468,popopanda,4,0.00026,364456,23.34645,1561077
9469,poulad,4,0.00026,364460,23.34670,1561077
9470,pouwerkerk,4,0.00026,364464,23.34696,1561077
9471,prabhukasisekar,4,0.00026,364468,23.34721,1561077
9472,prafullkotecha,4,0.00026,364472,23.34747,1561077
9473,prakhar-aqua,4,0.00026,364476,23.34773,1561077
9474,prashant-chai,4,0.00026,364480,23.34798,1561077
9475,pratamov,4,0.00026,364484,23.34824,1561077
9476,praveen12bnitt,4,0.00026,364488,23.34850,1561077
9477,praveendath92,4,0.00026,364492,23.34875,1561077
9478,pravynandas,4,0.00026,364496,23.34901,1561077
9479,prayagvakharia,4,0.00026,364500,23.34926,1561077
9480,premkiran7,4,0.00026,364504,23.34952,1561077
9481,priyadarshan85,4,0.00026,364508,23.34978,1561077
9482,p-rog,4,0.00026,364512,23.35003,1561077
9483,progix21,4,0.00026,364516,23.35029,1561077
9484,programminh,4,0.00026,364520,23.35055,1561077
9485,Protopopys,4,0.00026,364524,23.35080,1561077
9486,proxium,4,0.00026,364528,23.35106,1561077
9487,psantos1113,4,0.00026,364532,23.35131,1561077
9488,pscosta,4,0.00026,364536,23.35157,1561077
9489,PseudoCoding,4,0.00026,364540,23.35183,1561077
9490,psharkey,4,0.00026,364544,23.35208,1561077
9491,psmod2,4,0.00026,364548,23.35234,1561077
9492,ptarjan,4,0.00026,364552,23.35260,1561077
9493,ptrlaszlo,4,0.00026,364556,23.35285,1561077
9494,puckel,4,0.00026,364560,23.35311,1561077
9495,pulquero,4,0.00026,364564,23.35336,1561077
9496,punitag,4,0.00026,364568,23.35362,1561077
9497,pvilasra,4,0.00026,364572,23.35388,1561077
9498,PyGuy2,4,0.00026,364576,23.35413,1561077
9499,pyrocks,4,0.00026,364580,23.35439,1561077
9500,PyvesB,4,0.00026,364584,23.35465,1561077
9501,qhua948,4,0.00026,364588,23.35490,1561077
9502,qingchuwudi,4,0.00026,364592,23.35516,1561077
9503,qixiaobo,4,0.00026,364596,23.35541,1561077
9504,qris,4,0.00026,364600,23.35567,1561077
9505,quincy-codametrix,4,0.00026,364604,23.35593,1561077
9506,quintesse,4,0.00026,364608,23.35618,1561077
9507,R3dIO,4,0.00026,364612,23.35644,1561077
9508,racodond,4,0.00026,364616,23.35670,1561077
9509,radical81,4,0.00026,364620,23.35695,1561077
9510,raducanuoctavian,4,0.00026,364624,23.35721,1561077
9511,rafalhejna,4,0.00026,364628,23.35746,1561077
9512,rafal-prasal,4,0.00026,364632,23.35772,1561077
9513,ragaller,4,0.00026,364636,23.35798,1561077
9514,ragnaros2046,4,0.00026,364640,23.35823,1561077
9515,rahbal,4,0.00026,364644,23.35849,1561077
9516,Raibaz,4,0.00026,364648,23.35875,1561077
9517,Rajankhosla,4,0.00026,364652,23.35900,1561077
9518,rajat1401,4,0.00026,364656,23.35926,1561077
9519,Rajat2213,4,0.00026,364660,23.35951,1561077
9520,rakesh-joshi,4,0.00026,364664,23.35977,1561077
9521,ralph089,4,0.00026,364668,23.36003,1561077
9522,randomswdev,4,0.00026,364672,23.36028,1561077
9523,randyaa,4,0.00026,364676,23.36054,1561077
9524,ranjith-ka,4,0.00026,364680,23.36080,1561077
9525,ranjithvuppala,4,0.00026,364684,23.36105,1561077
9526,raquelroriz,4,0.00026,364688,23.36131,1561077
9527,ratripathi,4,0.00026,364692,23.36156,1561077
9528,raunak111,4,0.00026,364696,23.36182,1561077
9529,rbambrough-intel,4,0.00026,364700,23.36208,1561077
9530,rcfja,4,0.00026,364704,23.36233,1561077
9531,rchkv,4,0.00026,364708,23.36259,1561077
9532,rdica,4,0.00026,364712,23.36285,1561077
9533,rdong333,4,0.00026,364716,23.36310,1561077
9534,ReadyAPIAgent,4,0.00026,364720,23.36336,1561077
9535,RedDwarf69,4,0.00026,364724,23.36361,1561077
9536,redlumxn,4,0.00026,364728,23.36387,1561077
9537,redr0bin,4,0.00026,364732,23.36413,1561077
9538,redturtlepower,4,0.00026,364736,23.36438,1561077
9539,reinhapa,4,0.00026,364740,23.36464,1561077
9540,reinsch82,4,0.00026,364744,23.36489,1561077
9541,RemigiuszDudek,4,0.00026,364748,23.36515,1561077
9542,renannprado,4,0.00026,364752,23.36541,1561077
9543,Resisty,4,0.00026,364756,23.36566,1561077
9544,rezroo,4,0.00026,364760,23.36592,1561077
9545,rholder,4,0.00026,364764,23.36618,1561077
9546,riazvm,4,0.00026,364768,23.36643,1561077
9547,ricardompcarvalho,4,0.00026,364772,23.36669,1561077
9548,ricbir,4,0.00026,364776,23.36694,1561077
9549,richardhunt,4,0.00026,364780,23.36720,1561077
9550,richardol,4,0.00026,364784,23.36746,1561077
9551,richardsimko,4,0.00026,364788,23.36771,1561077
9552,richid,4,0.00026,364792,23.36797,1561077
9553,richnou,4,0.00026,364796,23.36823,1561077
9554,rick-a-lane-ii,4,0.00026,364800,23.36848,1561077
9555,RicoToothless,4,0.00026,364804,23.36874,1561077
9556,ricxsar,4,0.00026,364808,23.36899,1561077
9557,RiddlerKnight,4,0.00026,364812,23.36925,1561077
9558,rililinx,4,0.00026,364816,23.36951,1561077
9559,rishiraaz,4,0.00026,364820,23.36976,1561077
9560,ritchieGitHub,4,0.00026,364824,23.37002,1561077
9561,RiyaGupta89,4,0.00026,364828,23.37028,1561077
9562,RizzoV,4,0.00026,364832,23.37053,1561077
9563,rjackson-dev-ops,4,0.00026,364836,23.37079,1561077
9564,rkirkpat,4,0.00026,364840,23.37104,1561077
9565,rlagoue,4,0.00026,364844,23.37130,1561077
9566,rliu0009,4,0.00026,364848,23.37156,1561077
9567,rlnchow,4,0.00026,364852,23.37181,1561077
9568,rlogiacco,4,0.00026,364856,23.37207,1561077
9569,rmathewsbeyond,4,0.00026,364860,23.37233,1561077
9570,rmeshenberg,4,0.00026,364864,23.37258,1561077
9571,robkorv,4,0.00026,364868,23.37284,1561077
9572,rob-ott,4,0.00026,364872,23.37309,1561077
9573,rob-spoor,4,0.00026,364876,23.37335,1561077
9574,robtec,4,0.00026,364880,23.37361,1561077
9575,robzr,4,0.00026,364884,23.37386,1561077
9576,roccivic,4,0.00026,364888,23.37412,1561077
9577,rochanaatapattu,4,0.00026,364892,23.37438,1561077
9578,roDew,4,0.00026,364896,23.37463,1561077
9579,rodrigoGA,4,0.00026,364900,23.37489,1561077
9580,roelandg,4,0.00026,364904,23.37514,1561077
9581,roeman,4,0.00026,364908,23.37540,1561077
9582,Romain-Geissler-1A,4,0.00026,364912,23.37566,1561077
9583,romainlouvet,4,0.00026,364916,23.37591,1561077
9584,roman-bilyi,4,0.00026,364920,23.37617,1561077
9585,romansmat,4,0.00026,364924,23.37643,1561077
9586,ronaldoooo,4,0.00026,364928,23.37668,1561077
9587,roni-frantchi,4,0.00026,364932,23.37694,1561077
9588,Ronrey100,4,0.00026,364936,23.37719,1561077
9589,royceking,4,0.00026,364940,23.37745,1561077
9590,roynilanjan,4,0.00026,364944,23.37771,1561077
9591,rozhok,4,0.00026,364948,23.37796,1561077
9592,rozky,4,0.00026,364952,23.37822,1561077
9593,rrehbein,4,0.00026,364956,23.37848,1561077
9594,rsareth,4,0.00026,364960,23.37873,1561077
9595,Rsenjoyer,4,0.00026,364964,23.37899,1561077
9596,rsgrobot,4,0.00026,364968,23.37924,1561077
9597,Ruenzuo,4,0.00026,364972,23.37950,1561077
9598,rufreakde,4,0.00026,364976,23.37976,1561077
9599,rukkus,4,0.00026,364980,23.38001,1561077
9600,russell,4,0.00026,364984,23.38027,1561077
9601,rustycar54,4,0.00026,364988,23.38053,1561077
9602,rvsoni,4,0.00026,364992,23.38078,1561077
9603,ryancastle,4,0.00026,364996,23.38104,1561077
9604,ryandcartwright,4,0.00026,365000,23.38129,1561077
9605,ryanewk,4,0.00026,365004,23.38155,1561077
9606,ryangardner,4,0.00026,365008,23.38181,1561077
9607,ryanmiville,4,0.00026,365012,23.38206,1561077
9608,ryanpudd,4,0.00026,365016,23.38232,1561077
9609,ryanrupp,4,0.00026,365020,23.38257,1561077
9610,ryansmith303,4,0.00026,365024,23.38283,1561077
9611,Rykus0,4,0.00026,365028,23.38309,1561077
9612,s1rlon,4,0.00026,365032,23.38334,1561077
9613,sagaii,4,0.00026,365036,23.38360,1561077
9614,sagaraivale,4,0.00026,365040,23.38386,1561077
9615,sahoo007tm,4,0.00026,365044,23.38411,1561077
9616,SaiJyothiGudibandi,4,0.00026,365048,23.38437,1561077
9617,salonigoyal2309,4,0.00026,365052,23.38462,1561077
9618,Sam0x,4,0.00026,365056,23.38488,1561077
9619,sam1111,4,0.00026,365060,23.38514,1561077
9620,SambhaviPD,4,0.00026,365064,23.38539,1561077
9621,sameera464,4,0.00026,365068,23.38565,1561077
9622,samitkumarpatel,4,0.00026,365072,23.38591,1561077
9623,sam-shen,4,0.00026,365076,23.38616,1561077
9624,sandipnath,4,0.00026,365080,23.38642,1561077
9625,sandy2294,4,0.00026,365084,23.38667,1561077
9626,sandyiscool,4,0.00026,365088,23.38693,1561077
9627,sanjaysheel,4,0.00026,365092,23.38719,1561077
9628,sarina-dd,4,0.00026,365096,23.38744,1561077
9629,SaschaSchwarz,4,0.00026,365100,23.38770,1561077
9630,sa-spag,4,0.00026,365104,23.38796,1561077
9631,satishdg,4,0.00026,365108,23.38821,1561077
9632,satyasonu,4,0.00026,365112,23.38847,1561077
9633,SauceMcFloss,4,0.00026,365116,23.38872,1561077
9634,sawujul,4,0.00026,365120,23.38898,1561077
9635,sbartram,4,0.00026,365124,23.38924,1561077
9636,sboehmann,4,0.00026,365128,23.38949,1561077
9637,sbussard,4,0.00026,365132,23.38975,1561077
9638,sbyrd-edmunds,4,0.00026,365136,23.39001,1561077
9639,scattym,4,0.00026,365140,23.39026,1561077
9640,schatti123,4,0.00026,365144,23.39052,1561077
9641,schendel,4,0.00026,365148,23.39077,1561077
9642,schmidtwastl,4,0.00026,365152,23.39103,1561077
9643,schniedergers,4,0.00026,365156,23.39129,1561077
9644,scramados,4,0.00026,365160,23.39154,1561077
9645,seacephos,4,0.00026,365164,23.39180,1561077
9646,SeanKilleen,4,0.00026,365168,23.39206,1561077
9647,sebastian-sauer,4,0.00026,365172,23.39231,1561077
9648,sebcworks,4,0.00026,365176,23.39257,1561077
9649,sebosp,4,0.00026,365180,23.39282,1561077
9650,sebzimmermann,4,0.00026,365184,23.39308,1561077
9651,senkrad76,4,0.00026,365188,23.39334,1561077
9652,seregasheypak,4,0.00026,365192,23.39359,1561077
9653,serg-bs,4,0.00026,365196,23.39385,1561077
9654,Sergh888,4,0.00026,365200,23.39411,1561077
9655,sergio-opslevel,4,0.00026,365204,23.39436,1561077
9656,serianox,4,0.00026,365208,23.39462,1561077
9657,sethev,4,0.00026,365212,23.39487,1561077
9658,seunroava,4,0.00026,365216,23.39513,1561077
9659,sevaho,4,0.00026,365220,23.39539,1561077
9660,sevenbill,4,0.00026,365224,23.39564,1561077
9661,seyguai,4,0.00026,365228,23.39590,1561077
9662,shaedis,4,0.00026,365232,23.39616,1561077
9663,shahkv95,4,0.00026,365236,23.39641,1561077
9664,Shahnawaz-Sk,4,0.00026,365240,23.39667,1561077
9665,shaiban,4,0.00026,365244,23.39692,1561077
9666,shaik447,4,0.00026,365248,23.39718,1561077
9667,shanab,4,0.00026,365252,23.39744,1561077
9668,shanep2300,4,0.00026,365256,23.39769,1561077
9669,sharad-mbk,4,0.00026,365260,23.39795,1561077
9670,shaulishaked,4,0.00026,365264,23.39821,1561077
9671,ShaunDAdams,4,0.00026,365268,23.39846,1561077
9672,shauvik,4,0.00026,365272,23.39872,1561077
9673,shayl,4,0.00026,365276,23.39897,1561077
9674,shiangree,4,0.00026,365280,23.39923,1561077
9675,shindevishal1443,4,0.00026,365284,23.39949,1561077
9676,shindouj,4,0.00026,365288,23.39974,1561077
9677,shipk,4,0.00026,365292,23.40000,1561077
9678,shirosaki,4,0.00026,365296,23.40026,1561077
9679,shivako,4,0.00026,365300,23.40051,1561077
9680,shivamdixit,4,0.00026,365304,23.40077,1561077
9681,shivang-sharma,4,0.00026,365308,23.40102,1561077
9682,ShivaPotlapelli,4,0.00026,365312,23.40128,1561077
9683,shiwano,4,0.00026,365316,23.40154,1561077
9684,shizhz,4,0.00026,365320,23.40179,1561077
9685,Shnitzelil,4,0.00026,365324,23.40205,1561077
9686,shochdoerfer,4,0.00026,365328,23.40230,1561077
9687,shokohsc,4,0.00026,365332,23.40256,1561077
9688,Shop-kins,4,0.00026,365336,23.40282,1561077
9689,ShortCipher42,4,0.00026,365340,23.40307,1561077
9690,shreknitin89,4,0.00026,365344,23.40333,1561077
9691,shresthsuman,4,0.00026,365348,23.40359,1561077
9692,ShreyasSubhedar,4,0.00026,365352,23.40384,1561077
9693,shuai-gao-awx,4,0.00026,365356,23.40410,1561077
9694,shubhamrajvanshi,4,0.00026,365360,23.40435,1561077
9695,shubhamsingh93,4,0.00026,365364,23.40461,1561077
9696,shubhsinghh,4,0.00026,365368,23.40487,1561077
9697,shuklak-els,4,0.00026,365372,23.40512,1561077
9698,shysteph,4,0.00026,365376,23.40538,1561077
9699,Sibicoder,4,0.00026,365380,23.40564,1561077
9700,Sickafant,4,0.00026,365384,23.40589,1561077
9701,siggae,4,0.00026,365388,23.40615,1561077
9702,sijis,4,0.00026,365392,23.40640,1561077
9703,SIkebe,4,0.00026,365396,23.40666,1561077
9704,silverl,4,0.00026,365400,23.40692,1561077
9705,simao,4,0.00026,365404,23.40717,1561077
9706,simonCor,4,0.00026,365408,23.40743,1561077
9707,SimonDevineau,4,0.00026,365412,23.40769,1561077
9708,simontunnat,4,0.00026,365416,23.40794,1561077
9709,simplyviks,4,0.00026,365420,23.40820,1561077
9710,sinback,4,0.00026,365424,23.40845,1561077
9711,Singapore-Tech-Entrepreneurs,4,0.00026,365428,23.40871,1561077
9712,sinkcup,4,0.00026,365432,23.40897,1561077
9713,sinnstudio-nas,4,0.00026,365436,23.40922,1561077
9714,sipani909,4,0.00026,365440,23.40948,1561077
9715,sirhopcount,4,0.00026,365444,23.40974,1561077
9716,sirkaiserkai,4,0.00026,365448,23.40999,1561077
9717,sivarp,4,0.00026,365452,23.41025,1561077
9718,sj666663,4,0.00026,365456,23.41050,1561077
9719,sjqnn,4,0.00026,365460,23.41076,1561077
9720,skalaiyarasan,4,0.00026,365464,23.41102,1561077
9721,skillingbeck,4,0.00026,365468,23.41127,1561077
9722,skommula96,4,0.00026,365472,23.41153,1561077
9723,skrobot,4,0.00026,365476,23.41179,1561077
9724,skyionblue,4,0.00026,365480,23.41204,1561077
9725,slavakl,4,0.00026,365484,23.41230,1561077
9726,sli921,4,0.00026,365488,23.41255,1561077
9727,slimmaalej,4,0.00026,365492,23.41281,1561077
9728,slingcode,4,0.00026,365496,23.41307,1561077
9729,smann297,4,0.00026,365500,23.41332,1561077
9730,SMEmp,4,0.00026,365504,23.41358,1561077
9731,smerck,4,0.00026,365508,23.41384,1561077
9732,smileatom,4,0.00026,365512,23.41409,1561077
9733,smitjainsj,4,0.00026,365516,23.41435,1561077
9734,smola,4,0.00026,365520,23.41460,1561077
9735,smstone,4,0.00026,365524,23.41486,1561077
9736,snayler0,4,0.00026,365528,23.41512,1561077
9737,snitin315,4,0.00026,365532,23.41537,1561077
9738,snowman78,4,0.00026,365536,23.41563,1561077
9739,sofat1989,4,0.00026,365540,23.41589,1561077
9740,SofteqDG,4,0.00026,365544,23.41614,1561077
9741,SohamJ,4,0.00026,365548,23.41640,1561077
9742,solganik,4,0.00026,365552,23.41665,1561077
9743,sona1111,4,0.00026,365556,23.41691,1561077
9744,sonic4x,4,0.00026,365560,23.41717,1561077
9745,soufianez75,4,0.00026,365564,23.41742,1561077
9746,sp1r,4,0.00026,365568,23.41768,1561077
9747,spariev,4,0.00026,365572,23.41794,1561077
9748,sparkacus,4,0.00026,365576,23.41819,1561077
9749,speedythesnail,4,0.00026,365580,23.41845,1561077
9750,Spellchaser,4,0.00026,365584,23.41870,1561077
9751,spheromak,4,0.00026,365588,23.41896,1561077
9752,spiritman1990,4,0.00026,365592,23.41922,1561077
9753,spirius,4,0.00026,365596,23.41947,1561077
9754,spnchian,4,0.00026,365600,23.41973,1561077
9755,spolspol,4,0.00026,365604,23.41999,1561077
9756,spudfkc,4,0.00026,365608,23.42024,1561077
9757,srajappa,4,0.00026,365612,23.42050,1561077
9758,sramekmichal,4,0.00026,365616,23.42075,1561077
9759,srevinsaju,4,0.00026,365620,23.42101,1561077
9760,sridharvellingiri,4,0.00026,365624,23.42127,1561077
9761,srinivas-vangari,4,0.00026,365628,23.42152,1561077
9762,ssakhuja57,4,0.00026,365632,23.42178,1561077
9763,ssallmen,4,0.00026,365636,23.42203,1561077
9764,ssangaiah,4,0.00026,365640,23.42229,1561077
9765,sschleemilch,4,0.00026,365644,23.42255,1561077
9766,sschoetz,4,0.00026,365648,23.42280,1561077
9767,ssnorrizaurous,4,0.00026,365652,23.42306,1561077
9768,ssotangk,4,0.00026,365656,23.42332,1561077
9769,sstrato,4,0.00026,365660,23.42357,1561077
9770,staffan-einarsson,4,0.00026,365664,23.42383,1561077
9771,stanleywym,4,0.00026,365668,23.42408,1561077
9772,Stark-X,4,0.00026,365672,23.42434,1561077
9773,startx-lab,4,0.00026,365676,23.42460,1561077
9774,stawii,4,0.00026,365680,23.42485,1561077
9775,staylorx,4,0.00026,365684,23.42511,1561077
9776,stefancrain,4,0.00026,365688,23.42537,1561077
9777,stefan-dimitrov,4,0.00026,365692,23.42562,1561077
9778,stemurray,4,0.00026,365696,23.42588,1561077
9779,stephan48,4,0.00026,365700,23.42613,1561077
9780,stephaniemartin7,4,0.00026,365704,23.42639,1561077
9781,stephendonner,4,0.00026,365708,23.42665,1561077
9782,SteveEasley,4,0.00026,365712,23.42690,1561077
9783,stevemyers,4,0.00026,365716,23.42716,1561077
9784,steveonjava,4,0.00026,365720,23.42742,1561077
9785,stewartbryson,4,0.00026,365724,23.42767,1561077
9786,sthenault,4,0.00026,365728,23.42793,1561077
9787,Sti2nd,4,0.00026,365732,23.42818,1561077
9788,stickycode,4,0.00026,365736,23.42844,1561077
9789,StjerneIdioten,4,0.00026,365740,23.42870,1561077
9790,storyicon,4,0.00026,365744,23.42895,1561077
9791,stregatto,4,0.00026,365748,23.42921,1561077
9792,strobeti,4,0.00026,365752,23.42947,1561077
9793,stsukrov,4,0.00026,365756,23.42972,1561077
9794,stuartmallan,4,0.00026,365760,23.42998,1561077
9795,sturivny,4,0.00026,365764,23.43023,1561077
9796,sudheerkb,4,0.00026,365768,23.43049,1561077
9797,sugardon,4,0.00026,365772,23.43075,1561077
9798,sujithmathew93,4,0.00026,365776,23.43100,1561077
9799,sundeer,4,0.00026,365780,23.43126,1561077
9800,sungam3r,4,0.00026,365784,23.43152,1561077
9801,sunilkps,4,0.00026,365788,23.43177,1561077
9802,sunnyqeen,4,0.00026,365792,23.43203,1561077
9803,superflav,4,0.00026,365796,23.43228,1561077
9804,SupergiantAndrew,4,0.00026,365800,23.43254,1561077
9805,Sushrut1101,4,0.00026,365804,23.43280,1561077
9806,sven-carstens-udg,4,0.00026,365808,23.43305,1561077
9807,svisagan83,4,0.00026,365812,23.43331,1561077
9808,swallez,4,0.00026,365816,23.43357,1561077
9809,Sweta271097,4,0.00026,365820,23.43382,1561077
9810,swiss-chris,4,0.00026,365824,23.43408,1561077
9811,systembell,4,0.00026,365828,23.43433,1561077
9812,szymon3,4,0.00026,365832,23.43459,1561077
9813,t0rb3n,4,0.00026,365836,23.43485,1561077
9814,T45K,4,0.00026,365840,23.43510,1561077
9815,Tahvok,4,0.00026,365844,23.43536,1561077
9816,TalAntR,4,0.00026,365848,23.43562,1561077
9817,talcloudshare,4,0.00026,365852,23.43587,1561077
9818,TalEliyahu,4,0.00026,365856,23.43613,1561077
9819,taneishamitchell,4,0.00026,365860,23.43638,1561077
9820,tanya-sy,4,0.00026,365864,23.43664,1561077
9821,taraszka,4,0.00026,365868,23.43690,1561077
9822,tarikly,4,0.00026,365872,23.43715,1561077
9823,tasssko,4,0.00026,365876,23.43741,1561077
9824,Tazer,4,0.00026,365880,23.43767,1561077
9825,tbeu,4,0.00026,365884,23.43792,1561077
9826,tcoupin,4,0.00026,365888,23.43818,1561077
9827,tdawson,4,0.00026,365892,23.43843,1561077
9828,testark,4,0.00026,365896,23.43869,1561077
9829,tfink-cc,4,0.00026,365900,23.43895,1561077
9830,tfnico,4,0.00026,365904,23.43920,1561077
9831,TG9541,4,0.00026,365908,23.43946,1561077
9832,th3w4y,4,0.00026,365912,23.43972,1561077
9833,theCrius,4,0.00026,365916,23.43997,1561077
9834,theobisproject,4,0.00026,365920,23.44023,1561077
9835,theotonne,4,0.00026,365924,23.44048,1561077
9836,theRemix,4,0.00026,365928,23.44074,1561077
9837,TheRhino04,4,0.00026,365932,23.44100,1561077
9838,TheSkorm,4,0.00026,365936,23.44125,1561077
9839,theweblab-gr,4,0.00026,365940,23.44151,1561077
9840,thewolfwillcome,4,0.00026,365944,23.44176,1561077
9841,thiagosanches,4,0.00026,365948,23.44202,1561077
9842,Thihup,4,0.00026,365952,23.44228,1561077
9843,Thogor,4,0.00026,365956,23.44253,1561077
9844,thomasbromehead,4,0.00026,365960,23.44279,1561077
9845,Thomas-Clark,4,0.00026,365964,23.44305,1561077
9846,thomas-eaa,4,0.00026,365968,23.44330,1561077
9847,thomaseizinger,4,0.00026,365972,23.44356,1561077
9848,ThomasGP,4,0.00026,365976,23.44381,1561077
9849,thomas-oo,4,0.00026,365980,23.44407,1561077
9850,thomasporez-tinyclues,4,0.00026,365984,23.44433,1561077
9851,ThomasReinhardt,4,0.00026,365988,23.44458,1561077
9852,thomassun,4,0.00026,365992,23.44484,1561077
9853,ThomGeG,4,0.00026,365996,23.44510,1561077
9854,thomsn,4,0.00026,366000,23.44535,1561077
9855,thpham,4,0.00026,366004,23.44561,1561077
9856,tianlai,4,0.00026,366008,23.44586,1561077
9857,Tibor17,4,0.00026,366012,23.44612,1561077
9858,Ticketedmoon,4,0.00026,366016,23.44638,1561077
9859,tidowu,4,0.00026,366020,23.44663,1561077
9860,tiffanyfb,4,0.00026,366024,23.44689,1561077
9861,tilted,4,0.00026,366028,23.44715,1561077
9862,timmccormick,4,0.00026,366032,23.44740,1561077
9863,timols,4,0.00026,366036,23.44766,1561077
9864,timpillsbury,4,0.00026,366040,23.44791,1561077
9865,timscottbell,4,0.00026,366044,23.44817,1561077
9866,Tingles,4,0.00026,366048,23.44843,1561077
9867,tisaiful31,4,0.00026,366052,23.44868,1561077
9868,tishadosh,4,0.00026,366056,23.44894,1561077
9869,tisluk,4,0.00026,366060,23.44920,1561077
9870,Tivorak,4,0.00026,366064,23.44945,1561077
9871,tjmoore,4,0.00026,366068,23.44971,1561077
9872,tjokimie,4,0.00026,366072,23.44996,1561077
9873,tjololo,4,0.00026,366076,23.45022,1561077
9874,tkruse,4,0.00026,366080,23.45048,1561077
9875,tlnd-mtallet,4,0.00026,366084,23.45073,1561077
9876,tnaroska,4,0.00026,366088,23.45099,1561077
9877,tnucera,4,0.00026,366092,23.45125,1561077
9878,Tobrek,4,0.00026,366096,23.45150,1561077
9879,tokou,4,0.00026,366100,23.45176,1561077
9880,TomaisLeannan,4,0.00026,366104,23.45201,1561077
9881,tomaszbar-deviniti,4,0.00026,366108,23.45227,1561077
9882,tomaszpiekarczyk-saucelabs,4,0.00026,366112,23.45253,1561077
9883,tombradshaw2001,4,0.00026,366116,23.45278,1561077
9884,tomcart90,4,0.00026,366120,23.45304,1561077
9885,TomHart,4,0.00026,366124,23.45330,1561077
9886,Tomino2112,4,0.00026,366128,23.45355,1561077
9887,tommy-bo,4,0.00026,366132,23.45381,1561077
9888,ToninZhao,4,0.00026,366136,23.45406,1561077
9889,tonyfinn,4,0.00026,366140,23.45432,1561077
9890,TonyMcTony,4,0.00026,366144,23.45458,1561077
9891,tonymctonyo,4,0.00026,366148,23.45483,1561077
9892,topine,4,0.00026,366152,23.45509,1561077
9893,tothegills,4,0.00026,366156,23.45535,1561077
9894,tptak,4,0.00026,366160,23.45560,1561077
9895,tracom1,4,0.00026,366164,23.45586,1561077
9896,trashytop,4,0.00026,366168,23.45611,1561077
9897,trevjonez,4,0.00026,366172,23.45637,1561077
9898,trevrosen,4,0.00026,366176,23.45663,1561077
9899,trick77,4,0.00026,366180,23.45688,1561077
9900,TriPhoenix,4,0.00026,366184,23.45714,1561077
9901,Triple-Z,4,0.00026,366188,23.45740,1561077
9902,troizky,4,0.00026,366192,23.45765,1561077
9903,troy256,4,0.00026,366196,23.45791,1561077
9904,troy-jacobson,4,0.00026,366200,23.45816,1561077
9905,Trozz,4,0.00026,366204,23.45842,1561077
9906,tst-nstires,4,0.00026,366208,23.45868,1561077
9907,tswanson-cs,4,0.00026,366212,23.45893,1561077
9908,tucstwo,4,0.00026,366216,23.45919,1561077
9909,tvanhill,4,0.00026,366220,23.45944,1561077
9910,twildber,4,0.00026,366224,23.45970,1561077
9911,twilde,4,0.00026,366228,23.45996,1561077
9912,twillouer,4,0.00026,366232,23.46021,1561077
9913,tyge68,4,0.00026,366236,23.46047,1561077
9914,tzaeru,4,0.00026,366240,23.46073,1561077
9915,Ubermensch01,4,0.00026,366244,23.46098,1561077
9916,uevilwizard,4,0.00026,366248,23.46124,1561077
9917,ukulekek,4,0.00026,366252,23.46149,1561077
9918,ulich,4,0.00026,366256,23.46175,1561077
9919,Unpublished,4,0.00026,366260,23.46201,1561077
9920,uowiec,4,0.00026,366264,23.46226,1561077
9921,Urban123,4,0.00026,366268,23.46252,1561077
9922,uriinf,4,0.00026,366272,23.46278,1561077
9923,urkon,4,0.00026,366276,23.46303,1561077
9924,v3se,4,0.00026,366280,23.46329,1561077
9925,Vaccano,4,0.00026,366284,23.46354,1561077
9926,ValHaris,4,0.00026,366288,23.46380,1561077
9927,Valtaroth,4,0.00026,366292,23.46406,1561077
9928,valtterilehtinen,4,0.00026,366296,23.46431,1561077
9929,valVk,4,0.00026,366300,23.46457,1561077
9930,valyukov,4,0.00026,366304,23.46483,1561077
9931,VanRoy,4,0.00026,366308,23.46508,1561077
9932,vctgross,4,0.00026,366312,23.46534,1561077
9933,vedarthk,4,0.00026,366316,23.46559,1561077
9934,vedev2021,4,0.00026,366320,23.46585,1561077
9935,velma,4,0.00026,366324,23.46611,1561077
9936,venkateshilango7,4,0.00026,366328,23.46636,1561077
9937,venksel,4,0.00026,366332,23.46662,1561077
9938,ventojna,4,0.00026,366336,23.46688,1561077
9939,Venusbee,4,0.00026,366340,23.46713,1561077
9940,vickycool91,4,0.00026,366344,23.46739,1561077
9941,vighneshpai-yml,4,0.00026,366348,23.46764,1561077
9942,vignesh5225,4,0.00026,366352,23.46790,1561077
9943,vijaytripathi,4,0.00026,366356,23.46816,1561077
9944,vikas981,4,0.00026,366360,23.46841,1561077
9945,vikrant82,4,0.00026,366364,23.46867,1561077
9946,vinay-prasad,4,0.00026,366368,23.46893,1561077
9947,vince166,4,0.00026,366372,23.46918,1561077
9948,VinceBT,4,0.00026,366376,23.46944,1561077
9949,vineus,4,0.00026,366380,23.46969,1561077
9950,violetaGitHub,4,0.00026,366384,23.46995,1561077
9951,violetastegaru,4,0.00026,366388,23.47021,1561077
9952,vipulmadaan,4,0.00026,366392,23.47046,1561077
9953,vishnoisuresh,4,0.00026,366396,23.47072,1561077
9954,vivekj11,4,0.00026,366400,23.47098,1561077
9955,vivienneChen,4,0.00026,366404,23.47123,1561077
9956,vladdoster,4,0.00026,366408,23.47149,1561077
9957,vladfr,4,0.00026,366412,23.47174,1561077
9958,vladislav-sharapov,4,0.00026,366416,23.47200,1561077
9959,vladislavzl,4,0.00026,366420,23.47226,1561077
9960,Void9711,4,0.00026,366424,23.47251,1561077
9961,vojtechmasa,4,0.00026,366428,23.47277,1561077
9962,VolodymyrFesenko,4,0.00026,366432,23.47303,1561077
9963,vpal,4,0.00026,366436,23.47328,1561077
9964,vpandi,4,0.00026,366440,23.47354,1561077
9965,vpoptani,4,0.00026,366444,23.47379,1561077
9966,vredda,4,0.00026,366448,23.47405,1561077
9967,vtsykun,4,0.00026,366452,23.47431,1561077
9968,vvchistiakov,4,0.00026,366456,23.47456,1561077
9969,vweng,4,0.00026,366460,23.47482,1561077
9970,waguerin,4,0.00026,366464,23.47508,1561077
9971,wajid-poernomo,4,0.00026,366468,23.47533,1561077
9972,wanderer163,4,0.00026,366472,23.47559,1561077
9973,WaniMukesh,4,0.00026,366476,23.47584,1561077
9974,warren5236,4,0.00026,366480,23.47610,1561077
9975,waytoharish,4,0.00026,366484,23.47636,1561077
9976,wbagdon,4,0.00026,366488,23.47661,1561077
9977,wckhg89,4,0.00026,366492,23.47687,1561077
9978,wdougoveto,4,0.00026,366496,23.47713,1561077
9979,weaversam8,4,0.00026,366500,23.47738,1561077
9980,webzakimbo,4,0.00026,366504,23.47764,1561077
9981,wenwen12341234,4,0.00026,366508,23.47789,1561077
9982,wesley-c42,4,0.00026,366512,23.47815,1561077
9983,WesleyWeber,4,0.00026,366516,23.47841,1561077
9984,wg21908,4,0.00026,366520,23.47866,1561077
9985,wgoyer,4,0.00026,366524,23.47892,1561077
9986,wickedjester,4,0.00026,366528,23.47917,1561077
9987,widdix123,4,0.00026,366532,23.47943,1561077
9988,widgetii,4,0.00026,366536,23.47969,1561077
9989,wiemerc,4,0.00026,366540,23.47994,1561077
9990,Wigder,4,0.00026,366544,23.48020,1561077
9991,willfaught,4,0.00026,366548,23.48046,1561077
9992,WilliamChen-luckbob,4,0.00026,366552,23.48071,1561077
9993,williamxinranZhang,4,0.00026,366556,23.48097,1561077
9994,willisc7,4,0.00026,366560,23.48122,1561077
9995,wimdeblauwe,4,0.00026,366564,23.48148,1561077
9996,windy,4,0.00026,366568,23.48174,1561077
9997,wiquan,4,0.00026,366572,23.48199,1561077
9998,Wohra,4,0.00026,366576,23.48225,1561077
9999,wojciechk,4,0.00026,366580,23.48251,1561077
10000,wolfg1969,4,0.00026,366584,23.48276,1561077
10001,wolfson109,4,0.00026,366588,23.48302,1561077
10002,wolstena,4,0.00026,366592,23.48327,1561077
10003,workman-Lu,4,0.00026,366596,23.48353,1561077
10004,WorldVM,4,0.00026,366600,23.48379,1561077
10005,wozman,4,0.00026,366604,23.48404,1561077
10006,wq911206,4,0.00026,366608,23.48430,1561077
10007,wschiang,4,0.00026,366612,23.48456,1561077
10008,wtnbjn,4,0.00026,366616,23.48481,1561077
10009,wuchenwang,4,0.00026,366620,23.48507,1561077
10010,wudc,4,0.00026,366624,23.48532,1561077
10011,wwade,4,0.00026,366628,23.48558,1561077
10012,wwalasekperform,4,0.00026,366632,23.48584,1561077
10013,wzlee,4,0.00026,366636,23.48609,1561077
10014,xeniorac,4,0.00026,366640,23.48635,1561077
10015,Xenoamor,4,0.00026,366644,23.48661,1561077
10016,xMate420x,4,0.00026,366648,23.48686,1561077
10017,xomiamoore,4,0.00026,366652,23.48712,1561077
10018,xoonz,4,0.00026,366656,23.48737,1561077
10019,xuliugen,4,0.00026,366660,23.48763,1561077
10020,xuwei1119,4,0.00026,366664,23.48789,1561077
10021,xwing7,4,0.00026,366668,23.48814,1561077
10022,xxmaestroxx,4,0.00026,366672,23.48840,1561077
10023,xykong,4,0.00026,366676,23.48866,1561077
10024,xyloman,4,0.00026,366680,23.48891,1561077
10025,Yasumoto,4,0.00026,366684,23.48917,1561077
10026,yasu-s,4,0.00026,366688,23.48942,1561077
10027,yejiayu,4,0.00026,366692,23.48968,1561077
10028,YesemKebede,4,0.00026,366696,23.48994,1561077
10029,yileye,4,0.00026,366700,23.49019,1561077
10030,y-luis,4,0.00026,366704,23.49045,1561077
10031,yrathams1990,4,0.00026,366708,23.49071,1561077
10032,ystradmann,4,0.00026,366712,23.49096,1561077
10033,yubo56,4,0.00026,366716,23.49122,1561077
10034,YuriIvanov,4,0.00026,366720,23.49147,1561077
10035,yuyan-seik,4,0.00026,366724,23.49173,1561077
10036,yx135790,4,0.00026,366728,23.49199,1561077
10037,zaghdoun,4,0.00026,366732,23.49224,1561077
10038,zajacmp3,4,0.00026,366736,23.49250,1561077
10039,zavale,4,0.00026,366740,23.49276,1561077
10040,zepag,4,0.00026,366744,23.49301,1561077
10041,zeue,4,0.00026,366748,23.49327,1561077
10042,zgorizzo69,4,0.00026,366752,23.49352,1561077
10043,zhihaining,4,0.00026,366756,23.49378,1561077
10044,zhouzhengde,4,0.00026,366760,23.49404,1561077
10045,zhujunling-nj,4,0.00026,366764,23.49429,1561077
10046,zieka,4,0.00026,366768,23.49455,1561077
10047,Zitrax,4,0.00026,366772,23.49481,1561077
10048,zivry,4,0.00026,366776,23.49506,1561077
10049,zkendall,4,0.00026,366780,23.49532,1561077
10050,ZloAlien,4,0.00026,366784,23.49557,1561077
10051,znorris,4,0.00026,366788,23.49583,1561077
10052,zohrenweiss,4,0.00026,366792,23.49609,1561077
10053,zottinor,4,0.00026,366796,23.49634,1561077
10054,zpinter,4,0.00026,366800,23.49660,1561077
10055,zuBux,4,0.00026,366804,23.49686,1561077
10056,zwl231,4,0.00026,366808,23.49711,1561077
10057,zylpsrs,4,0.00026,366812,23.49737,1561077
10058,Zyndric,4,0.00026,366816,23.49762,1561077
10059,zzhzero,4,0.00026,366820,23.49788,1561077
10060,zzuwangfeng,4,0.00026,366824,23.49814,1561077
10061,00bins,3,0.00019,366827,23.49833,1561077
10062,0x7f,3,0.00019,366830,23.49852,1561077
10063,0xClpz,3,0.00019,366833,23.49871,1561077
10064,141984,3,0.00019,366836,23.49890,1561077
10065,1508zb,3,0.00019,366839,23.49910,1561077
10066,2002wmj,3,0.00019,366842,23.49929,1561077
10067,2313060585,3,0.00019,366845,23.49948,1561077
10068,35devnhz,3,0.00019,366848,23.49967,1561077
10069,3onyc,3,0.00019,366851,23.49987,1561077
10070,4311021x,3,0.00019,366854,23.50006,1561077
10071,4nt01ne,3,0.00019,366857,23.50025,1561077
10072,5c077yP,3,0.00019,366860,23.50044,1561077
10073,714273725,3,0.00019,366863,23.50063,1561077
10074,846501252,3,0.00019,366866,23.50083,1561077
10075,97gushan,3,0.00019,366869,23.50102,1561077
10076,a1gemmel,3,0.00019,366872,23.50121,1561077
10077,aadis,3,0.00019,366875,23.50140,1561077
10078,aahung,3,0.00019,366878,23.50160,1561077
10079,aali0730,3,0.00019,366881,23.50179,1561077
10080,aamol,3,0.00019,366884,23.50198,1561077
10081,aaron-harvey,3,0.00019,366887,23.50217,1561077
10082,abangerl,3,0.00019,366890,23.50236,1561077
10083,abdessamadcdg,3,0.00019,366893,23.50256,1561077
10084,abdullahfasih,3,0.00019,366896,23.50275,1561077
10085,abep-c3d,3,0.00019,366899,23.50294,1561077
10086,abhi2v,3,0.00019,366902,23.50313,1561077
10087,abhiCR7,3,0.00019,366905,23.50332,1561077
10088,AbhideepChakravarty,3,0.00019,366908,23.50352,1561077
10089,Abhilash-sandupatla,3,0.00019,366911,23.50371,1561077
10090,abhishek-anand13,3,0.00019,366914,23.50390,1561077
10091,abiwill,3,0.00019,366917,23.50409,1561077
10092,abobwhite,3,0.00019,366920,23.50429,1561077
10093,aboger,3,0.00019,366923,23.50448,1561077
10094,abouchama,3,0.00019,366926,23.50467,1561077
10095,abs2310,3,0.00019,366929,23.50486,1561077
10096,aburnett,3,0.00019,366932,23.50505,1561077
10097,acaprari,3,0.00019,366935,23.50525,1561077
10098,accumulator,3,0.00019,366938,23.50544,1561077
10099,ace13,3,0.00019,366941,23.50563,1561077
10100,AceOfSnakes,3,0.00019,366944,23.50582,1561077
10101,achamayou,3,0.00019,366947,23.50602,1561077
10102,achingbrain,3,0.00019,366950,23.50621,1561077
10103,acmyo,3,0.00019,366953,23.50640,1561077
10104,acouvreur,3,0.00019,366956,23.50659,1561077
10105,ac-rdn,3,0.00019,366959,23.50678,1561077
10106,adamerstelle,3,0.00019,366962,23.50698,1561077
10107,adamkrone,3,0.00019,366965,23.50717,1561077
10108,adamvaughan,3,0.00019,366968,23.50736,1561077
10109,adaphi,3,0.00019,366971,23.50755,1561077
10110,adermorl,3,0.00019,366974,23.50774,1561077
10111,adgantt,3,0.00019,366977,23.50794,1561077
10112,adiesner,3,0.00019,366980,23.50813,1561077
10113,adis-io,3,0.00019,366983,23.50832,1561077
10114,Adnn,3,0.00019,366986,23.50851,1561077
10115,adrianer,3,0.00019,366989,23.50871,1561077
10116,adrianvg,3,0.00019,366992,23.50890,1561077
10117,adrienzieba,3,0.00019,366995,23.50909,1561077
10118,aelsabbahy,3,0.00019,366998,23.50928,1561077
10119,aerodinesh,3,0.00019,367001,23.50947,1561077
10120,afbjorklund,3,0.00019,367004,23.50967,1561077
10121,afk-always,3,0.00019,367007,23.50986,1561077
10122,aflopes,3,0.00019,367010,23.51005,1561077
10123,afspear,3,0.00019,367013,23.51024,1561077
10124,agentmarine,3,0.00019,367016,23.51044,1561077
10125,agentmilindu,3,0.00019,367019,23.51063,1561077
10126,AHancher2022,3,0.00019,367022,23.51082,1561077
10127,ahmaddev313,3,0.00019,367025,23.51101,1561077
10128,ahmed-arbaoui,3,0.00019,367028,23.51120,1561077
10129,ahmetb,3,0.00019,367031,23.51140,1561077
10130,aholyoake-bc,3,0.00019,367034,23.51159,1561077
10131,ahunigel,3,0.00019,367037,23.51178,1561077
10132,aiannucci,3,0.00019,367040,23.51197,1561077
10133,aidenkeating,3,0.00019,367043,23.51216,1561077
10134,aitorpazos,3,0.00019,367046,23.51236,1561077
10135,aivanov-citc,3,0.00019,367049,23.51255,1561077
10136,aixigo-cschreuer,3,0.00019,367052,23.51274,1561077
10137,AiyionPrime,3,0.00019,367055,23.51293,1561077
10138,ajaygautam,3,0.00019,367058,23.51313,1561077
10139,ajeet007,3,0.00019,367061,23.51332,1561077
10140,ajsatix,3,0.00019,367064,23.51351,1561077
10141,ajzaff,3,0.00019,367067,23.51370,1561077
10142,Akash-Jain-GMI,3,0.00019,367070,23.51389,1561077
10143,AkhilJoseph-Valeo,3,0.00019,367073,23.51409,1561077
10144,aknowles,3,0.00019,367076,23.51428,1561077
10145,akrist,3,0.00019,367079,23.51447,1561077
10146,akshaychavan,3,0.00019,367082,23.51466,1561077
10147,alancphilpott,3,0.00019,367085,23.51486,1561077
10148,alasolli,3,0.00019,367088,23.51505,1561077
10149,albertorm95,3,0.00019,367091,23.51524,1561077
10150,albertvipe,3,0.00019,367094,23.51543,1561077
10151,albestia,3,0.00019,367097,23.51562,1561077
10152,aldehoff,3,0.00019,367100,23.51582,1561077
10153,aldobrucale,3,0.00019,367103,23.51601,1561077
10154,aldochristiaan,3,0.00019,367106,23.51620,1561077
10155,aldor007,3,0.00019,367109,23.51639,1561077
10156,AlecKotovichSAM,3,0.00019,367112,23.51659,1561077
10157,alefnode,3,0.00019,367115,23.51678,1561077
10158,AleksandarBorsos,3,0.00019,367118,23.51697,1561077
10159,aleksei-bulgak,3,0.00019,367121,23.51716,1561077
10160,aleks-programmer,3,0.00019,367124,23.51735,1561077
10161,Alenx58,3,0.00019,367127,23.51755,1561077
10162,ALeschinsky,3,0.00019,367130,23.51774,1561077
10163,alexanderLinear,3,0.00019,367133,23.51793,1561077
10164,alexanderm2018,3,0.00019,367136,23.51812,1561077
10165,AlexanderPoleschuk,3,0.00019,367139,23.51831,1561077
10166,alexandersels,3,0.00019,367142,23.51851,1561077
10167,alexander-svendsen,3,0.00019,367145,23.51870,1561077
10168,AlexBravoInostroza01,3,0.00019,367148,23.51889,1561077
10169,alexcojocaru,3,0.00019,367151,23.51908,1561077
10170,alexdowad,3,0.00019,367154,23.51928,1561077
10171,alexfish,3,0.00019,367157,23.51947,1561077
10172,alexisde,3,0.00019,367160,23.51966,1561077
10173,AlexKroeker,3,0.00019,367163,23.51985,1561077
10174,alexm118,3,0.00019,367166,23.52004,1561077
10175,alexmuller,3,0.00019,367169,23.52024,1561077
10176,alexwang19,3,0.00019,367172,23.52043,1561077
10177,Alex-Weatherhead,3,0.00019,367175,23.52062,1561077
10178,alexxxxx,3,0.00019,367178,23.52081,1561077
10179,alfarme,3,0.00019,367181,23.52101,1561077
10180,alfoltran,3,0.00019,367184,23.52120,1561077
10181,alfredolopez-kantox,3,0.00019,367187,23.52139,1561077
10182,alien11689,3,0.00019,367190,23.52158,1561077
10183,alikian,3,0.00019,367193,23.52177,1561077
10184,alineprattiezops,3,0.00019,367196,23.52197,1561077
10185,Alirezaaraby,3,0.00019,367199,23.52216,1561077
10186,alissonrodrigz,3,0.00019,367202,23.52235,1561077
10187,Alloc86,3,0.00019,367205,23.52254,1561077
10188,almeidh,3,0.00019,367208,23.52273,1561077
10189,almorelle,3,0.00019,367211,23.52293,1561077
10190,alnesbit,3,0.00019,367214,23.52312,1561077
10191,alsterg,3,0.00019,367217,23.52331,1561077
10192,altendky,3,0.00019,367220,23.52350,1561077
10193,AlvaroRausell,3,0.00019,367223,23.52370,1561077
10194,amadridlar,3,0.00019,367226,23.52389,1561077
10195,amaembo,3,0.00019,367229,23.52408,1561077
10196,amangrover1,3,0.00019,367232,23.52427,1561077
10197,amanjyot,3,0.00019,367235,23.52446,1561077
10198,amberRrucker,3,0.00019,367238,23.52466,1561077
10199,amckenzie132,3,0.00019,367241,23.52485,1561077
10200,amenick,3,0.00019,367244,23.52504,1561077
10201,amirdamirov,3,0.00019,367247,23.52523,1561077
10202,amitkarpe,3,0.00019,367250,23.52543,1561077
10203,amleszk,3,0.00019,367253,23.52562,1561077
10204,amohapatr,3,0.00019,367256,23.52581,1561077
10205,amoltapase,3,0.00019,367259,23.52600,1561077
10206,amrwc,3,0.00019,367262,23.52619,1561077
10207,amsz,3,0.00019,367265,23.52639,1561077
10208,amzuko,3,0.00019,367268,23.52658,1561077
10209,anandnd,3,0.00019,367271,23.52677,1561077
10210,anandpatil,3,0.00019,367274,23.52696,1561077
10211,AnderwanSAM,3,0.00019,367277,23.52715,1561077
10212,AndHager,3,0.00019,367280,23.52735,1561077
10213,AndraeRay,3,0.00019,367283,23.52754,1561077
10214,AndreGross,3,0.00019,367286,23.52773,1561077
10215,andreih89,3,0.00019,367289,23.52792,1561077
10216,andreijefremov,3,0.00019,367292,23.52812,1561077
10217,andrejusc,3,0.00019,367295,23.52831,1561077
10218,andrew-boutin,3,0.00019,367298,23.52850,1561077
10219,andrewcooke,3,0.00019,367301,23.52869,1561077
10220,AndrewCopeland,3,0.00019,367304,23.52888,1561077
10221,andrewducker,3,0.00019,367307,23.52908,1561077
10222,andrewgoktepe,3,0.00019,367310,23.52927,1561077
10223,andrewhibbert,3,0.00019,367313,23.52946,1561077
10224,andrewspiers,3,0.00019,367316,23.52965,1561077
10225,andrey-carerix,3,0.00019,367319,23.52985,1561077
10226,andreyhsiao,3,0.00019,367322,23.53004,1561077
10227,AndrGrig,3,0.00019,367325,23.53023,1561077
10228,andrii-rymar,3,0.00019,367328,23.53042,1561077
10229,Andy2003,3,0.00019,367331,23.53061,1561077
10230,andycoates,3,0.00019,367334,23.53081,1561077
10231,andygraphite,3,0.00019,367337,23.53100,1561077
10232,andythsu,3,0.00019,367340,23.53119,1561077
10233,AndyUM357,3,0.00019,367343,23.53138,1561077
10234,anees264,3,0.00019,367346,23.53157,1561077
10235,anfurny,3,0.00019,367349,23.53177,1561077
10236,AngelCantugr,3,0.00019,367352,23.53196,1561077
10237,angelherce,3,0.00019,367355,23.53215,1561077
10238,angelichorsey,3,0.00019,367358,23.53234,1561077
10239,angelofdeauth,3,0.00019,367361,23.53254,1561077
10240,angry-tony,3,0.00019,367364,23.53273,1561077
10241,Angus221,3,0.00019,367367,23.53292,1561077
10242,angystardust,3,0.00019,367370,23.53311,1561077
10243,anh1979,3,0.00019,367373,23.53330,1561077
10244,anigetsin,3,0.00019,367376,23.53350,1561077
10245,anikitchuk,3,0.00019,367379,23.53369,1561077
10246,AnilKumarP003,3,0.00019,367382,23.53388,1561077
10247,anitakrueger,3,0.00019,367385,23.53407,1561077
10248,ankitml,3,0.00019,367388,23.53427,1561077
10249,a-nldisr,3,0.00019,367391,23.53446,1561077
10250,anmolnagpal,3,0.00019,367394,23.53465,1561077
10251,annapoornimoorthy,3,0.00019,367397,23.53484,1561077
10252,anomalizer,3,0.00019,367400,23.53503,1561077
10253,AnonymFx,3,0.00019,367403,23.53523,1561077
10254,anonymousobject,3,0.00019,367406,23.53542,1561077
10255,anoopl,3,0.00019,367409,23.53561,1561077
10256,anorborg,3,0.00019,367412,23.53580,1561077
10257,anotherchrissmith,3,0.00019,367415,23.53599,1561077
10258,anshbansal,3,0.00019,367418,23.53619,1561077
10259,Anshul-Rathour,3,0.00019,367421,23.53638,1561077
10260,anshumangoyal,3,0.00019,367424,23.53657,1561077
10261,an-sush,3,0.00019,367427,23.53676,1561077
10262,anthonyikeda,3,0.00019,367430,23.53696,1561077
10263,anthuwan13,3,0.00019,367433,23.53715,1561077
10264,antinodes,3,0.00019,367436,23.53734,1561077
10265,antoniobustorff,3,0.00019,367439,23.53753,1561077
10266,antonystevens20,3,0.00019,367442,23.53772,1561077
10267,anttipo,3,0.00019,367445,23.53792,1561077
10268,anu-kailash,3,0.00019,367448,23.53811,1561077
10269,anupts,3,0.00019,367451,23.53830,1561077
10270,Anurag26,3,0.00019,367454,23.53849,1561077
10271,aosterkamp,3,0.00019,367457,23.53869,1561077
10272,aowczarek618,3,0.00019,367460,23.53888,1561077
10273,ap0phi5,3,0.00019,367463,23.53907,1561077
10274,apanisile,3,0.00019,367466,23.53926,1561077
10275,apazga,3,0.00019,367469,23.53945,1561077
10276,aphex3k,3,0.00019,367472,23.53965,1561077
10277,apifortress,3,0.00019,367475,23.53984,1561077
10278,apiloqbc,3,0.00019,367478,23.54003,1561077
10279,Apteryx0,3,0.00019,367481,23.54022,1561077
10280,archis99,3,0.00019,367484,23.54041,1561077
10281,ArcticJuggernaut,3,0.00019,367487,23.54061,1561077
10282,arcturus140,3,0.00019,367490,23.54080,1561077
10283,aresares,3,0.00019,367493,23.54099,1561077
10284,Aricg,3,0.00019,367496,23.54118,1561077
10285,arif49,3,0.00019,367499,23.54138,1561077
10286,arikkfir,3,0.00019,367502,23.54157,1561077
10287,arius86,3,0.00019,367505,23.54176,1561077
10288,Ar-Kan,3,0.00019,367508,23.54195,1561077
10289,arkantos1482,3,0.00019,367511,23.54214,1561077
10290,ArKniiD,3,0.00019,367514,23.54234,1561077
10291,armaanPy,3,0.00019,367517,23.54253,1561077
10292,arobase-laurent,3,0.00019,367520,23.54272,1561077
10293,arogge,3,0.00019,367523,23.54291,1561077
10294,aronwk-aaron,3,0.00019,367526,23.54311,1561077
10295,arranubels,3,0.00019,367529,23.54330,1561077
10296,artcyb,3,0.00019,367532,23.54349,1561077
10297,artemzakharov,3,0.00019,367535,23.54368,1561077
10298,arteniioleg,3,0.00019,367538,23.54387,1561077
10299,ArthurVardevanyan,3,0.00019,367541,23.54407,1561077
10300,Artik0,3,0.00019,367544,23.54426,1561077
10301,arturokunder,3,0.00019,367547,23.54445,1561077
10302,aruiz14,3,0.00019,367550,23.54464,1561077
10303,arunp7080,3,0.00019,367553,23.54483,1561077
10304,arunrajkumar235,3,0.00019,367556,23.54503,1561077
10305,aryaman02,3,0.00019,367559,23.54522,1561077
10306,arymkus,3,0.00019,367562,23.54541,1561077
10307,aschepp,3,0.00019,367565,23.54560,1561077
10308,aschet,3,0.00019,367568,23.54580,1561077
10309,asdfsx,3,0.00019,367571,23.54599,1561077
10310,asergeant01,3,0.00019,367574,23.54618,1561077
10311,Ashera138,3,0.00019,367577,23.54637,1561077
10312,ashishprajapat2,3,0.00019,367580,23.54656,1561077
10313,ashleywolf,3,0.00019,367583,23.54676,1561077
10314,AshwiniChowdavarapu,3,0.00019,367586,23.54695,1561077
10315,asiainfoJiangmy,3,0.00019,367589,23.54714,1561077
10316,Asiya-Yunusa,3,0.00019,367592,23.54733,1561077
10317,asn80,3,0.00019,367595,23.54753,1561077
10318,aspiringDev22,3,0.00019,367598,23.54772,1561077
10319,assembledadam,3,0.00019,367601,23.54791,1561077
10320,astik,3,0.00019,367604,23.54810,1561077
10321,astrahan87,3,0.00019,367607,23.54829,1561077
10322,atdiff,3,0.00019,367610,23.54849,1561077
10323,atgiovannini,3,0.00019,367613,23.54868,1561077
10324,atharvai,3,0.00019,367616,23.54887,1561077
10325,Atihinen,3,0.00019,367619,23.54906,1561077
10326,atileren,3,0.00019,367622,23.54925,1561077
10327,atlaskerr,3,0.00019,367625,23.54945,1561077
10328,atltvri,3,0.00019,367628,23.54964,1561077
10329,atomlab,3,0.00019,367631,23.54983,1561077
10330,atsharp,3,0.00019,367634,23.55002,1561077
10331,attrobit,3,0.00019,367637,23.55022,1561077
10332,atur94,3,0.00019,367640,23.55041,1561077
10333,atwright147,3,0.00019,367643,23.55060,1561077
10334,Atzmon-hentov,3,0.00019,367646,23.55079,1561077
10335,augustocarvalho,3,0.00019,367649,23.55098,1561077
10336,auke-,3,0.00019,367652,23.55118,1561077
10337,aumkarpraja,3,0.00019,367655,23.55137,1561077
10338,Aurel,3,0.00019,367658,23.55156,1561077
10339,austonpramodh,3,0.00019,367661,23.55175,1561077
10340,autero1,3,0.00019,367664,23.55195,1561077
10341,AvalakhGit,3,0.00019,367667,23.55214,1561077
10342,avalery,3,0.00019,367670,23.55233,1561077
10343,avddvd,3,0.00019,367673,23.55252,1561077
10344,Averus89,3,0.00019,367676,23.55271,1561077
10345,AvinashSingh299,3,0.00019,367679,23.55291,1561077
10346,avindra,3,0.00019,367682,23.55310,1561077
10347,avovsya,3,0.00019,367685,23.55329,1561077
10348,awei1001,3,0.00019,367688,23.55348,1561077
10349,aWildElephant,3,0.00019,367691,23.55367,1561077
10350,a-wildman,3,0.00019,367694,23.55387,1561077
10351,awszhen,3,0.00019,367697,23.55406,1561077
10352,axb59,3,0.00019,367700,23.55425,1561077
10353,axelhodler,3,0.00019,367703,23.55444,1561077
10354,aytemuryakup,3,0.00019,367706,23.55464,1561077
10355,ayushri21,3,0.00019,367709,23.55483,1561077
10356,azbpa,3,0.00019,367712,23.55502,1561077
10357,Azhrei251,3,0.00019,367715,23.55521,1561077
10358,azuroff,3,0.00019,367718,23.55540,1561077
10359,azwcl,3,0.00019,367721,23.55560,1561077
10360,babatundebusari,3,0.00019,367724,23.55579,1561077
10361,babbons,3,0.00019,367727,23.55598,1561077
10362,Baccanno,3,0.00019,367730,23.55617,1561077
10363,BackSlasher,3,0.00019,367733,23.55637,1561077
10364,badamb9,3,0.00019,367736,23.55656,1561077
10365,badesiru,3,0.00019,367739,23.55675,1561077
10366,bahui80,3,0.00019,367742,23.55694,1561077
10367,baileyn,3,0.00019,367745,23.55713,1561077
10368,Bakuutin,3,0.00019,367748,23.55733,1561077
10369,balajipothula,3,0.00019,367751,23.55752,1561077
10370,Bamieh,3,0.00019,367754,23.55771,1561077
10371,bangupoc,3,0.00019,367757,23.55790,1561077
10372,bao-lu,3,0.00019,367760,23.55809,1561077
10373,baowei,3,0.00019,367763,23.55829,1561077
10374,Bareliah,3,0.00019,367766,23.55848,1561077
10375,Bargamut,3,0.00019,367769,23.55867,1561077
10376,barneygale,3,0.00019,367772,23.55886,1561077
10377,bartkalanski,3,0.00019,367775,23.55906,1561077
10378,bartoszj,3,0.00019,367778,23.55925,1561077
10379,bastianb,3,0.00019,367781,23.55944,1561077
10380,Bayron8,3,0.00019,367784,23.55963,1561077
10381,bbeck,3,0.00019,367787,23.55982,1561077
10382,bbenz,3,0.00019,367790,23.56002,1561077
10383,bbxfnet,3,0.00019,367793,23.56021,1561077
10384,bbxx111,3,0.00019,367796,23.56040,1561077
10385,Bcouddot,3,0.00019,367799,23.56059,1561077
10386,Bdoom,3,0.00019,367802,23.56079,1561077
10387,beamerblvd,3,0.00019,367805,23.56098,1561077
10388,bearxc,3,0.00019,367808,23.56117,1561077
10389,bednar,3,0.00019,367811,23.56136,1561077
10390,beikov,3,0.00019,367814,23.56155,1561077
10391,bempelise,3,0.00019,367817,23.56175,1561077
10392,BenB196,3,0.00019,367820,23.56194,1561077
10393,BenchmarkingBanana,3,0.00019,367823,23.56213,1561077
10394,BenCoffman,3,0.00019,367826,23.56232,1561077
10395,Benjaminvdv,3,0.00019,367829,23.56251,1561077
10396,bennythejudge,3,0.00019,367832,23.56271,1561077
10397,bensherman,3,0.00019,367835,23.56290,1561077
10398,ben-wangz,3,0.00019,367838,23.56309,1561077
10399,BernalCarlos,3,0.00019,367841,23.56328,1561077
10400,bersace,3,0.00019,367844,23.56348,1561077
10401,bert2002,3,0.00019,367847,23.56367,1561077
10402,berthamilton,3,0.00019,367850,23.56386,1561077
10403,berviantoleo,3,0.00019,367853,23.56405,1561077
10404,beryl-factset,3,0.00019,367856,23.56424,1561077
10405,bfaure,3,0.00019,367859,23.56444,1561077
10406,bgianfo,3,0.00019,367862,23.56463,1561077
10407,bgotink,3,0.00019,367865,23.56482,1561077
10408,bgreeleyquibi,3,0.00019,367868,23.56501,1561077
10409,bhaberle,3,0.00019,367871,23.56521,1561077
10410,bharathcp,3,0.00019,367874,23.56540,1561077
10411,bhaveshgoyal182,3,0.00019,367877,23.56559,1561077
10412,bheiskell-datto,3,0.00019,367880,23.56578,1561077
10413,bhepple,3,0.00019,367883,23.56597,1561077
10414,bhipple,3,0.00019,367886,23.56617,1561077
10415,bhuvan,3,0.00019,367889,23.56636,1561077
10416,BigBadOwl,3,0.00019,367892,23.56655,1561077
10417,bigblondewolf,3,0.00019,367895,23.56674,1561077
10418,bigdavedev,3,0.00019,367898,23.56693,1561077
10419,bigdaz,3,0.00019,367901,23.56713,1561077
10420,binarix,3,0.00019,367904,23.56732,1561077
10421,Bincy1234,3,0.00019,367907,23.56751,1561077
10422,bini-dere,3,0.00019,367910,23.56770,1561077
10423,bionickz,3,0.00019,367913,23.56790,1561077
10424,biozshock,3,0.00019,367916,23.56809,1561077
10425,bitsarvi,3,0.00019,367919,23.56828,1561077
10426,bitwisekaizen,3,0.00019,367922,23.56847,1561077
10427,bjfletcher,3,0.00019,367925,23.56866,1561077
10428,bjfr,3,0.00019,367928,23.56886,1561077
10429,bl4keee,3,0.00019,367931,23.56905,1561077
10430,blacabexg,3,0.00019,367934,23.56924,1561077
10431,blackliner,3,0.00019,367937,23.56943,1561077
10432,bladewheels,3,0.00019,367940,23.56963,1561077
10433,blitz137,3,0.00019,367943,23.56982,1561077
10434,Bloeffy,3,0.00019,367946,23.57001,1561077
10435,b-long,3,0.00019,367949,23.57020,1561077
10436,blongman-snapdocs,3,0.00019,367952,23.57039,1561077
10437,bluepioupiou,3,0.00019,367955,23.57059,1561077
10438,bmanth60,3,0.00019,367958,23.57078,1561077
10439,bmcgair,3,0.00019,367961,23.57097,1561077
10440,bmenaman,3,0.00019,367964,23.57116,1561077
10441,bmhm,3,0.00019,367967,23.57135,1561077
10442,bmleite,3,0.00019,367970,23.57155,1561077
10443,bmoqimi,3,0.00019,367973,23.57174,1561077
10444,bngsudheer,3,0.00019,367976,23.57193,1561077
10445,bnigh,3,0.00019,367979,23.57212,1561077
10446,BNUZ-YLSY,3,0.00019,367982,23.57232,1561077
10447,bobcallaway,3,0.00019,367985,23.57251,1561077
10448,bobclarke,3,0.00019,367988,23.57270,1561077
10449,boblloyd,3,0.00019,367991,23.57289,1561077
10450,bobstiles,3,0.00019,367994,23.57308,1561077
10451,bobthebuilderberlin,3,0.00019,367997,23.57328,1561077
10452,boczh,3,0.00019,368000,23.57347,1561077
10453,bol,3,0.00019,368003,23.57366,1561077
10454,bollenn,3,0.00019,368006,23.57385,1561077
10455,BookOfGreg,3,0.00019,368009,23.57405,1561077
10456,boolafish,3,0.00019,368012,23.57424,1561077
10457,BOOMChiefRocka,3,0.00019,368015,23.57443,1561077
10458,bopoda,3,0.00019,368018,23.57462,1561077
10459,borq79,3,0.00019,368021,23.57481,1561077
10460,borski,3,0.00019,368024,23.57501,1561077
10461,boul3ez,3,0.00019,368027,23.57520,1561077
10462,BowenChan,3,0.00019,368030,23.57539,1561077
10463,boyagao,3,0.00019,368033,23.57558,1561077
10464,bperel,3,0.00019,368036,23.57577,1561077
10465,bpohoriletz,3,0.00019,368039,23.57597,1561077
10466,bradleycherrin,3,0.00019,368042,23.57616,1561077
10467,BradNewton,3,0.00019,368045,23.57635,1561077
10468,bradwin,3,0.00019,368048,23.57654,1561077
10469,bradynpoulsen,3,0.00019,368051,23.57674,1561077
10470,Bram-Zijp,3,0.00019,368054,23.57693,1561077
10471,brandonflittner,3,0.00019,368057,23.57712,1561077
10472,brandon-fryslie,3,0.00019,368060,23.57731,1561077
10473,brandonicon,3,0.00019,368063,23.57750,1561077
10474,brandonroeder,3,0.00019,368066,23.57770,1561077
10475,brandonsturgeon,3,0.00019,368069,23.57789,1561077
10476,brange,3,0.00019,368072,23.57808,1561077
10477,Brenne,3,0.00019,368075,23.57827,1561077
10478,BrentDouglas,3,0.00019,368078,23.57847,1561077
10479,brentsmyth,3,0.00019,368081,23.57866,1561077
10480,brian-anthony,3,0.00019,368084,23.57885,1561077
10481,brianeclow,3,0.00019,368087,23.57904,1561077
10482,brianehlert,3,0.00019,368090,23.57923,1561077
10483,brianespinosa,3,0.00019,368093,23.57943,1561077
10484,brianwyka,3,0.00019,368096,23.57962,1561077
10485,brienjo2,3,0.00019,368099,23.57981,1561077
10486,Brightside56,3,0.00019,368102,23.58000,1561077
10487,brikis98,3,0.00019,368105,23.58019,1561077
10488,brism,3,0.00019,368108,23.58039,1561077
10489,brockers,3,0.00019,368111,23.58058,1561077
10490,brp23,3,0.00019,368114,23.58077,1561077
10491,brucellino,3,0.00019,368117,23.58096,1561077
10492,Brunochris13,3,0.00019,368120,23.58116,1561077
10493,brunoprin,3,0.00019,368123,23.58135,1561077
10494,brunoribeiro,3,0.00019,368126,23.58154,1561077
10495,btk3000,3,0.00019,368129,23.58173,1561077
10496,btobolaski,3,0.00019,368132,23.58192,1561077
10497,btotharye,3,0.00019,368135,23.58212,1561077
10498,btromanova,3,0.00019,368138,23.58231,1561077
10499,bubi1311,3,0.00019,368141,23.58250,1561077
10500,buenjybar,3,0.00019,368144,23.58269,1561077
10501,Buli-0,3,0.00019,368147,23.58289,1561077
10502,burner1024,3,0.00019,368150,23.58308,1561077
10503,busynight,3,0.00019,368153,23.58327,1561077
10504,buulam,3,0.00019,368156,23.58346,1561077
10505,Buzzard44,3,0.00019,368159,23.58365,1561077
10506,bvanosten,3,0.00019,368162,23.58385,1561077
10507,bvcelari,3,0.00019,368165,23.58404,1561077
10508,bvold,3,0.00019,368168,23.58423,1561077
10509,bxliam,3,0.00019,368171,23.58442,1561077
10510,c0ldd,3,0.00019,368174,23.58461,1561077
10511,cageyv,3,0.00019,368177,23.58481,1561077
10512,caikemp,3,0.00019,368180,23.58500,1561077
10513,calebmfreed,3,0.00019,368183,23.58519,1561077
10514,Callumccr,3,0.00019,368186,23.58538,1561077
10515,calphool,3,0.00019,368189,23.58558,1561077
10516,cameronbalahan,3,0.00019,368192,23.58577,1561077
10517,camohub,3,0.00019,368195,23.58596,1561077
10518,camshoff,3,0.00019,368198,23.58615,1561077
10519,camusd,3,0.00019,368201,23.58634,1561077
10520,caozhiyuan,3,0.00019,368204,23.58654,1561077
10521,CAP-3Shape,3,0.00019,368207,23.58673,1561077
10522,caperutxa,3,0.00019,368210,23.58692,1561077
10523,capt2101akash,3,0.00019,368213,23.58711,1561077
10524,captrespect,3,0.00019,368216,23.58731,1561077
10525,carlbray,3,0.00019,368219,23.58750,1561077
10526,cars,3,0.00019,368222,23.58769,1561077
10527,CarstenWickner,3,0.00019,368225,23.58788,1561077
10528,caseycs,3,0.00019,368228,23.58807,1561077
10529,cassidea,3,0.00019,368231,23.58827,1561077
10530,castsoftware-ero,3,0.00019,368234,23.58846,1561077
10531,Cataclysm18,3,0.00019,368237,23.58865,1561077
10532,cataphract,3,0.00019,368240,23.58884,1561077
10533,cavirinppm,3,0.00019,368243,23.58904,1561077
10534,cbirajdar,3,0.00019,368246,23.58923,1561077
10535,cbonami,3,0.00019,368249,23.58942,1561077
10536,cbuckley01,3,0.00019,368252,23.58961,1561077
10537,cchristous,3,0.00019,368255,23.58980,1561077
10538,cchrysostom,3,0.00019,368258,23.59000,1561077
10539,cClaude,3,0.00019,368261,23.59019,1561077
10540,ccrolf,3,0.00019,368264,23.59038,1561077
10541,ccwumao,3,0.00019,368267,23.59057,1561077
10542,cdemeijer,3,0.00019,368270,23.59076,1561077
10543,celluj34,3,0.00019,368273,23.59096,1561077
10544,ceritium,3,0.00019,368276,23.59115,1561077
10545,ceztko,3,0.00019,368279,23.59134,1561077
10546,cfedersp,3,0.00019,368282,23.59153,1561077
10547,cfurst,3,0.00019,368285,23.59173,1561077
10548,cghislai,3,0.00019,368288,23.59192,1561077
10549,chachi,3,0.00019,368291,23.59211,1561077
10550,chad-barensfeld-exa,3,0.00019,368294,23.59230,1561077
10551,chadbercea,3,0.00019,368297,23.59249,1561077
10552,chamoisla,3,0.00019,368300,23.59269,1561077
10553,chantivlad,3,0.00019,368303,23.59288,1561077
10554,CharliePF,3,0.00019,368306,23.59307,1561077
10555,charliepoker,3,0.00019,368309,23.59326,1561077
10556,Charlio99,3,0.00019,368312,23.59346,1561077
10557,chaseconey,3,0.00019,368315,23.59365,1561077
10558,cheethoe,3,0.00019,368318,23.59384,1561077
10559,chehomovns,3,0.00019,368321,23.59403,1561077
10560,chenguangfu,3,0.00019,368324,23.59422,1561077
10561,Chimney42,3,0.00019,368327,23.59442,1561077
10562,chimpytt,3,0.00019,368330,23.59461,1561077
10563,chintanb,3,0.00019,368333,23.59480,1561077
10564,chkp-ivanmar,3,0.00019,368336,23.59499,1561077
10565,chongj615,3,0.00019,368339,23.59518,1561077
10566,chopmann,3,0.00019,368342,23.59538,1561077
10567,choweiyuan,3,0.00019,368345,23.59557,1561077
10568,chq81,3,0.00019,368348,23.59576,1561077
10569,chrahunt,3,0.00019,368351,23.59595,1561077
10570,chrisbeall,3,0.00019,368354,23.59615,1561077
10571,chrisburrell,3,0.00019,368357,23.59634,1561077
10572,chris-cayaba,3,0.00019,368360,23.59653,1561077
10573,ChrisGWarp,3,0.00019,368363,23.59672,1561077
10574,chrisipa,3,0.00019,368366,23.59691,1561077
10575,chriskloe,3,0.00019,368369,23.59711,1561077
10576,ChrisTheShark,3,0.00019,368372,23.59730,1561077
10577,christoe,3,0.00019,368375,23.59749,1561077
10578,christofdamian,3,0.00019,368378,23.59768,1561077
10579,ChristopherHanson,3,0.00019,368381,23.59788,1561077
10580,ChristophGr,3,0.00019,368384,23.59807,1561077
10581,Chronojam,3,0.00019,368387,23.59826,1561077
10582,chroto,3,0.00019,368390,23.59845,1561077
10583,chtourou-youssef,3,0.00019,368393,23.59864,1561077
10584,chukkalapradeep,3,0.00019,368396,23.59884,1561077
10585,chunmeiwu2018,3,0.00019,368399,23.59903,1561077
10586,Chupaka,3,0.00019,368402,23.59922,1561077
10587,chy168,3,0.00019,368405,23.59941,1561077
10588,CiliaFred,3,0.00019,368408,23.59960,1561077
10589,cincodenada,3,0.00019,368411,23.59980,1561077
10590,cinemacloudapp,3,0.00019,368414,23.59999,1561077
10591,CineTek,3,0.00019,368417,23.60018,1561077
10592,CJCShadowsan,3,0.00019,368420,23.60037,1561077
10593,ckipp01,3,0.00019,368423,23.60057,1561077
10594,ckolderup,3,0.00019,368426,23.60076,1561077
10595,cl1ent,3,0.00019,368429,23.60095,1561077
10596,claco,3,0.00019,368432,23.60114,1561077
10597,clatko,3,0.00019,368435,23.60133,1561077
10598,clayg,3,0.00019,368438,23.60153,1561077
10599,clayreimann,3,0.00019,368441,23.60172,1561077
10600,clementckw,3,0.00019,368444,23.60191,1561077
10601,cleverkidd,3,0.00019,368447,23.60210,1561077
10602,clifff,3,0.00019,368450,23.60230,1561077
10603,CliffFoster,3,0.00019,368453,23.60249,1561077
10604,clivecrous,3,0.00019,368456,23.60268,1561077
10605,CliveJL,3,0.00019,368459,23.60287,1561077
10606,clklachu,3,0.00019,368462,23.60306,1561077
10607,cllunsford,3,0.00019,368465,23.60326,1561077
10608,CloudGrimm,3,0.00019,368468,23.60345,1561077
10609,ClundXIII,3,0.00019,368471,23.60364,1561077
10610,cod3min3,3,0.00019,368474,23.60383,1561077
10611,codemercenary,3,0.00019,368477,23.60402,1561077
10612,coder451,3,0.00019,368480,23.60422,1561077
10613,codersofthedark,3,0.00019,368483,23.60441,1561077
10614,codertux,3,0.00019,368486,23.60460,1561077
10615,coleduclos,3,0.00019,368489,23.60479,1561077
10616,colfredstan,3,0.00019,368492,23.60499,1561077
10617,Colin1860,3,0.00019,368495,23.60518,1561077
10618,ColineLelong,3,0.00019,368498,23.60537,1561077
10619,colin-lee,3,0.00019,368501,23.60556,1561077
10620,colinlee81,3,0.00019,368504,23.60575,1561077
10621,comjf,3,0.00019,368507,23.60595,1561077
10622,comptonqc,3,0.00019,368510,23.60614,1561077
10623,conordean,3,0.00019,368513,23.60633,1561077
10624,conorjduggan,3,0.00019,368516,23.60652,1561077
10625,consokodev,3,0.00019,368519,23.60672,1561077
10626,consueloel,3,0.00019,368522,23.60691,1561077
10627,cookingcodewithme,3,0.00019,368525,23.60710,1561077
10628,cooniur,3,0.00019,368528,23.60729,1561077
10629,copartdevops,3,0.00019,368531,23.60748,1561077
10630,copperlight,3,0.00019,368534,23.60768,1561077
10631,core23,3,0.00019,368537,23.60787,1561077
10632,corneredrat,3,0.00019,368540,23.60806,1561077
10633,Costallat,3,0.00019,368543,23.60825,1561077
10634,coxalass,3,0.00019,368546,23.60844,1561077
10635,cprato79,3,0.00019,368549,23.60864,1561077
10636,CptanPanic,3,0.00019,368552,23.60883,1561077
10637,CptDaniel,3,0.00019,368555,23.60902,1561077
10638,cquinn,3,0.00019,368558,23.60921,1561077
10639,craft-de-jet,3,0.00019,368561,23.60941,1561077
10640,craig65535,3,0.00019,368564,23.60960,1561077
10641,Crayon2000,3,0.00019,368567,23.60979,1561077
10642,CrazyGiraffe,3,0.00019,368570,23.60998,1561077
10643,Crazyigor1987,3,0.00019,368573,23.61017,1561077
10644,crdnb,3,0.00019,368576,23.61037,1561077
10645,cristiandonosoc,3,0.00019,368579,23.61056,1561077
10646,cristinelcalugarita,3,0.00019,368582,23.61075,1561077
10647,CritasWang,3,0.00019,368585,23.61094,1561077
10648,crossan007,3,0.00019,368588,23.61114,1561077
10649,croydondias,3,0.00019,368591,23.61133,1561077
10650,Crucient,3,0.00019,368594,23.61152,1561077
10651,CSachin,3,0.00019,368597,23.61171,1561077
10652,csauvain,3,0.00019,368600,23.61190,1561077
10653,cschwarz-inco,3,0.00019,368603,23.61210,1561077
10654,ctoestreich,3,0.00019,368606,23.61229,1561077
10655,cuhavp,3,0.00019,368609,23.61248,1561077
10656,curiouspratik,3,0.00019,368612,23.61267,1561077
10657,curtisgcarroll,3,0.00019,368615,23.61286,1561077
10658,cvanballegooijen,3,0.00019,368618,23.61306,1561077
10659,cvarjao,3,0.00019,368621,23.61325,1561077
10660,cw-shubham,3,0.00019,368624,23.61344,1561077
10661,cxGIT1,3,0.00019,368627,23.61363,1561077
10662,cybaj,3,0.00019,368630,23.61383,1561077
10663,cybereason-deployments,3,0.00019,368633,23.61402,1561077
10664,cyberguard,3,0.00019,368636,23.61421,1561077
10665,cyberjoac,3,0.00019,368639,23.61440,1561077
10666,cyclopentan,3,0.00019,368642,23.61459,1561077
10667,cyrilleTixierLefebreDalloz,3,0.00019,368645,23.61479,1561077
10668,cyrus-mc,3,0.00019,368648,23.61498,1561077
10669,cythrawll,3,0.00019,368651,23.61517,1561077
10670,d3xt3r01,3,0.00019,368654,23.61536,1561077
10671,d4rky-pl,3,0.00019,368657,23.61556,1561077
10672,dafelipe130,3,0.00019,368660,23.61575,1561077
10673,daganibhanu,3,0.00019,368663,23.61594,1561077
10674,daijithegeek,3,0.00019,368666,23.61613,1561077
10675,dakuhlman,3,0.00019,368669,23.61632,1561077
10676,dalcouffe,3,0.00019,368672,23.61652,1561077
10677,damjanko,3,0.00019,368675,23.61671,1561077
10678,dancruciat,3,0.00019,368678,23.61690,1561077
10679,Dan-Dongcheol-Lee,3,0.00019,368681,23.61709,1561077
10680,DaNeubi,3,0.00019,368684,23.61728,1561077
10681,Danh4,3,0.00019,368687,23.61748,1561077
10682,DanielBFox,3,0.00019,368690,23.61767,1561077
10683,daniel-huss,3,0.00019,368693,23.61786,1561077
10684,danielkucera,3,0.00019,368696,23.61805,1561077
10685,DanielYWoo,3,0.00019,368699,23.61825,1561077
10686,danifernandezs,3,0.00019,368702,23.61844,1561077
10687,danilaml,3,0.00019,368705,23.61863,1561077
10688,danillosl,3,0.00019,368708,23.61882,1561077
10689,daniloformiga,3,0.00019,368711,23.61901,1561077
10690,danimorelo,3,0.00019,368714,23.61921,1561077
10691,danjesus,3,0.00019,368717,23.61940,1561077
10692,dankraemer,3,0.00019,368720,23.61959,1561077
10693,danmanners,3,0.00019,368723,23.61978,1561077
10694,dannygoulder,3,0.00019,368726,23.61998,1561077
10695,danparisd,3,0.00019,368729,23.62017,1561077
10696,danrobinson21,3,0.00019,368732,23.62036,1561077
10697,dansimau,3,0.00019,368735,23.62055,1561077
10698,dansiviter,3,0.00019,368738,23.62074,1561077
10699,danudey,3,0.00019,368741,23.62094,1561077
10700,daparthi001,3,0.00019,368744,23.62113,1561077
10701,daphnemcrossbrowser,3,0.00019,368747,23.62132,1561077
10702,darabi,3,0.00019,368750,23.62151,1561077
10703,darashenka,3,0.00019,368753,23.62170,1561077
10704,darioatbashton,3,0.00019,368756,23.62190,1561077
10705,darkedges,3,0.00019,368759,23.62209,1561077
10706,Darknesskight,3,0.00019,368762,23.62228,1561077
10707,darkpeak,3,0.00019,368765,23.62247,1561077
10708,darshanshah,3,0.00019,368768,23.62267,1561077
10709,dashfwd,3,0.00019,368771,23.62286,1561077
10710,davehouser1,3,0.00019,368774,23.62305,1561077
10711,daveseff,3,0.00019,368777,23.62324,1561077
10712,DavidA2014,3,0.00019,368780,23.62343,1561077
10713,davidcarboni,3,0.00019,368783,23.62363,1561077
10714,david-ecc,3,0.00019,368786,23.62382,1561077
10715,davidfm,3,0.00019,368789,23.62401,1561077
10716,DavidGervasioAltus,3,0.00019,368792,23.62420,1561077
10717,davidkuster,3,0.00019,368795,23.62440,1561077
10718,davidlarsen-contrast,3,0.00019,368798,23.62459,1561077
10719,davidlinke,3,0.00019,368801,23.62478,1561077
10720,davidmoshal,3,0.00019,368804,23.62497,1561077
10721,DavidRomanovizc,3,0.00019,368807,23.62516,1561077
10722,Davidsasegu,3,0.00019,368810,23.62536,1561077
10723,davidsielert,3,0.00019,368813,23.62555,1561077
10724,DavidTheSysAdmin,3,0.00019,368816,23.62574,1561077
10725,davidtlascelles,3,0.00019,368819,23.62593,1561077
10726,Davis8988,3,0.00019,368822,23.62612,1561077
10727,davorbonaci,3,0.00019,368825,23.62632,1561077
10728,daxpat2000,3,0.00019,368828,23.62651,1561077
10729,daxroc,3,0.00019,368831,23.62670,1561077
10730,daya,3,0.00019,368834,23.62689,1561077
10731,dbaur,3,0.00019,368837,23.62709,1561077
10732,dbradley771,3,0.00019,368840,23.62728,1561077
10733,dbristow,3,0.00019,368843,23.62747,1561077
10734,dbu,3,0.00019,368846,23.62766,1561077
10735,dburm,3,0.00019,368849,23.62785,1561077
10736,dcaba,3,0.00019,368852,23.62805,1561077
10737,dcacenabes,3,0.00019,368855,23.62824,1561077
10738,dcodix,3,0.00019,368858,23.62843,1561077
10739,ddavtian,3,0.00019,368861,23.62862,1561077
10740,ddlfcloud,3,0.00019,368864,23.62882,1561077
10741,ddqd,3,0.00019,368867,23.62901,1561077
10742,ddy4633,3,0.00019,368870,23.62920,1561077
10743,dean36963,3,0.00019,368873,23.62939,1561077
10744,deceneu3,3,0.00019,368876,23.62958,1561077
10745,deege,3,0.00019,368879,23.62978,1561077
10746,DEEJAY29,3,0.00019,368882,23.62997,1561077
10747,deepeeess,3,0.00019,368885,23.63016,1561077
10748,deepforu47,3,0.00019,368888,23.63035,1561077
10749,deeptrixx,3,0.00019,368891,23.63054,1561077
10750,deepu7bn,3,0.00019,368894,23.63074,1561077
10751,DegalaS,3,0.00019,368897,23.63093,1561077
10752,degoltz,3,0.00019,368900,23.63112,1561077
10753,de-jcup,3,0.00019,368903,23.63131,1561077
10754,dejewi,3,0.00019,368906,23.63151,1561077
10755,dejlek,3,0.00019,368909,23.63170,1561077
10756,DeltaLikeM,3,0.00019,368912,23.63189,1561077
10757,denhamcoote,3,0.00019,368915,23.63208,1561077
10758,DenisBY,3,0.00019,368918,23.63227,1561077
10759,DennisRippinger,3,0.00019,368921,23.63247,1561077
10760,DenysLins,3,0.00019,368924,23.63266,1561077
10761,denzs,3,0.00019,368927,23.63285,1561077
10762,deogracia,3,0.00019,368930,23.63304,1561077
10763,deporcali,3,0.00019,368933,23.63324,1561077
10764,derekln1,3,0.00019,368936,23.63343,1561077
10765,Derenge,3,0.00019,368939,23.63362,1561077
10766,derline,3,0.00019,368942,23.63381,1561077
10767,dethi,3,0.00019,368945,23.63400,1561077
10768,devdattakulkarni,3,0.00019,368948,23.63420,1561077
10769,dev-hanz-ops,3,0.00019,368951,23.63439,1561077
10770,devkonarev,3,0.00019,368954,23.63458,1561077
10771,devqore,3,0.00019,368957,23.63477,1561077
10772,deweistarsky,3,0.00019,368960,23.63496,1561077
10773,dexterlakin,3,0.00019,368963,23.63516,1561077
10774,dgilmanTORQATA,3,0.00019,368966,23.63535,1561077
10775,Dgiordano33,3,0.00019,368969,23.63554,1561077
10776,dgrunwald,3,0.00019,368972,23.63573,1561077
10777,dgvigil,3,0.00019,368975,23.63593,1561077
10778,Dhaojie6688,3,0.00019,368978,23.63612,1561077
10779,dheeraj7771,3,0.00019,368981,23.63631,1561077
10780,Dhirendra-kx,3,0.00019,368984,23.63650,1561077
10781,dholsch,3,0.00019,368987,23.63669,1561077
10782,dhrapson,3,0.00019,368990,23.63689,1561077
10783,dialex,3,0.00019,368993,23.63708,1561077
10784,didster,3,0.00019,368996,23.63727,1561077
10785,diegombeltran,3,0.00019,368999,23.63746,1561077
10786,dietrichatadobe,3,0.00019,369002,23.63766,1561077
10787,diewuq,3,0.00019,369005,23.63785,1561077
10788,dil-dbakker,3,0.00019,369008,23.63804,1561077
10789,Dilolokko,3,0.00019,369011,23.63823,1561077
10790,dimdiden,3,0.00019,369014,23.63842,1561077
10791,dimencionrider,3,0.00019,369017,23.63862,1561077
10792,dineshmistry,3,0.00019,369020,23.63881,1561077
10793,Diogo-Costa,3,0.00019,369023,23.63900,1561077
10794,DirkTheDaring,3,0.00019,369026,23.63919,1561077
10795,disguster,3,0.00019,369029,23.63938,1561077
10796,djh82,3,0.00019,369032,23.63958,1561077
10797,djoudi5,3,0.00019,369035,23.63977,1561077
10798,djrichar,3,0.00019,369038,23.63996,1561077
10799,dkinzer,3,0.00019,369041,23.64015,1561077
10800,dlovera,3,0.00019,369044,23.64035,1561077
10801,dlucasd,3,0.00019,369047,23.64054,1561077
10802,dmamidisynopsys,3,0.00019,369050,23.64073,1561077
10803,dmercer1,3,0.00019,369053,23.64092,1561077
10804,dmitrykrupa,3,0.00019,369056,23.64111,1561077
10805,dmitrymikheiev,3,0.00019,369059,23.64131,1561077
10806,dmpratt,3,0.00019,369062,23.64150,1561077
10807,dmrogers7,3,0.00019,369065,23.64169,1561077
10808,dmtumilovich,3,0.00019,369068,23.64188,1561077
10809,dnorrell,3,0.00019,369071,23.64208,1561077
10810,dogloblin,3,0.00019,369074,23.64227,1561077
10811,dogriffiths,3,0.00019,369077,23.64246,1561077
10812,dohoangkhiem,3,0.00019,369080,23.64265,1561077
10813,DominikGebhart,3,0.00019,369083,23.64284,1561077
10814,DOnlyone,3,0.00019,369086,23.64304,1561077
10815,DonnieKim411,3,0.00019,369089,23.64323,1561077
10816,DougSven,3,0.00019,369092,23.64342,1561077
10817,dpricha89,3,0.00019,369095,23.64361,1561077
10818,dra90n,3,0.00019,369098,23.64380,1561077
10819,dragon512,3,0.00019,369101,23.64400,1561077
10820,drahamim,3,0.00019,369104,23.64419,1561077
10821,dreamercz,3,0.00019,369107,23.64438,1561077
10822,dreamrace,3,0.00019,369110,23.64457,1561077
10823,drewish,3,0.00019,369113,23.64477,1561077
10824,drewterry,3,0.00019,369116,23.64496,1561077
10825,DRicciardi,3,0.00019,369119,23.64515,1561077
10826,DriesVerachtert,3,0.00019,369122,23.64534,1561077
10827,drmaniac,3,0.00019,369125,23.64553,1561077
10828,Drupal-Infrastructure,3,0.00019,369128,23.64573,1561077
10829,drwahl,3,0.00019,369131,23.64592,1561077
10830,dsanyika,3,0.00019,369134,23.64611,1561077
10831,DSmedley,3,0.00019,369137,23.64630,1561077
10832,dsmorse,3,0.00019,369140,23.64650,1561077
10833,dtronche,3,0.00019,369143,23.64669,1561077
10834,dtweston,3,0.00019,369146,23.64688,1561077
10835,dumez-k,3,0.00019,369149,23.64707,1561077
10836,dunse,3,0.00019,369152,23.64726,1561077
10837,durgasunil86,3,0.00019,369155,23.64746,1561077
10838,durgeshworks,3,0.00019,369158,23.64765,1561077
10839,DusteDdk,3,0.00019,369161,23.64784,1561077
10840,DustinChaloupka,3,0.00019,369164,23.64803,1561077
10841,duttonw,3,0.00019,369167,23.64822,1561077
10842,dVerhees,3,0.00019,369170,23.64842,1561077
10843,DW-gabriele,3,0.00019,369173,23.64861,1561077
10844,dwt2,3,0.00019,369176,23.64880,1561077
10845,d-zalewski,3,0.00019,369179,23.64899,1561077
10846,dzwarg,3,0.00019,369182,23.64919,1561077
10847,earthgouer,3,0.00019,369185,23.64938,1561077
10848,ebaek,3,0.00019,369188,23.64957,1561077
10849,ebariaux,3,0.00019,369191,23.64976,1561077
10850,EBCEEB,3,0.00019,369194,23.64995,1561077
10851,e-bits,3,0.00019,369197,23.65015,1561077
10852,echatman,3,0.00019,369200,23.65034,1561077
10853,ecsumed,3,0.00019,369203,23.65053,1561077
10854,edbrannin,3,0.00019,369206,23.65072,1561077
10855,eddi-weiss,3,0.00019,369209,23.65092,1561077
10856,edent,3,0.00019,369212,23.65111,1561077
10857,edgardogho,3,0.00019,369215,23.65130,1561077
10858,edgarkz,3,0.00019,369218,23.65149,1561077
10859,edisonh,3,0.00019,369221,23.65168,1561077
10860,EdisonHarada,3,0.00019,369224,23.65188,1561077
10861,edp237,3,0.00019,369227,23.65207,1561077
10862,edugueperouxWeborama,3,0.00019,369230,23.65226,1561077
10863,edwardvfluke,3,0.00019,369233,23.65245,1561077
10864,eeriwan,3,0.00019,369236,23.65264,1561077
10865,efernandes-ANDigital,3,0.00019,369239,23.65284,1561077
10866,egherrmann,3,0.00019,369242,23.65303,1561077
10867,egok,3,0.00019,369245,23.65322,1561077
10868,egor1989,3,0.00019,369248,23.65341,1561077
10869,egoramazon,3,0.00019,369251,23.65361,1561077
10870,egulatee,3,0.00019,369254,23.65380,1561077
10871,egyptiancaesar,3,0.00019,369257,23.65399,1561077
10872,ehsandanesh,3,0.00019,369260,23.65418,1561077
10873,EikeDawid,3,0.00019,369263,23.65437,1561077
10874,eitsch,3,0.00019,369266,23.65457,1561077
10875,e-kmisk,3,0.00019,369269,23.65476,1561077
10876,ElaineRichards,3,0.00019,369272,23.65495,1561077
10877,elarbi,3,0.00019,369275,23.65514,1561077
10878,electricalbah,3,0.00019,369278,23.65534,1561077
10879,elenoir,3,0.00019,369281,23.65553,1561077
10880,elhe,3,0.00019,369284,23.65572,1561077
10881,Elhodred,3,0.00019,369287,23.65591,1561077
10882,eliasbalasis,3,0.00019,369290,23.65610,1561077
10883,EliasNeypes,3,0.00019,369293,23.65630,1561077
10884,eliranshlomo,3,0.00019,369296,23.65649,1561077
10885,elisalter,3,0.00019,369299,23.65668,1561077
10886,elismaga,3,0.00019,369302,23.65687,1561077
10887,eliyosef578,3,0.00019,369305,23.65706,1561077
10888,Elkasitu,3,0.00019,369308,23.65726,1561077
10889,elmuerte,3,0.00019,369311,23.65745,1561077
10890,eloo,3,0.00019,369314,23.65764,1561077
10891,elreydetoda,3,0.00019,369317,23.65783,1561077
10892,eltonlauhk01,3,0.00019,369320,23.65803,1561077
10893,ElvenSpellmaker,3,0.00019,369323,23.65822,1561077
10894,elyezer,3,0.00019,369326,23.65841,1561077
10895,email2smohanty,3,0.00019,369329,23.65860,1561077
10896,emilioag,3,0.00019,369332,23.65879,1561077
10897,EmilyDimpfl,3,0.00019,369335,23.65899,1561077
10898,emimarz,3,0.00019,369338,23.65918,1561077
10899,emmaroberts-nbs,3,0.00019,369341,23.65937,1561077
10900,empi89,3,0.00019,369344,23.65956,1561077
10901,endertunc,3,0.00019,369347,23.65976,1561077
10902,enekogb,3,0.00019,369350,23.65995,1561077
10903,Enmotus-Dave-Cohen,3,0.00019,369353,23.66014,1561077
10904,enricojonas,3,0.00019,369356,23.66033,1561077
10905,enschede,3,0.00019,369359,23.66052,1561077
10906,ensean,3,0.00019,369362,23.66072,1561077
10907,enydrueda,3,0.00019,369365,23.66091,1561077
10908,eoghankennedy,3,0.00019,369368,23.66110,1561077
10909,Epsilon314,3,0.00019,369371,23.66129,1561077
10910,eranbibi,3,0.00019,369374,23.66148,1561077
10911,erbrecht,3,0.00019,369377,23.66168,1561077
10912,ercpe,3,0.00019,369380,23.66187,1561077
10913,Erethon,3,0.00019,369383,23.66206,1561077
10914,ericcarboni,3,0.00019,369386,23.66225,1561077
10915,ericKlawitter,3,0.00019,369389,23.66245,1561077
10916,EricoCartmanez,3,0.00019,369392,23.66264,1561077
10917,ericsgagnon,3,0.00019,369395,23.66283,1561077
10918,ericstoppel1,3,0.00019,369398,23.66302,1561077
10919,erikhofer,3,0.00019,369401,23.66321,1561077
10920,Erikvv,3,0.00019,369404,23.66341,1561077
10921,erikzquby,3,0.00019,369407,23.66360,1561077
10922,ernesgonzalez33,3,0.00019,369410,23.66379,1561077
10923,ernestomedina17,3,0.00019,369413,23.66398,1561077
10924,ernix,3,0.00019,369416,23.66418,1561077
10925,eromani-r7,3,0.00019,369419,23.66437,1561077
10926,erral,3,0.00019,369422,23.66456,1561077
10927,eskuat,3,0.00019,369425,23.66475,1561077
10928,EstebanMonge,3,0.00019,369428,23.66494,1561077
10929,esteve,3,0.00019,369431,23.66514,1561077
10930,ethan-haynes,3,0.00019,369434,23.66533,1561077
10931,ethankhall,3,0.00019,369437,23.66552,1561077
10932,etherfoundry,3,0.00019,369440,23.66571,1561077
10933,eugene-riabchuk,3,0.00019,369443,23.66591,1561077
10934,Ev2Evgeny,3,0.00019,369446,23.66610,1561077
10935,everccc,3,0.00019,369449,23.66629,1561077
10936,evictor,3,0.00019,369452,23.66648,1561077
10937,evilbwil,3,0.00019,369455,23.66667,1561077
10938,EvilClam,3,0.00019,369458,23.66687,1561077
10939,e-westra,3,0.00019,369461,23.66706,1561077
10940,ewolfe123,3,0.00019,369464,23.66725,1561077
10941,exander77,3,0.00019,369467,23.66744,1561077
10942,exoemay,3,0.00019,369470,23.66763,1561077
10943,extmkv,3,0.00019,369473,23.66783,1561077
10944,eytand,3,0.00019,369476,23.66802,1561077
10945,ezh,3,0.00019,369479,23.66821,1561077
10946,fab30,3,0.00019,369482,23.66840,1561077
10947,fabienjuif,3,0.00019,369485,23.66860,1561077
10948,fabricat,3,0.00019,369488,23.66879,1561077
10949,fabriciorissetto,3,0.00019,369491,23.66898,1561077
10950,facupalladino,3,0.00019,369494,23.66917,1561077
10951,fadenb,3,0.00019,369497,23.66936,1561077
10952,failshell,3,0.00019,369500,23.66956,1561077
10953,faintdream,3,0.00019,369503,23.66975,1561077
10954,fairmonk,3,0.00019,369506,23.66994,1561077
10955,FallenRiteMonk,3,0.00019,369509,23.67013,1561077
10956,fanny-jiang,3,0.00019,369512,23.67033,1561077
10957,fantasyair,3,0.00019,369515,23.67052,1561077
10958,Fantomatic,3,0.00019,369518,23.67071,1561077
10959,Faqa,3,0.00019,369521,23.67090,1561077
10960,farnsworth2008,3,0.00019,369524,23.67109,1561077
10961,FartParty,3,0.00019,369527,23.67129,1561077
10962,fc277073030,3,0.00019,369530,23.67148,1561077
10963,fcanela,3,0.00019,369533,23.67167,1561077
10964,fdaca,3,0.00019,369536,23.67186,1561077
10965,fdarul,3,0.00019,369539,23.67205,1561077
10966,fdechery,3,0.00019,369542,23.67225,1561077
10967,fearthewildllama,3,0.00019,369545,23.67244,1561077
10968,fedora19,3,0.00019,369548,23.67263,1561077
10969,feiniao0308,3,0.00019,369551,23.67282,1561077
10970,FeiranTao,3,0.00019,369554,23.67302,1561077
10971,feivxs,3,0.00019,369557,23.67321,1561077
10972,felixge,3,0.00019,369560,23.67340,1561077
10973,felixPG,3,0.00019,369563,23.67359,1561077
10974,felladrin,3,0.00019,369566,23.67378,1561077
10975,fenz,3,0.00019,369569,23.67398,1561077
10976,fescobar,3,0.00019,369572,23.67417,1561077
10977,feteu,3,0.00019,369575,23.67436,1561077
10978,ff-ahumberston,3,0.00019,369578,23.67455,1561077
10979,ffiorentino-CBNL,3,0.00019,369581,23.67475,1561077
10980,ffissore,3,0.00019,369584,23.67494,1561077
10981,fgiacomelli,3,0.00019,369587,23.67513,1561077
10982,fgm,3,0.00019,369590,23.67532,1561077
10983,fgsalomon,3,0.00019,369593,23.67551,1561077
10984,FGtatsuro,3,0.00019,369596,23.67571,1561077
10985,fhalna,3,0.00019,369599,23.67590,1561077
10986,fharris,3,0.00019,369602,23.67609,1561077
10987,FibreFoX,3,0.00019,369605,23.67628,1561077
10988,fimash,3,0.00019,369608,23.67647,1561077
10989,fioxxu,3,0.00019,369611,23.67667,1561077
10990,Firefishy,3,0.00019,369614,23.67686,1561077
10991,fishermans,3,0.00019,369617,23.67705,1561077
10992,fitzy101,3,0.00019,369620,23.67724,1561077
10993,fl0wm0ti0n,3,0.00019,369623,23.67744,1561077
10994,flabrie,3,0.00019,369626,23.67763,1561077
10995,Flaniga3,3,0.00019,369629,23.67782,1561077
10996,flitzie,3,0.00019,369632,23.67801,1561077
10997,flo-02-mu,3,0.00019,369635,23.67820,1561077
10998,FlorianWilhelm,3,0.00019,369638,23.67840,1561077
10999,flozanorht,3,0.00019,369641,23.67859,1561077
11000,fmichaut-dev,3,0.00019,369644,23.67878,1561077
11001,fnaum,3,0.00019,369647,23.67897,1561077
11002,foneox,3,0.00019,369650,23.67917,1561077
11003,foobarfran,3,0.00019,369653,23.67936,1561077
11004,fperrin,3,0.00019,369656,23.67955,1561077
11005,fporta,3,0.00019,369659,23.67974,1561077
11006,FrameBassman,3,0.00019,369662,23.67993,1561077
11007,francescopersico,3,0.00019,369665,23.68013,1561077
11008,FranciscoBorges,3,0.00019,369668,23.68032,1561077
11009,FranckG,3,0.00019,369671,23.68051,1561077
11010,Francois-D,3,0.00019,369674,23.68070,1561077
11011,frank273,3,0.00019,369677,23.68089,1561077
11012,frankcarey,3,0.00019,369680,23.68109,1561077
11013,FrankJian,3,0.00019,369683,23.68128,1561077
11014,frankvollenweider,3,0.00019,369686,23.68147,1561077
11015,frankySH,3,0.00019,369689,23.68166,1561077
11016,frapontillo,3,0.00019,369692,23.68186,1561077
11017,FrEaKmAn,3,0.00019,369695,23.68205,1561077
11018,freddy33,3,0.00019,369698,23.68224,1561077
11019,fredericmorinara,3,0.00019,369701,23.68243,1561077
11020,freedom1989,3,0.00019,369704,23.68262,1561077
11021,freeman,3,0.00019,369707,23.68282,1561077
11022,freevatar,3,0.00019,369710,23.68301,1561077
11023,freshfx,3,0.00019,369713,23.68320,1561077
11024,Frettman,3,0.00019,369716,23.68339,1561077
11025,Frickeldave,3,0.00019,369719,23.68359,1561077
11026,friedhardware,3,0.00019,369722,23.68378,1561077
11027,froland,3,0.00019,369725,23.68397,1561077
11028,FROSADO,3,0.00019,369728,23.68416,1561077
11029,frozenfoxx,3,0.00019,369731,23.68435,1561077
11030,frznlogic,3,0.00019,369734,23.68455,1561077
11031,fubian,3,0.00019,369737,23.68474,1561077
11032,fugazyrappersoutlook,3,0.00019,369740,23.68493,1561077
11033,fuji246,3,0.00019,369743,23.68512,1561077
11034,fukusuket,3,0.00019,369746,23.68531,1561077
11035,fullycoded,3,0.00019,369749,23.68551,1561077
11036,fun4jimmy,3,0.00019,369752,23.68570,1561077
11037,funkaster,3,0.00019,369755,23.68589,1561077
11038,furystryker,3,0.00019,369758,23.68608,1561077
11039,fuzzybair,3,0.00019,369761,23.68628,1561077
11040,fvztdk,3,0.00019,369764,23.68647,1561077
11041,Gabelbombe,3,0.00019,369767,23.68666,1561077
11042,gabesz84,3,0.00019,369770,23.68685,1561077
11043,gaborcsardi,3,0.00019,369773,23.68704,1561077
11044,gabpil45,3,0.00019,369776,23.68724,1561077
11045,gabrielfairbanks,3,0.00019,369779,23.68743,1561077
11046,gabrielfarias93,3,0.00019,369782,23.68762,1561077
11047,gabrielpreston,3,0.00019,369785,23.68781,1561077
11048,gadams00,3,0.00019,369788,23.68801,1561077
11049,Gadzy,3,0.00019,369791,23.68820,1561077
11050,gaffa,3,0.00019,369794,23.68839,1561077
11051,Gaibhne,3,0.00019,369797,23.68858,1561077
11052,galetis,3,0.00019,369800,23.68877,1561077
11053,galexandre,3,0.00019,369803,23.68897,1561077
11054,galloprussell,3,0.00019,369806,23.68916,1561077
11055,Gamesh,3,0.00019,369809,23.68935,1561077
11056,GarbageYard,3,0.00019,369812,23.68954,1561077
11057,garlandkr,3,0.00019,369815,23.68973,1561077
11058,garyjyao1,3,0.00019,369818,23.68993,1561077
11059,Gaurang033,3,0.00019,369821,23.69012,1561077
11060,GavinZZ,3,0.00019,369824,23.69031,1561077
11061,gayathrisandra,3,0.00019,369827,23.69050,1561077
11062,gbash4128,3,0.00019,369830,23.69070,1561077
11063,gbelorgey,3,0.00019,369833,23.69089,1561077
11064,gbrener,3,0.00019,369836,23.69108,1561077
11065,gcameo,3,0.00019,369839,23.69127,1561077
11066,gcymbalski,3,0.00019,369842,23.69146,1561077
11067,gdelisle,3,0.00019,369845,23.69166,1561077
11068,gdubs,3,0.00019,369848,23.69185,1561077
11069,gdziwoki,3,0.00019,369851,23.69204,1561077
11070,gee72,3,0.00019,369854,23.69223,1561077
11071,GeniusLearner,3,0.00019,369857,23.69243,1561077
11072,gennadykr,3,0.00019,369860,23.69262,1561077
11073,george2515,3,0.00019,369863,23.69281,1561077
11074,gerry-christiansen,3,0.00019,369866,23.69300,1561077
11075,GetchaDEAGLE,3,0.00019,369869,23.69319,1561077
11076,ggkochanski,3,0.00019,369872,23.69339,1561077
11077,ghostganz,3,0.00019,369875,23.69358,1561077
11078,ghusse,3,0.00019,369878,23.69377,1561077
11079,giddel,3,0.00019,369881,23.69396,1561077
11080,gigatesseract,3,0.00019,369884,23.69415,1561077
11081,gigyas,3,0.00019,369887,23.69435,1561077
11082,GioMac,3,0.00019,369890,23.69454,1561077
11083,gir,3,0.00019,369893,23.69473,1561077
11084,gis2all,3,0.00019,369896,23.69492,1561077
11085,githubNinja,3,0.00019,369899,23.69512,1561077
11086,giuliana-bezerra,3,0.00019,369902,23.69531,1561077
11087,giuspen,3,0.00019,369905,23.69550,1561077
11088,Gjed,3,0.00019,369908,23.69569,1561077
11089,gkman,3,0.00019,369911,23.69588,1561077
11090,gkrat,3,0.00019,369914,23.69608,1561077
11091,gl0om,3,0.00019,369917,23.69627,1561077
11092,glebsts,3,0.00019,369920,23.69646,1561077
11093,gleg,3,0.00019,369923,23.69665,1561077
11094,glenjamin,3,0.00019,369926,23.69685,1561077
11095,glennmcallister,3,0.00019,369929,23.69704,1561077
11096,GMafra,3,0.00019,369932,23.69723,1561077
11097,gmaghera,3,0.00019,369935,23.69742,1561077
11098,gmarraffa,3,0.00019,369938,23.69761,1561077
11099,gmegidish,3,0.00019,369941,23.69781,1561077
11100,gmembre-zenika,3,0.00019,369944,23.69800,1561077
11101,gmixo,3,0.00019,369947,23.69819,1561077
11102,gmoirod,3,0.00019,369950,23.69838,1561077
11103,gofancyever,3,0.00019,369953,23.69857,1561077
11104,gogreen53,3,0.00019,369956,23.69877,1561077
11105,gokeefe,3,0.00019,369959,23.69896,1561077
11106,golergka,3,0.00019,369962,23.69915,1561077
11107,gopivalleru,3,0.00019,369965,23.69934,1561077
11108,gorbadoc,3,0.00019,369968,23.69954,1561077
11109,goswings,3,0.00019,369971,23.69973,1561077
11110,gouraharidas,3,0.00019,369974,23.69992,1561077
11111,GoverningCloud,3,0.00019,369977,23.70011,1561077
11112,gowthamshankar99,3,0.00019,369980,23.70030,1561077
11113,gowthamsubbu,3,0.00019,369983,23.70050,1561077
11114,gpaiu,3,0.00019,369986,23.70069,1561077
11115,gpetrovgeorgi,3,0.00019,369989,23.70088,1561077
11116,graemecncs,3,0.00019,369992,23.70107,1561077
11117,gray-image,3,0.00019,369995,23.70127,1561077
11118,grazielegs,3,0.00019,369998,23.70146,1561077
11119,greenjm,3,0.00019,370001,23.70165,1561077
11120,gregastasothebys,3,0.00019,370004,23.70184,1561077
11121,gregcarriger,3,0.00019,370007,23.70203,1561077
11122,gregnorth,3,0.00019,370010,23.70223,1561077
11123,grjones,3,0.00019,370013,23.70242,1561077
11124,Grogdunn,3,0.00019,370016,23.70261,1561077
11125,Grosskopferter,3,0.00019,370019,23.70280,1561077
11126,grotrek,3,0.00019,370022,23.70299,1561077
11127,gruaig,3,0.00019,370025,23.70319,1561077
11128,gruhoptum,3,0.00019,370028,23.70338,1561077
11129,grumpyshoe,3,0.00019,370031,23.70357,1561077
11130,grzegorz181,3,0.00019,370034,23.70376,1561077
11131,grzegorz-kotarski,3,0.00019,370037,23.70396,1561077
11132,gsugambit,3,0.00019,370040,23.70415,1561077
11133,gsumalo,3,0.00019,370043,23.70434,1561077
11134,gthosaniNetskope,3,0.00019,370046,23.70453,1561077
11135,gtrkiller,3,0.00019,370049,23.70472,1561077
11136,GudaboinaSuhas,3,0.00019,370052,23.70492,1561077
11137,guidodl,3,0.00019,370055,23.70511,1561077
11138,guilherme93,3,0.00019,370058,23.70530,1561077
11139,guilhermemauro,3,0.00019,370061,23.70549,1561077
11140,Guillaumichaud,3,0.00019,370064,23.70569,1561077
11141,guillemetten,3,0.00019,370067,23.70588,1561077
11142,Guitrum,3,0.00019,370070,23.70607,1561077
11143,gumutianqi,3,0.00019,370073,23.70626,1561077
11144,gunnypatel,3,0.00019,370076,23.70645,1561077
11145,guozhangwang,3,0.00019,370079,23.70665,1561077
11146,gurv,3,0.00019,370082,23.70684,1561077
11147,gusleig,3,0.00019,370085,23.70703,1561077
11148,gustavohenrique,3,0.00019,370088,23.70722,1561077
11149,guvial,3,0.00019,370091,23.70741,1561077
11150,guwenqing,3,0.00019,370094,23.70761,1561077
11151,gvilarino,3,0.00019,370097,23.70780,1561077
11152,g-w,3,0.00019,370100,23.70799,1561077
11153,gwolkerstorfer,3,0.00019,370103,23.70818,1561077
11154,GWT5091,3,0.00019,370106,23.70838,1561077
11155,gxbjtu,3,0.00019,370109,23.70857,1561077
11156,habib-the-sweet,3,0.00019,370112,23.70876,1561077
11157,habolanos,3,0.00019,370115,23.70895,1561077
11158,hagaigold,3,0.00019,370118,23.70914,1561077
11159,haiyanghaiyang,3,0.00019,370121,23.70934,1561077
11160,halloweed,3,0.00019,370124,23.70953,1561077
11161,hamzaahmedkhan,3,0.00019,370127,23.70972,1561077
11162,hanczaryk,3,0.00019,370130,23.70991,1561077
11163,HanruiZ,3,0.00019,370133,23.71011,1561077
11164,hansboder,3,0.00019,370136,23.71030,1561077
11165,Hardik500,3,0.00019,370139,23.71049,1561077
11166,hardyvala,3,0.00019,370142,23.71068,1561077
11167,HarishMargal,3,0.00019,370145,23.71087,1561077
11168,harmti,3,0.00019,370148,23.71107,1561077
11169,haroldwongms,3,0.00019,370151,23.71126,1561077
11170,HarrierPanels,3,0.00019,370154,23.71145,1561077
11171,HarryCaveMan,3,0.00019,370157,23.71164,1561077
11172,harrysingh,3,0.00019,370160,23.71183,1561077
11173,HarryWeppner,3,0.00019,370163,23.71203,1561077
11174,harrywynn,3,0.00019,370166,23.71222,1561077
11175,harshana-rav,3,0.00019,370169,23.71241,1561077
11176,harshblog150,3,0.00019,370172,23.71260,1561077
11177,hatxet,3,0.00019,370175,23.71280,1561077
11178,hauntingEcho,3,0.00019,370178,23.71299,1561077
11179,havenqi,3,0.00019,370181,23.71318,1561077
11180,Hawk777,3,0.00019,370184,23.71337,1561077
11181,hbajaj2,3,0.00019,370187,23.71356,1561077
11182,hdep,3,0.00019,370190,23.71376,1561077
11183,HeikoNardmann,3,0.00019,370193,23.71395,1561077
11184,heiooyooy,3,0.00019,370196,23.71414,1561077
11185,held62,3,0.00019,370199,23.71433,1561077
11186,hellojukay,3,0.00019,370202,23.71453,1561077
11187,hema-surya,3,0.00019,370205,23.71472,1561077
11188,hendrikstill,3,0.00019,370208,23.71491,1561077
11189,hendryang,3,0.00019,370211,23.71510,1561077
11190,hengike,3,0.00019,370214,23.71529,1561077
11191,henkjan,3,0.00019,370217,23.71549,1561077
11192,HenningL,3,0.00019,370220,23.71568,1561077
11193,henok321,3,0.00019,370223,23.71587,1561077
11194,henrik242,3,0.00019,370226,23.71606,1561077
11195,henshitou,3,0.00019,370229,23.71625,1561077
11196,henti,3,0.00019,370232,23.71645,1561077
11197,hesk,3,0.00019,370235,23.71664,1561077
11198,heunghingwan,3,0.00019,370238,23.71683,1561077
11199,hgner,3,0.00019,370241,23.71702,1561077
11200,hhandberg,3,0.00019,370244,23.71722,1561077
11201,hickeng,3,0.00019,370247,23.71741,1561077
11202,hiephuunguyen3385,3,0.00019,370250,23.71760,1561077
11203,higrow,3,0.00019,370253,23.71779,1561077
11204,Hildebrand,3,0.00019,370256,23.71798,1561077
11205,hillebrand,3,0.00019,370259,23.71818,1561077
11206,himanshu219,3,0.00019,370262,23.71837,1561077
11207,hite77,3,0.00019,370265,23.71856,1561077
11208,hluk,3,0.00019,370268,23.71875,1561077
11209,hmagroun,3,0.00019,370271,23.71895,1561077
11210,hnioche,3,0.00019,370274,23.71914,1561077
11211,hnts,3,0.00019,370277,23.71933,1561077
11212,hoaitang,3,0.00019,370280,23.71952,1561077
11213,hobit1111,3,0.00019,370283,23.71971,1561077
11214,hodossy,3,0.00019,370286,23.71991,1561077
11215,hoikin,3,0.00019,370289,23.72010,1561077
11216,hoshposh,3,0.00019,370292,23.72029,1561077
11217,HrFlorianHoffmann,3,0.00019,370295,23.72048,1561077
11218,HristoKehayov,3,0.00019,370298,23.72067,1561077
11219,hsatterwhite-transloc,3,0.00019,370301,23.72087,1561077
11220,hscanlan,3,0.00019,370304,23.72106,1561077
11221,htanjo,3,0.00019,370307,23.72125,1561077
11222,htplbc,3,0.00019,370310,23.72144,1561077
11223,htthao,3,0.00019,370313,23.72164,1561077
11224,huanghantao,3,0.00019,370316,23.72183,1561077
11225,huangjingfang,3,0.00019,370319,23.72202,1561077
11226,huangrenxi,3,0.00019,370322,23.72221,1561077
11227,hugoboos,3,0.00019,370325,23.72240,1561077
11228,huifanglu2018,3,0.00019,370328,23.72260,1561077
11229,huylv,3,0.00019,370331,23.72279,1561077
11230,huynguyenqas,3,0.00019,370334,23.72298,1561077
11231,huyugui,3,0.00019,370337,23.72317,1561077
11232,hwellmann,3,0.00019,370340,23.72337,1561077
11233,hyChang1221,3,0.00019,370343,23.72356,1561077
11234,Hym-tw,3,0.00019,370346,23.72375,1561077
11235,hyunjutrudylee,3,0.00019,370349,23.72394,1561077
11236,i4s-pserrano,3,0.00019,370352,23.72413,1561077
11237,iamlauriano,3,0.00019,370355,23.72433,1561077
11238,i-am-vt,3,0.00019,370358,23.72452,1561077
11239,ianceicys,3,0.00019,370361,23.72471,1561077
11240,ianhinder,3,0.00019,370364,23.72490,1561077
11241,ibaiul,3,0.00019,370367,23.72509,1561077
11242,ibrahim-alzant,3,0.00019,370370,23.72529,1561077
11243,ibratoev,3,0.00019,370373,23.72548,1561077
11244,ibuys,3,0.00019,370376,23.72567,1561077
11245,Icemap,3,0.00019,370379,23.72586,1561077
11246,IchordeDionysos,3,0.00019,370382,23.72606,1561077
11247,idlefella,3,0.00019,370385,23.72625,1561077
11248,i-feofilaktov,3,0.00019,370388,23.72644,1561077
11249,igijedi,3,0.00019,370391,23.72663,1561077
11250,IgnatevSV,3,0.00019,370394,23.72682,1561077
11251,igorbljahhin,3,0.00019,370397,23.72702,1561077
11252,igor-pinchuk,3,0.00019,370400,23.72721,1561077
11253,Igorshp,3,0.00019,370403,23.72740,1561077
11254,igut,3,0.00019,370406,23.72759,1561077
11255,iHearty,3,0.00019,370409,23.72779,1561077
11256,ijcd,3,0.00019,370412,23.72798,1561077
11257,ikarstein,3,0.00019,370415,23.72817,1561077
11258,ikesyo,3,0.00019,370418,23.72836,1561077
11259,iklen5,3,0.00019,370421,23.72855,1561077
11260,ilaipi,3,0.00019,370424,23.72875,1561077
11261,ilchemla,3,0.00019,370427,23.72894,1561077
11262,ilias-ar,3,0.00019,370430,23.72913,1561077
11263,illay1994,3,0.00019,370433,23.72932,1561077
11264,ilovemysillybanana,3,0.00019,370436,23.72951,1561077
11265,ilsl,3,0.00019,370439,23.72971,1561077
11266,ilyaa1,3,0.00019,370442,23.72990,1561077
11267,ilyataskaev,3,0.00019,370445,23.73009,1561077
11268,imdadahad,3,0.00019,370448,23.73028,1561077
11269,ImDevinC,3,0.00019,370451,23.73048,1561077
11270,inaxium,3,0.00019,370454,23.73067,1561077
11271,indiws,3,0.00019,370457,23.73086,1561077
11272,inetshell,3,0.00019,370460,23.73105,1561077
11273,initialzero,3,0.00019,370463,23.73124,1561077
11274,innocentiv,3,0.00019,370466,23.73144,1561077
11275,instipod,3,0.00019,370469,23.73163,1561077
11276,intel352,3,0.00019,370472,23.73182,1561077
11277,interone-ms,3,0.00019,370475,23.73201,1561077
11278,inzagod,3,0.00019,370478,23.73221,1561077
11279,IONKnight,3,0.00019,370481,23.73240,1561077
11280,IOOOTAlan,3,0.00019,370484,23.73259,1561077
11281,Iridias,3,0.00019,370487,23.73278,1561077
11282,iridinite,3,0.00019,370490,23.73297,1561077
11283,irishgordo,3,0.00019,370493,23.73317,1561077
11284,IRobL,3,0.00019,370496,23.73336,1561077
11285,ironiusn,3,0.00019,370499,23.73355,1561077
11286,IronSean,3,0.00019,370502,23.73374,1561077
11287,irrandon,3,0.00019,370505,23.73393,1561077
11288,irschad,3,0.00019,370508,23.73413,1561077
11289,ishan-12,3,0.00019,370511,23.73432,1561077
11290,ishepherd,3,0.00019,370514,23.73451,1561077
11291,ishmora,3,0.00019,370517,23.73470,1561077
11292,istolga,3,0.00019,370520,23.73490,1561077
11293,itaborda,3,0.00019,370523,23.73509,1561077
11294,itorK,3,0.00019,370526,23.73528,1561077
11295,itsmemac,3,0.00019,370529,23.73547,1561077
11296,itzikb,3,0.00019,370532,23.73566,1561077
11297,iugostang,3,0.00019,370535,23.73586,1561077
11298,ivan1986,3,0.00019,370538,23.73605,1561077
11299,ivanli1990,3,0.00019,370541,23.73624,1561077
11300,IvanUAH,3,0.00019,370544,23.73643,1561077
11301,ivopatty,3,0.00019,370547,23.73663,1561077
11302,ivtashev,3,0.00019,370550,23.73682,1561077
11303,iwonbigbro,3,0.00019,370553,23.73701,1561077
11304,izcet,3,0.00019,370556,23.73720,1561077
11305,j03m,3,0.00019,370559,23.73739,1561077
11306,j4b0l,3,0.00019,370562,23.73759,1561077
11307,ja2081,3,0.00019,370565,23.73778,1561077
11308,jacekbilski,3,0.00019,370568,23.73797,1561077
11309,JackHowa,3,0.00019,370571,23.73816,1561077
11310,jackieli-tes,3,0.00019,370574,23.73835,1561077
11311,jacknewcombe-je,3,0.00019,370577,23.73855,1561077
11312,jacob-ablowitz,3,0.00019,370580,23.73874,1561077
11313,jacob-dmi,3,0.00019,370583,23.73893,1561077
11314,jacobfike,3,0.00019,370586,23.73912,1561077
11315,Jacob-Levitan-Snyk,3,0.00019,370589,23.73932,1561077
11316,jacobweber,3,0.00019,370592,23.73951,1561077
11317,JacquesOfAllTrades,3,0.00019,370595,23.73970,1561077
11318,jagte,3,0.00019,370598,23.73989,1561077
11319,jakubfijalkowski,3,0.00019,370601,23.74008,1561077
11320,jakubvondrak,3,0.00019,370604,23.74028,1561077
11321,jamesabbottsmith,3,0.00019,370607,23.74047,1561077
11322,jamesholderness-ibboost,3,0.00019,370610,23.74066,1561077
11323,james-hu,3,0.00019,370613,23.74085,1561077
11324,jamesmawm,3,0.00019,370616,23.74105,1561077
11325,jamestechv,3,0.00019,370619,23.74124,1561077
11326,jamie-pate,3,0.00019,370622,23.74143,1561077
11327,jamiewastin,3,0.00019,370625,23.74162,1561077
11328,jamoralp,3,0.00019,370628,23.74181,1561077
11329,jamshid,3,0.00019,370631,23.74201,1561077
11330,jan0112d,3,0.00019,370634,23.74220,1561077
11331,janaurka,3,0.00019,370637,23.74239,1561077
11332,jan-feindt,3,0.00019,370640,23.74258,1561077
11333,jangalda-nsc,3,0.00019,370643,23.74278,1561077
11334,janssk1,3,0.00019,370646,23.74297,1561077
11335,jaohaohsuan,3,0.00019,370649,23.74316,1561077
11336,JaredReady,3,0.00019,370652,23.74335,1561077
11337,jasonh-logic2020,3,0.00019,370655,23.74354,1561077
11338,JasonMathison,3,0.00019,370658,23.74374,1561077
11339,jason-schatz-hcl,3,0.00019,370661,23.74393,1561077
11340,jasoryeh,3,0.00019,370664,23.74412,1561077
11341,javicastillo83,3,0.00019,370667,23.74431,1561077
11342,javlonsodikov,3,0.00019,370670,23.74450,1561077
11343,jayabalan1992,3,0.00019,370673,23.74470,1561077
11344,jayaganthan,3,0.00019,370676,23.74489,1561077
11345,jayahariv,3,0.00019,370679,23.74508,1561077
11346,jay-johnson,3,0.00019,370682,23.74527,1561077
11347,jaysonwor,3,0.00019,370685,23.74547,1561077
11348,jayzandme,3,0.00019,370688,23.74566,1561077
11349,jazminorozco,3,0.00019,370691,23.74585,1561077
11350,jbapple-cloudera,3,0.00019,370694,23.74604,1561077
11351,jbinglei,3,0.00019,370697,23.74623,1561077
11352,JBlandHV,3,0.00019,370700,23.74643,1561077
11353,jbogers,3,0.00019,370703,23.74662,1561077
11354,jbomaileva,3,0.00019,370706,23.74681,1561077
11355,jbouse,3,0.00019,370709,23.74700,1561077
11356,jbrunett,3,0.00019,370712,23.74720,1561077
11357,JC1738,3,0.00019,370715,23.74739,1561077
11358,jcatana,3,0.00019,370718,23.74758,1561077
11359,j-chao,3,0.00019,370721,23.74777,1561077
11360,jchuong,3,0.00019,370724,23.74796,1561077
11361,jchychot,3,0.00019,370727,23.74816,1561077
11362,jcme,3,0.00019,370730,23.74835,1561077
11363,jcogilvie,3,0.00019,370733,23.74854,1561077
11364,jdbeutel,3,0.00019,370736,23.74873,1561077
11365,jdeniau,3,0.00019,370739,23.74892,1561077
11366,jdepp,3,0.00019,370742,23.74912,1561077
11367,jdfeathe,3,0.00019,370745,23.74931,1561077
11368,jdillard,3,0.00019,370748,23.74950,1561077
11369,jdoshi1,3,0.00019,370751,23.74969,1561077
11370,jdrouhard,3,0.00019,370754,23.74989,1561077
11371,jdurzi,3,0.00019,370757,23.75008,1561077
11372,jdve,3,0.00019,370760,23.75027,1561077
11373,JeanChristopheMorinRodeoFX,3,0.00019,370763,23.75046,1561077
11374,jeantil,3,0.00019,370766,23.75065,1561077
11375,jeckste,3,0.00019,370769,23.75085,1561077
11376,jeffb-stell,3,0.00019,370772,23.75104,1561077
11377,jeffreymergler,3,0.00019,370775,23.75123,1561077
11378,jefimm,3,0.00019,370778,23.75142,1561077
11379,jegr78,3,0.00019,370781,23.75162,1561077
11380,jeitae,3,0.00019,370784,23.75181,1561077
11381,jekakm,3,0.00019,370787,23.75200,1561077
11382,jennyfountain,3,0.00019,370790,23.75219,1561077
11383,jenrsparks,3,0.00019,370793,23.75238,1561077
11384,jensdotbruggeman,3,0.00019,370796,23.75258,1561077
11385,jensh007,3,0.00019,370799,23.75277,1561077
11386,Jenwitsstt,3,0.00019,370802,23.75296,1561077
11387,Jerakin,3,0.00019,370805,23.75315,1561077
11388,JerBear70,3,0.00019,370808,23.75334,1561077
11389,jeremyber,3,0.00019,370811,23.75354,1561077
11390,jeremydonahue,3,0.00019,370814,23.75373,1561077
11391,jeremyhager,3,0.00019,370817,23.75392,1561077
11392,jeremyweber-np,3,0.00019,370820,23.75411,1561077
11393,jessefarinacci,3,0.00019,370823,23.75431,1561077
11394,jessleonard,3,0.00019,370826,23.75450,1561077
11395,jesstruck,3,0.00019,370829,23.75469,1561077
11396,jeykey,3,0.00019,370832,23.75488,1561077
11397,jfemia,3,0.00019,370835,23.75507,1561077
11398,jgabriel98,3,0.00019,370838,23.75527,1561077
11399,jgajaan,3,0.00019,370841,23.75546,1561077
11400,jgawor,3,0.00019,370844,23.75565,1561077
11401,jgebal,3,0.00019,370847,23.75584,1561077
11402,jgkite,3,0.00019,370850,23.75604,1561077
11403,jgmchan,3,0.00019,370853,23.75623,1561077
11404,jgrammen-agilitypr,3,0.00019,370856,23.75642,1561077
11405,jh0natan166,3,0.00019,370859,23.75661,1561077
11406,jhaeyaert,3,0.00019,370862,23.75680,1561077
11407,jhita,3,0.00019,370865,23.75700,1561077
11408,jhonny-oliveira,3,0.00019,370868,23.75719,1561077
11409,jhosmer,3,0.00019,370871,23.75738,1561077
11410,jiakuan,3,0.00019,370874,23.75757,1561077
11411,jiaming0708,3,0.00019,370877,23.75776,1561077
11412,JigarProjects,3,0.00019,370880,23.75796,1561077
11413,jihyun00,3,0.00019,370883,23.75815,1561077
11414,jikortus,3,0.00019,370886,23.75834,1561077
11415,jillianwilson,3,0.00019,370889,23.75853,1561077
11416,jimcroft,3,0.00019,370892,23.75873,1561077
11417,jimmymalhan,3,0.00019,370895,23.75892,1561077
11418,jinlxz,3,0.00019,370898,23.75911,1561077
11419,jinwg,3,0.00019,370901,23.75930,1561077
11420,Jinxit,3,0.00019,370904,23.75949,1561077
11421,jiri-meluzin,3,0.00019,370907,23.75969,1561077
11422,jjaaxx44,3,0.00019,370910,23.75988,1561077
11423,JJApache,3,0.00019,370913,23.76007,1561077
11424,JJJayway,3,0.00019,370916,23.76026,1561077
11425,jjlehtinen,3,0.00019,370919,23.76046,1561077
11426,jjouanno,3,0.00019,370922,23.76065,1561077
11427,jjuarez,3,0.00019,370925,23.76084,1561077
11428,jjulicher,3,0.00019,370928,23.76103,1561077
11429,jkao97,3,0.00019,370931,23.76122,1561077
11430,jkatnik,3,0.00019,370934,23.76142,1561077
11431,jkerssens,3,0.00019,370937,23.76161,1561077
11432,jkopriva,3,0.00019,370940,23.76180,1561077
11433,jkrehm,3,0.00019,370943,23.76199,1561077
11434,jkretsch,3,0.00019,370946,23.76218,1561077
11435,jkwiz,3,0.00019,370949,23.76238,1561077
11436,jlafreni,3,0.00019,370952,23.76257,1561077
11437,jlfranklin,3,0.00019,370955,23.76276,1561077
11438,jlhuerfanor,3,0.00019,370958,23.76295,1561077
11439,jlouisfoster,3,0.00019,370961,23.76315,1561077
11440,jmahowald,3,0.00019,370964,23.76334,1561077
11441,jmcmahon,3,0.00019,370967,23.76353,1561077
11442,jmcu,3,0.00019,370970,23.76372,1561077
11443,jmif,3,0.00019,370973,23.76391,1561077
11444,jmleddy,3,0.00019,370976,23.76411,1561077
11445,jmoliva,3,0.00019,370979,23.76430,1561077
11446,jmullo,3,0.00019,370982,23.76449,1561077
11447,jmvanryn,3,0.00019,370985,23.76468,1561077
11448,jnbnyc,3,0.00019,370988,23.76488,1561077
11449,jnikolai,3,0.00019,370991,23.76507,1561077
11450,JoachimSailer,3,0.00019,370994,23.76526,1561077
11451,joaorebelo-ar,3,0.00019,370997,23.76545,1561077
11452,jobamnavarro,3,0.00019,371000,23.76564,1561077
11453,jocbothe,3,0.00019,371003,23.76584,1561077
11454,jochen42,3,0.00019,371006,23.76603,1561077
11455,joearasin,3,0.00019,371009,23.76622,1561077
11456,joelcox22,3,0.00019,371012,23.76641,1561077
11457,joerg1985,3,0.00019,371015,23.76660,1561077
11458,joesiewert,3,0.00019,371018,23.76680,1561077
11459,joesolly,3,0.00019,371021,23.76699,1561077
11460,joeyparis,3,0.00019,371024,23.76718,1561077
11461,joeypiccola,3,0.00019,371027,23.76737,1561077
11462,JohnBloom,3,0.00019,371030,23.76757,1561077
11463,johnclyde,3,0.00019,371033,23.76776,1561077
11464,johnnnliu,3,0.00019,371036,23.76795,1561077
11465,john-pastore,3,0.00019,371039,23.76814,1561077
11466,johnyesberg,3,0.00019,371042,23.76833,1561077
11467,JohnYu500,3,0.00019,371045,23.76853,1561077
11468,jojwang,3,0.00019,371048,23.76872,1561077
11469,jolivares,3,0.00019,371051,23.76891,1561077
11470,jonasv,3,0.00019,371054,23.76910,1561077
11471,JonathanKayumbo,3,0.00019,371057,23.76930,1561077
11472,jonathannaguin,3,0.00019,371060,23.76949,1561077
11473,jonbca,3,0.00019,371063,23.76968,1561077
11474,jonbev,3,0.00019,371066,23.76987,1561077
11475,jondkelley,3,0.00019,371069,23.77006,1561077
11476,jonespm,3,0.00019,371072,23.77026,1561077
11477,jonesr91,3,0.00019,371075,23.77045,1561077
11478,jonheckman,3,0.00019,371078,23.77064,1561077
11479,jonlil,3,0.00019,371081,23.77083,1561077
11480,jonneymendoza,3,0.00019,371084,23.77102,1561077
11481,JonnyBGod,3,0.00019,371087,23.77122,1561077
11482,jons,3,0.00019,371090,23.77141,1561077
11483,JonSnowWhite,3,0.00019,371093,23.77160,1561077
11484,Jordan-Roberts1,3,0.00019,371096,23.77179,1561077
11485,jordisala1991,3,0.00019,371099,23.77199,1561077
11486,jorgeyanesdiez,3,0.00019,371102,23.77218,1561077
11487,Jorkata13,3,0.00019,371105,23.77237,1561077
11488,jornjambers,3,0.00019,371108,23.77256,1561077
11489,joseph-chu,3,0.00019,371111,23.77275,1561077
11490,josephjthomas,3,0.00019,371114,23.77295,1561077
11491,joseronierison,3,0.00019,371117,23.77314,1561077
11492,josh-padnick,3,0.00019,371120,23.77333,1561077
11493,joshuabaird,3,0.00019,371123,23.77352,1561077
11494,joshuaswickirl,3,0.00019,371126,23.77372,1561077
11495,joshuatalb,3,0.00019,371129,23.77391,1561077
11496,JosueTorres,3,0.00019,371132,23.77410,1561077
11497,joycebrum,3,0.00019,371135,23.77429,1561077
11498,Jpanda124,3,0.00019,371138,23.77448,1561077
11499,jpgauthier,3,0.00019,371141,23.77468,1561077
11500,jphhoeks,3,0.00019,371144,23.77487,1561077
11501,jpk6789,3,0.00019,371147,23.77506,1561077
11502,jrbury,3,0.00019,371150,23.77525,1561077
11503,jrDevBot,3,0.00019,371153,23.77544,1561077
11504,jrdufresne,3,0.00019,371156,23.77564,1561077
11505,jre-lsft,3,0.00019,371159,23.77583,1561077
11506,jrowinski3d,3,0.00019,371162,23.77602,1561077
11507,jrpalmer,3,0.00019,371165,23.77621,1561077
11508,jsachs,3,0.00019,371168,23.77641,1561077
11509,jschewebbn,3,0.00019,371171,23.77660,1561077
11510,jsedlace,3,0.00019,371174,23.77679,1561077
11511,jskyn,3,0.00019,371177,23.77698,1561077
11512,jsmickey,3,0.00019,371180,23.77717,1561077
11513,jsposato,3,0.00019,371183,23.77737,1561077
11514,jsztuka,3,0.00019,371186,23.77756,1561077
11515,jtillman,3,0.00019,371189,23.77775,1561077
11516,jtylr,3,0.00019,371192,23.77794,1561077
11517,juaningan,3,0.00019,371195,23.77814,1561077
11518,juanmariareina,3,0.00019,371198,23.77833,1561077
11519,Jujupretha,3,0.00019,371201,23.77852,1561077
11520,Julian,3,0.00019,371204,23.77871,1561077
11521,julianh2o,3,0.00019,371207,23.77890,1561077
11522,julio-je-yaguez,3,0.00019,371210,23.77910,1561077
11523,JungStar,3,0.00019,371213,23.77929,1561077
11524,JuniorCtba,3,0.00019,371216,23.77948,1561077
11525,jurnho,3,0.00019,371219,23.77967,1561077
11526,just-another-dude,3,0.00019,371222,23.77986,1561077
11527,justinholmes,3,0.00019,371225,23.78006,1561077
11528,justinzyw,3,0.00019,371228,23.78025,1561077
11529,jvezinat,3,0.00019,371231,23.78044,1561077
11530,jwestboston,3,0.00019,371234,23.78063,1561077
11531,jwmoss,3,0.00019,371237,23.78083,1561077
11532,jyukenzan,3,0.00019,371240,23.78102,1561077
11533,k2glyph,3,0.00019,371243,23.78121,1561077
11534,kafteji,3,0.00019,371246,23.78140,1561077
11535,kaiayang,3,0.00019,371249,23.78159,1561077
11536,kaihuang201,3,0.00019,371252,23.78179,1561077
11537,kairu1987,3,0.00019,371255,23.78198,1561077
11538,kaleb-himes,3,0.00019,371258,23.78217,1561077
11539,Kalejin,3,0.00019,371261,23.78236,1561077
11540,kalyankp,3,0.00019,371264,23.78256,1561077
11541,KaminerD,3,0.00019,371267,23.78275,1561077
11542,Kanaduchi,3,0.00019,371270,23.78294,1561077
11543,kandia,3,0.00019,371273,23.78313,1561077
11544,kankaristo,3,0.00019,371276,23.78332,1561077
11545,karanj1994,3,0.00019,371279,23.78352,1561077
11546,karcherm,3,0.00019,371282,23.78371,1561077
11547,karianna,3,0.00019,371285,23.78390,1561077
11548,karlgb,3,0.00019,371288,23.78409,1561077
11549,karolkrawczyk,3,0.00019,371291,23.78428,1561077
11550,karthiksrinivasan,3,0.00019,371294,23.78448,1561077
11551,kartnan,3,0.00019,371297,23.78467,1561077
11552,kathryngo,3,0.00019,371300,23.78486,1561077
11553,kavyaAirbus,3,0.00019,371303,23.78505,1561077
11554,kayhu,3,0.00019,371306,23.78525,1561077
11555,KayK,3,0.00019,371309,23.78544,1561077
11556,kbatalin,3,0.00019,371312,23.78563,1561077
11557,kbrandt,3,0.00019,371315,23.78582,1561077
11558,kdawgwilk,3,0.00019,371318,23.78601,1561077
11559,kddubb,3,0.00019,371321,23.78621,1561077
11560,ke5aux,3,0.00019,371324,23.78640,1561077
11561,keestux,3,0.00019,371327,23.78659,1561077
11562,keinkonzept,3,0.00019,371330,23.78678,1561077
11563,keis,3,0.00019,371333,23.78698,1561077
11564,kel00s,3,0.00019,371336,23.78717,1561077
11565,kellcomnet2,3,0.00019,371339,23.78736,1561077
11566,kelvSYC-twitter,3,0.00019,371342,23.78755,1561077
11567,KemalSoysal,3,0.00019,371345,23.78774,1561077
11568,kenga,3,0.00019,371348,23.78794,1561077
11569,kennyko,3,0.00019,371351,23.78813,1561077
11570,Kern3l,3,0.00019,371354,23.78832,1561077
11571,kerr-bighealth,3,0.00019,371357,23.78851,1561077
11572,keshlam,3,0.00019,371360,23.78870,1561077
11573,kevangelidis,3,0.00019,371363,23.78890,1561077
11574,kevenli,3,0.00019,371366,23.78909,1561077
11575,Kevgilmore,3,0.00019,371369,23.78928,1561077
11576,KevinCathcart,3,0.00019,371372,23.78947,1561077
11577,kevinchowvungle,3,0.00019,371375,23.78967,1561077
11578,KevinLoveGitHub,3,0.00019,371378,23.78986,1561077
11579,Keysluomo,3,0.00019,371381,23.79005,1561077
11580,kh77,3,0.00019,371384,23.79024,1561077
11581,khalidjshaikh,3,0.00019,371387,23.79043,1561077
11582,khell,3,0.00019,371390,23.79063,1561077
11583,KhimairaCrypto,3,0.00019,371393,23.79082,1561077
11584,kholloway,3,0.00019,371396,23.79101,1561077
11585,kiahmed,3,0.00019,371399,23.79120,1561077
11586,kiic-leung,3,0.00019,371402,23.79140,1561077
11587,KikiCS,3,0.00019,371405,23.79159,1561077
11588,kiliczsh,3,0.00019,371408,23.79178,1561077
11589,KillianH,3,0.00019,371411,23.79197,1561077
11590,kimkong88,3,0.00019,371414,23.79216,1561077
11591,KimNorgaard,3,0.00019,371417,23.79236,1561077
11592,KimonHoffmann,3,0.00019,371420,23.79255,1561077
11593,kimschmock,3,0.00019,371423,23.79274,1561077
11594,kimsehwan96,3,0.00019,371426,23.79293,1561077
11595,kingsathurthi,3,0.00019,371429,23.79312,1561077
11596,kirangavali,3,0.00019,371432,23.79332,1561077
11597,KirkMartinez,3,0.00019,371435,23.79351,1561077
11598,kishorchintal,3,0.00019,371438,23.79370,1561077
11599,kjing,3,0.00019,371441,23.79389,1561077
11600,kkavin,3,0.00019,371444,23.79409,1561077
11601,klaussilveira,3,0.00019,371447,23.79428,1561077
11602,KLDM,3,0.00019,371450,23.79447,1561077
11603,klein178,3,0.00019,371453,23.79466,1561077
11604,klodnickik,3,0.00019,371456,23.79485,1561077
11605,klw0539,3,0.00019,371459,23.79505,1561077
11606,kmaris,3,0.00019,371462,23.79524,1561077
11607,knorx,3,0.00019,371465,23.79543,1561077
11608,kodeva,3,0.00019,371468,23.79562,1561077
11609,kofrezo,3,0.00019,371471,23.79582,1561077
11610,Kolky,3,0.00019,371474,23.79601,1561077
11611,Komodoro,3,0.00019,371477,23.79620,1561077
11612,konkit,3,0.00019,371480,23.79639,1561077
11613,konnta0,3,0.00019,371483,23.79658,1561077
11614,Konpon96,3,0.00019,371486,23.79678,1561077
11615,Kopei,3,0.00019,371489,23.79697,1561077
11616,kormotodor,3,0.00019,371492,23.79716,1561077
11617,kossmoboleat,3,0.00019,371495,23.79735,1561077
11618,KotovVitaliy,3,0.00019,371498,23.79754,1561077
11619,kozzztya,3,0.00019,371501,23.79774,1561077
11620,kramarz,3,0.00019,371504,23.79793,1561077
11621,krandell,3,0.00019,371507,23.79812,1561077
11622,kranurag7,3,0.00019,371510,23.79831,1561077
11623,kriegaex,3,0.00019,371513,23.79851,1561077
11624,kristi,3,0.00019,371516,23.79870,1561077
11625,krizhan,3,0.00019,371519,23.79889,1561077
11626,krmenon431,3,0.00019,371522,23.79908,1561077
11627,krrishkishore,3,0.00019,371525,23.79927,1561077
11628,krwalker,3,0.00019,371528,23.79947,1561077
11629,KrzysztofDziankowski,3,0.00019,371531,23.79966,1561077
11630,ksperling,3,0.00019,371534,23.79985,1561077
11631,kstevena,3,0.00019,371537,23.80004,1561077
11632,ksuther,3,0.00019,371540,23.80024,1561077
11633,kthacker7,3,0.00019,371543,23.80043,1561077
11634,ktsiligkiris,3,0.00019,371546,23.80062,1561077
11635,kubawi,3,0.00019,371549,23.80081,1561077
11636,KUGDev,3,0.00019,371552,23.80100,1561077
11637,KumarS86,3,0.00019,371555,23.80120,1561077
11638,kumlali,3,0.00019,371558,23.80139,1561077
11639,kumy,3,0.00019,371561,23.80158,1561077
11640,kunshah,3,0.00019,371564,23.80177,1561077
11641,kushwahvishal939,3,0.00019,371567,23.80196,1561077
11642,kvanderslicesuvoda,3,0.00019,371570,23.80216,1561077
11643,kwening,3,0.00019,371573,23.80235,1561077
11644,kwon37xi,3,0.00019,371576,23.80254,1561077
11645,kychoolkim,3,0.00019,371579,23.80273,1561077
11646,kyledwilson,3,0.00019,371582,23.80293,1561077
11647,kylekluever,3,0.00019,371585,23.80312,1561077
11648,kylemanna,3,0.00019,371588,23.80331,1561077
11649,ladventure,3,0.00019,371591,23.80350,1561077
11650,laenzlinger,3,0.00019,371594,23.80369,1561077
11651,laetificat,3,0.00019,371597,23.80389,1561077
11652,lajayis,3,0.00019,371600,23.80408,1561077
11653,Lalit-1219,3,0.00019,371603,23.80427,1561077
11654,lalithkumar97,3,0.00019,371606,23.80446,1561077
11655,lambourn,3,0.00019,371609,23.80466,1561077
11656,Larcagur,3,0.00019,371612,23.80485,1561077
11657,larsimmisch,3,0.00019,371615,23.80504,1561077
11658,laurentribot,3,0.00019,371618,23.80523,1561077
11659,LavaGolem,3,0.00019,371621,23.80542,1561077
11660,lbouquety,3,0.00019,371624,23.80562,1561077
11661,LCerebo,3,0.00019,371627,23.80581,1561077
11662,ldvy,3,0.00019,371630,23.80600,1561077
11663,leandrofrs,3,0.00019,371633,23.80619,1561077
11664,lee-seunghyun,3,0.00019,371636,23.80638,1561077
11665,LeeU1911,3,0.00019,371639,23.80658,1561077
11666,Leftbrained,3,0.00019,371642,23.80677,1561077
11667,lehenric,3,0.00019,371645,23.80696,1561077
11668,leialexisjiang,3,0.00019,371648,23.80715,1561077
11669,lelepentol,3,0.00019,371651,23.80735,1561077
11670,lengland,3,0.00019,371654,23.80754,1561077
11671,LeniuskaAlvarado,3,0.00019,371657,23.80773,1561077
11672,lenoqt,3,0.00019,371660,23.80792,1561077
11673,LeoDOD,3,0.00019,371663,23.80811,1561077
11674,leodutra-aurea,3,0.00019,371666,23.80831,1561077
11675,lepps,3,0.00019,371669,23.80850,1561077
11676,LeSandeep,3,0.00019,371672,23.80869,1561077
11677,leshiynyc,3,0.00019,371675,23.80888,1561077
11678,leslie-alldridge,3,0.00019,371678,23.80908,1561077
11679,levinanton,3,0.00019,371681,23.80927,1561077
11680,Levistator,3,0.00019,371684,23.80946,1561077
11681,LevonBecker,3,0.00019,371687,23.80965,1561077
11682,lexapi,3,0.00019,371690,23.80984,1561077
11683,lfilho,3,0.00019,371693,23.81004,1561077
11684,lgoenner,3,0.00019,371696,23.81023,1561077
11685,lgrill-pentaho,3,0.00019,371699,23.81042,1561077
11686,lhagemann,3,0.00019,371702,23.81061,1561077
11687,lhotari,3,0.00019,371705,23.81080,1561077
11688,lianfulei,3,0.00019,371708,23.81100,1561077
11689,liangming2003,3,0.00019,371711,23.81119,1561077
11690,liangzhitao,3,0.00019,371714,23.81138,1561077
11691,libinglong,3,0.00019,371717,23.81157,1561077
11692,lielran,3,0.00019,371720,23.81177,1561077
11693,lifehutch,3,0.00019,371723,23.81196,1561077
11694,lifemanship,3,0.00019,371726,23.81215,1561077
11695,Likqez,3,0.00019,371729,23.81234,1561077
11696,lilyJi,3,0.00019,371732,23.81253,1561077
11697,lin1005q,3,0.00019,371735,23.81273,1561077
11698,lindycoder,3,0.00019,371738,23.81292,1561077
11699,lizhao-code,3,0.00019,371741,23.81311,1561077
11700,ljacobford,3,0.00019,371744,23.81330,1561077
11701,ljlsh1234321,3,0.00019,371747,23.81350,1561077
11702,lkamal,3,0.00019,371750,23.81369,1561077
11703,lkastenson,3,0.00019,371753,23.81388,1561077
11704,lkokhreidze,3,0.00019,371756,23.81407,1561077
11705,lnsp,3,0.00019,371759,23.81426,1561077
11706,LogikBlitz,3,0.00019,371762,23.81446,1561077
11707,lohandus,3,0.00019,371765,23.81465,1561077
11708,LoicAG,3,0.00019,371768,23.81484,1561077
11709,Lonor,3,0.00019,371771,23.81503,1561077
11710,lopossumi,3,0.00019,371774,23.81523,1561077
11711,loreleimccollum-work,3,0.00019,371777,23.81542,1561077
11712,lorenzph,3,0.00019,371780,23.81561,1561077
11713,LorisSecuro,3,0.00019,371783,23.81580,1561077
11714,lo-ronk11,3,0.00019,371786,23.81599,1561077
11715,LosBandolero,3,0.00019,371789,23.81619,1561077
11716,losiki,3,0.00019,371792,23.81638,1561077
11717,lostiniceland,3,0.00019,371795,23.81657,1561077
11718,louism517,3,0.00019,371798,23.81676,1561077
11719,lovepocky,3,0.00019,371801,23.81695,1561077
11720,lrpg,3,0.00019,371804,23.81715,1561077
11721,lschnetler,3,0.00019,371807,23.81734,1561077
11722,lsdbitrue,3,0.00019,371810,23.81753,1561077
11723,lsoumille,3,0.00019,371813,23.81772,1561077
11724,lspecian,3,0.00019,371816,23.81792,1561077
11725,LTangaF,3,0.00019,371819,23.81811,1561077
11726,lttlang,3,0.00019,371822,23.81830,1561077
11727,luchaninov,3,0.00019,371825,23.81849,1561077
11728,luchianenco,3,0.00019,371828,23.81868,1561077
11729,luckygulli,3,0.00019,371831,23.81888,1561077
11730,LuckySpb,3,0.00019,371834,23.81907,1561077
11731,ludesdeveloper,3,0.00019,371837,23.81926,1561077
11732,luka5z,3,0.00019,371840,23.81945,1561077
11733,lukasy-a,3,0.00019,371843,23.81965,1561077
11734,lukeab,3,0.00019,371846,23.81984,1561077
11735,luke-hill,3,0.00019,371849,23.82003,1561077
11736,luke-tsekouras-sirca,3,0.00019,371852,23.82022,1561077
11737,LukeusMaximus,3,0.00019,371855,23.82041,1561077
11738,luqq,3,0.00019,371858,23.82061,1561077
11739,luvarqpp,3,0.00019,371861,23.82080,1561077
11740,lwasyl,3,0.00019,371864,23.82099,1561077
11741,lyca,3,0.00019,371867,23.82118,1561077
11742,Lyeeedar,3,0.00019,371870,23.82137,1561077
11743,lygfanye,3,0.00019,371873,23.82157,1561077
11744,m00re,3,0.00019,371876,23.82176,1561077
11745,M1123581E,3,0.00019,371879,23.82195,1561077
11746,m1a0yu3,3,0.00019,371882,23.82214,1561077
11747,M1ke,3,0.00019,371885,23.82234,1561077
11748,m2spring,3,0.00019,371888,23.82253,1561077
11749,m3nthal,3,0.00019,371891,23.82272,1561077
11750,maartengryp,3,0.00019,371894,23.82291,1561077
11751,maati55,3,0.00019,371897,23.82310,1561077
11752,madbence,3,0.00019,371900,23.82330,1561077
11753,maddyjakk,3,0.00019,371903,23.82349,1561077
11754,MadHawkx,3,0.00019,371906,23.82368,1561077
11755,Madhuri1518,3,0.00019,371909,23.82387,1561077
11756,madhurig,3,0.00019,371912,23.82407,1561077
11757,maemile,3,0.00019,371915,23.82426,1561077
11758,MagicianTM,3,0.00019,371918,23.82445,1561077
11759,MAH6146,3,0.00019,371921,23.82464,1561077
11760,mahdit83,3,0.00019,371924,23.82483,1561077
11761,mahmoudn88,3,0.00019,371927,23.82503,1561077
11762,majkelcc,3,0.00019,371930,23.82522,1561077
11763,major-fire,3,0.00019,371933,23.82541,1561077
11764,majuscule,3,0.00019,371936,23.82560,1561077
11765,makmaddy17,3,0.00019,371939,23.82579,1561077
11766,malcolm061990,3,0.00019,371942,23.82599,1561077
11767,maleix,3,0.00019,371945,23.82618,1561077
11768,mam10eks,3,0.00019,371948,23.82637,1561077
11769,mambon2,3,0.00019,371951,23.82656,1561077
11770,manandbytes,3,0.00019,371954,23.82676,1561077
11771,manavtidhan,3,0.00019,371957,23.82695,1561077
11772,mancubus77,3,0.00019,371960,23.82714,1561077
11773,maneetxebia,3,0.00019,371963,23.82733,1561077
11774,maniax89,3,0.00019,371966,23.82752,1561077
11775,mantonsson,3,0.00019,371969,23.82772,1561077
11776,maocorte,3,0.00019,371972,23.82791,1561077
11777,MaorT,3,0.00019,371975,23.82810,1561077
11778,maqzee-git,3,0.00019,371978,23.82829,1561077
11779,marc0der,3,0.00019,371981,23.82849,1561077
11780,MarcelBB,3,0.00019,371984,23.82868,1561077
11781,marcelocarlos,3,0.00019,371987,23.82887,1561077
11782,marchaos,3,0.00019,371990,23.82906,1561077
11783,marciomsm,3,0.00019,371993,23.82925,1561077
11784,MarcJose,3,0.00019,371996,23.82945,1561077
11785,marcmac,3,0.00019,371999,23.82964,1561077
11786,marco210,3,0.00019,372002,23.82983,1561077
11787,MarcoAurelioWM,3,0.00019,372005,23.83002,1561077
11788,MarcusUA,3,0.00019,372008,23.83021,1561077
11789,marcvelasco,3,0.00019,372011,23.83041,1561077
11790,mareknovotny,3,0.00019,372014,23.83060,1561077
11791,marianobenes,3,0.00019,372017,23.83079,1561077
11792,marianuspotratz,3,0.00019,372020,23.83098,1561077
11793,markearlwaite,3,0.00019,372023,23.83118,1561077
11794,markfaine,3,0.00019,372026,23.83137,1561077
11795,markHaoChen,3,0.00019,372029,23.83156,1561077
11796,MarkHerhold,3,0.00019,372032,23.83175,1561077
11797,markiewb,3,0.00019,372035,23.83194,1561077
11798,markmarkyesyes,3,0.00019,372038,23.83214,1561077
11799,MarkMulcahy,3,0.00019,372041,23.83233,1561077
11800,Markowy,3,0.00019,372044,23.83252,1561077
11801,MarkPreschern,3,0.00019,372047,23.83271,1561077
11802,marksumm,3,0.00019,372050,23.83291,1561077
11803,markus-franke,3,0.00019,372053,23.83310,1561077
11804,markusmo3,3,0.00019,372056,23.83329,1561077
11805,MarkusSchoelzel,3,0.00019,372059,23.83348,1561077
11806,marqaaron-armory,3,0.00019,372062,23.83367,1561077
11807,marquestiago,3,0.00019,372065,23.83387,1561077
11808,marrober,3,0.00019,372068,23.83406,1561077
11809,MarsianMan,3,0.00019,372071,23.83425,1561077
11810,marth8880,3,0.00019,372074,23.83444,1561077
11811,martin-brennan-csnet,3,0.00019,372077,23.83463,1561077
11812,MartinCon,3,0.00019,372080,23.83483,1561077
11813,MartinEmrich,3,0.00019,372083,23.83502,1561077
11814,martingith,3,0.00019,372086,23.83521,1561077
11815,MartinSGill,3,0.00019,372089,23.83540,1561077
11816,MartiUK,3,0.00019,372092,23.83560,1561077
11817,martygriffin,3,0.00019,372095,23.83579,1561077
11818,masanetes,3,0.00019,372098,23.83598,1561077
11819,masanorythm,3,0.00019,372101,23.83617,1561077
11820,mashby2022,3,0.00019,372104,23.83636,1561077
11821,maso7,3,0.00019,372107,23.83656,1561077
11822,masonse,3,0.00019,372110,23.83675,1561077
11823,master-nevi,3,0.00019,372113,23.83694,1561077
11824,matejkramny,3,0.00019,372116,23.83713,1561077
11825,matejzero,3,0.00019,372119,23.83733,1561077
11826,MateuszMysliwiec,3,0.00019,372122,23.83752,1561077
11827,mathiasi,3,0.00019,372125,23.83771,1561077
11828,matiasdecarli,3,0.00019,372128,23.83790,1561077
11829,matiasozdy,3,0.00019,372131,23.83809,1561077
11830,matsuu,3,0.00019,372134,23.83829,1561077
11831,matthew-devops,3,0.00019,372137,23.83848,1561077
11832,MatthewKohner,3,0.00019,372140,23.83867,1561077
11833,matthiaso,3,0.00019,372143,23.83886,1561077
11834,matthsmi,3,0.00019,372146,23.83905,1561077
11835,mattiasbpersson,3,0.00019,372149,23.83925,1561077
11836,MattRodler,3,0.00019,372152,23.83944,1561077
11837,mattydebie,3,0.00019,372155,23.83963,1561077
11838,maultosar,3,0.00019,372158,23.83982,1561077
11839,mauricioborges,3,0.00019,372161,23.84002,1561077
11840,maurycupitt,3,0.00019,372164,23.84021,1561077
11841,max464,3,0.00019,372167,23.84040,1561077
11842,maxep,3,0.00019,372170,23.84059,1561077
11843,maximilianriemensberger,3,0.00019,372173,23.84078,1561077
11844,maximilian-zollbrecht,3,0.00019,372176,23.84098,1561077
11845,maxres-fr,3,0.00019,372179,23.84117,1561077
11846,maxshine,3,0.00019,372182,23.84136,1561077
11847,mbaranczak,3,0.00019,372185,23.84155,1561077
11848,mbdevpl,3,0.00019,372188,23.84175,1561077
11849,mcalcote,3,0.00019,372191,23.84194,1561077
11850,mcaley,3,0.00019,372194,23.84213,1561077
11851,mcdonnell-john,3,0.00019,372197,23.84232,1561077
11852,mcorsillo-chwy,3,0.00019,372200,23.84251,1561077
11853,mc-zact,3,0.00019,372203,23.84271,1561077
11854,mdavis333,3,0.00019,372206,23.84290,1561077
11855,mdh69-github,3,0.00019,372209,23.84309,1561077
11856,meadsteve,3,0.00019,372212,23.84328,1561077
11857,meelistolk,3,0.00019,372215,23.84347,1561077
11858,meetmangukiya,3,0.00019,372218,23.84367,1561077
11859,MehranShafqat,3,0.00019,372221,23.84386,1561077
11860,meishaoyong,3,0.00019,372224,23.84405,1561077
11861,mengqing,3,0.00019,372227,23.84424,1561077
11862,mercuriete,3,0.00019,372230,23.84444,1561077
11863,mesolimbo,3,0.00019,372233,23.84463,1561077
11864,mevansam,3,0.00019,372236,23.84482,1561077
11865,mflm30,3,0.00019,372239,23.84501,1561077
11866,mgar,3,0.00019,372242,23.84520,1561077
11867,mgeary2,3,0.00019,372245,23.84540,1561077
11868,m-gendi,3,0.00019,372248,23.84559,1561077
11869,mgm-oss,3,0.00019,372251,23.84578,1561077
11870,mgor,3,0.00019,372254,23.84597,1561077
11871,mgummelt,3,0.00019,372257,23.84617,1561077
11872,MHacker9404,3,0.00019,372260,23.84636,1561077
11873,MHarris021,3,0.00019,372263,23.84655,1561077
11874,mhermosi,3,0.00019,372266,23.84674,1561077
11875,mhitza,3,0.00019,372269,23.84693,1561077
11876,mhughesbv,3,0.00019,372272,23.84713,1561077
11877,miago,3,0.00019,372275,23.84732,1561077
11878,miao1007,3,0.00019,372278,23.84751,1561077
11879,michaelbjames,3,0.00019,372281,23.84770,1561077
11880,michaelbra,3,0.00019,372284,23.84789,1561077
11881,michaelcusick,3,0.00019,372287,23.84809,1561077
11882,MichaelDBrown,3,0.00019,372290,23.84828,1561077
11883,michaelheyvaert,3,0.00019,372293,23.84847,1561077
11884,MichaelJKar,3,0.00019,372296,23.84866,1561077
11885,michaelmee,3,0.00019,372299,23.84886,1561077
11886,MichaelPereira,3,0.00019,372302,23.84905,1561077
11887,michaelpporter,3,0.00019,372305,23.84924,1561077
11888,michaelwiles,3,0.00019,372308,23.84943,1561077
11889,Michael-YuSha,3,0.00019,372311,23.84962,1561077
11890,MichaWiedenmann,3,0.00019,372314,23.84982,1561077
11891,michbeck100,3,0.00019,372317,23.85001,1561077
11892,micro-focus,3,0.00019,372320,23.85020,1561077
11893,midu-git,3,0.00019,372323,23.85039,1561077
11894,mietzen,3,0.00019,372326,23.85059,1561077
11895,migeorge,3,0.00019,372329,23.85078,1561077
11896,MiguelArroja,3,0.00019,372332,23.85097,1561077
11897,miguelaustro,3,0.00019,372335,23.85116,1561077
11898,mihaiplesa,3,0.00019,372338,23.85135,1561077
11899,mikashharia,3,0.00019,372341,23.85155,1561077
11900,mikelear,3,0.00019,372344,23.85174,1561077
11901,mikemead,3,0.00019,372347,23.85193,1561077
11902,mikemol,3,0.00019,372350,23.85212,1561077
11903,miketwenty1,3,0.00019,372353,23.85231,1561077
11904,mikeyeung123,3,0.00019,372356,23.85251,1561077
11905,MikhailTymchukDX,3,0.00019,372359,23.85270,1561077
11906,mikhailznak,3,0.00019,372362,23.85289,1561077
11907,mikjonsson,3,0.00019,372365,23.85308,1561077
11908,MikolajKakol,3,0.00019,372368,23.85328,1561077
11909,MilanRusev,3,0.00019,372371,23.85347,1561077
11910,milowg,3,0.00019,372374,23.85366,1561077
11911,ming9010,3,0.00019,372377,23.85385,1561077
11912,minzetao-tc,3,0.00019,372380,23.85404,1561077
11913,mirekphd,3,0.00019,372383,23.85424,1561077
11914,miro-balaz,3,0.00019,372386,23.85443,1561077
11915,Misho-98118,3,0.00019,372389,23.85462,1561077
11916,mislav,3,0.00019,372392,23.85481,1561077
11917,MisterChild,3,0.00019,372395,23.85501,1561077
11918,mistic,3,0.00019,372398,23.85520,1561077
11919,MitaliSa,3,0.00019,372401,23.85539,1561077
11920,mitchelladam,3,0.00019,372404,23.85558,1561077
11921,MitchTalmadge,3,0.00019,372407,23.85577,1561077
11922,Mixaill,3,0.00019,372410,23.85597,1561077
11923,mjmccormac,3,0.00019,372413,23.85616,1561077
11924,mjsobremonte,3,0.00019,372416,23.85635,1561077
11925,mkl262,3,0.00019,372419,23.85654,1561077
11926,mklinke,3,0.00019,372422,23.85673,1561077
11927,mknapcok,3,0.00019,372425,23.85693,1561077
11928,mknapik,3,0.00019,372428,23.85712,1561077
11929,mkroutikov,3,0.00019,372431,23.85731,1561077
11930,mlotfi2005,3,0.00019,372434,23.85750,1561077
11931,mluyo3414,3,0.00019,372437,23.85770,1561077
11932,mlynnyk,3,0.00019,372440,23.85789,1561077
11933,mmedum,3,0.00019,372443,23.85808,1561077
11934,mmoscher,3,0.00019,372446,23.85827,1561077
11935,mmreddy1582,3,0.00019,372449,23.85846,1561077
11936,mn7z,3,0.00019,372452,23.85866,1561077
11937,mobikop,3,0.00019,372455,23.85885,1561077
11938,mode19,3,0.00019,372458,23.85904,1561077
11939,moepi,3,0.00019,372461,23.85923,1561077
11940,moexu13,3,0.00019,372464,23.85943,1561077
11941,moh-abk,3,0.00019,372467,23.85962,1561077
11942,mohan08p,3,0.00019,372470,23.85981,1561077
11943,Mohitg06,3,0.00019,372473,23.86000,1561077
11944,molnare,3,0.00019,372476,23.86019,1561077
11945,molsky,3,0.00019,372479,23.86039,1561077
11946,momelod,3,0.00019,372482,23.86058,1561077
11947,momoneko,3,0.00019,372485,23.86077,1561077
11948,moorage,3,0.00019,372488,23.86096,1561077
11949,morbid98,3,0.00019,372491,23.86115,1561077
11950,morgankilgore,3,0.00019,372494,23.86135,1561077
11951,Morkxy,3,0.00019,372497,23.86154,1561077
11952,mo-saeed,3,0.00019,372500,23.86173,1561077
11953,moshie,3,0.00019,372503,23.86192,1561077
11954,mosieurlaurin,3,0.00019,372506,23.86212,1561077
11955,Mostafa-ashraf19,3,0.00019,372509,23.86231,1561077
11956,moszutij,3,0.00019,372512,23.86250,1561077
11957,moteesh-in2tive,3,0.00019,372515,23.86269,1561077
11958,mpantelimon,3,0.00019,372518,23.86288,1561077
11959,mpern,3,0.00019,372521,23.86308,1561077
11960,mpestritto,3,0.00019,372524,23.86327,1561077
11961,mpnico,3,0.00019,372527,23.86346,1561077
11962,mpptx,3,0.00019,372530,23.86365,1561077
11963,mpraeger,3,0.00019,372533,23.86385,1561077
11964,mr337,3,0.00019,372536,23.86404,1561077
11965,mratanji,3,0.00019,372539,23.86423,1561077
11966,mrbmd,3,0.00019,372542,23.86442,1561077
11967,MrBradricks,3,0.00019,372545,23.86461,1561077
11968,mrceresa,3,0.00019,372548,23.86481,1561077
11969,MrCreeperkopf,3,0.00019,372551,23.86500,1561077
11970,MrG00dkat,3,0.00019,372554,23.86519,1561077
11971,MrHassanMurtaza,3,0.00019,372557,23.86538,1561077
11972,mrishab,3,0.00019,372560,23.86557,1561077
11973,mrit,3,0.00019,372563,23.86577,1561077
11974,Mr-jiangzhiguo,3,0.00019,372566,23.86596,1561077
11975,mrkita,3,0.00019,372569,23.86615,1561077
11976,MrMania112,3,0.00019,372572,23.86634,1561077
11977,mrmastii,3,0.00019,372575,23.86654,1561077
11978,mrmaus,3,0.00019,372578,23.86673,1561077
11979,mr-remington,3,0.00019,372581,23.86692,1561077
11980,ms4pujari,3,0.00019,372584,23.86711,1561077
11981,msavy,3,0.00019,372587,23.86730,1561077
11982,mschroering,3,0.00019,372590,23.86750,1561077
11983,msdemt,3,0.00019,372593,23.86769,1561077
11984,msgongora,3,0.00019,372596,23.86788,1561077
11985,msheiny,3,0.00019,372599,23.86807,1561077
11986,mskadu,3,0.00019,372602,23.86827,1561077
11987,msmith9393,3,0.00019,372605,23.86846,1561077
11988,mspeers,3,0.00019,372608,23.86865,1561077
11989,mstantoncook,3,0.00019,372611,23.86884,1561077
11990,mstg,3,0.00019,372614,23.86903,1561077
11991,mstipanov,3,0.00019,372617,23.86923,1561077
11992,mstypinski,3,0.00019,372620,23.86942,1561077
11993,msylw,3,0.00019,372623,23.86961,1561077
11994,mthhs,3,0.00019,372626,23.86980,1561077
11995,mtoothman,3,0.00019,372629,23.86999,1561077
11996,mtwalsh,3,0.00019,372632,23.87019,1561077
11997,muanGC,3,0.00019,372635,23.87038,1561077
11998,muchnik,3,0.00019,372638,23.87057,1561077
11999,muczy,3,0.00019,372641,23.87076,1561077
12000,muhfuhcaw,3,0.00019,372644,23.87096,1561077
12001,mujx,3,0.00019,372647,23.87115,1561077
12002,mukul-kr,3,0.00019,372650,23.87134,1561077
12003,mulanshandi,3,0.00019,372653,23.87153,1561077
12004,Munchery-KleinLieu,3,0.00019,372656,23.87172,1561077
12005,mushycode,3,0.00019,372659,23.87192,1561077
12006,mustafic,3,0.00019,372662,23.87211,1561077
12007,muthenberg,3,0.00019,372665,23.87230,1561077
12008,mvalenzisi,3,0.00019,372668,23.87249,1561077
12009,mvillafuertem,3,0.00019,372671,23.87269,1561077
12010,mweiss427,3,0.00019,372674,23.87288,1561077
12011,myahl-uncomn,3,0.00019,372677,23.87307,1561077
12012,MychauU,3,0.00019,372680,23.87326,1561077
12013,myemir,3,0.00019,372683,23.87345,1561077
12014,myhau,3,0.00019,372686,23.87365,1561077
12015,MykhayloGnylorybov,3,0.00019,372689,23.87384,1561077
12016,myoss,3,0.00019,372692,23.87403,1561077
12017,mypark,3,0.00019,372695,23.87422,1561077
12018,Myrdrahl,3,0.00019,372698,23.87441,1561077
12019,mysticfall,3,0.00019,372701,23.87461,1561077
12020,Mythos,3,0.00019,372704,23.87480,1561077
12021,myxal,3,0.00019,372707,23.87499,1561077
12022,mzafir,3,0.00019,372710,23.87518,1561077
12023,mzagar,3,0.00019,372713,23.87538,1561077
12024,n1kl,3,0.00019,372716,23.87557,1561077
12025,n8felton,3,0.00019,372719,23.87576,1561077
12026,nabeelraja,3,0.00019,372722,23.87595,1561077
12027,nachevn,3,0.00019,372725,23.87614,1561077
12028,Nadav-Ruskin,3,0.00019,372728,23.87634,1561077
12029,nadirvishun,3,0.00019,372731,23.87653,1561077
12030,nael-fridhi,3,0.00019,372734,23.87672,1561077
12031,nafest,3,0.00019,372737,23.87691,1561077
12032,nafmo,3,0.00019,372740,23.87711,1561077
12033,NagarjunRepala,3,0.00019,372743,23.87730,1561077
12034,nagpalkaran95,3,0.00019,372746,23.87749,1561077
12035,NaranKPatel,3,0.00019,372749,23.87768,1561077
12036,Narrayahodeir,3,0.00019,372752,23.87787,1561077
12037,nathan818fr,3,0.00019,372755,23.87807,1561077
12038,nathan-v,3,0.00019,372758,23.87826,1561077
12039,NATHAP,3,0.00019,372761,23.87845,1561077
12040,nattymachado,3,0.00019,372764,23.87864,1561077
12041,Naveen-123snr,3,0.00019,372767,23.87883,1561077
12042,navinjoy,3,0.00019,372770,23.87903,1561077
12043,nayakmahesh,3,0.00019,372773,23.87922,1561077
12044,NBrunsch,3,0.00019,372776,23.87941,1561077
12045,ncreep,3,0.00019,372779,23.87960,1561077
12046,necipakca,3,0.00019,372782,23.87980,1561077
12047,nedbat,3,0.00019,372785,23.87999,1561077
12048,nediml,3,0.00019,372788,23.88018,1561077
12049,neeseius,3,0.00019,372791,23.88037,1561077
12050,neilmenon,3,0.00019,372794,23.88056,1561077
12051,nemacysts,3,0.00019,372797,23.88076,1561077
12052,nemothekid,3,0.00019,372800,23.88095,1561077
12053,nequid,3,0.00019,372803,23.88114,1561077
12054,NewbieProger,3,0.00019,372806,23.88133,1561077
12055,nguillaumin,3,0.00019,372809,23.88153,1561077
12056,Nguyendream,3,0.00019,372812,23.88172,1561077
12057,nguyenhugh,3,0.00019,372815,23.88191,1561077
12058,nguyenminh15988,3,0.00019,372818,23.88210,1561077
12059,ngwinghing,3,0.00019,372821,23.88229,1561077
12060,Nhattd97,3,0.00019,372824,23.88249,1561077
12061,nhomble,3,0.00019,372827,23.88268,1561077
12062,nhurel,3,0.00019,372830,23.88287,1561077
12063,NibinC,3,0.00019,372833,23.88306,1561077
12064,nickjacques,3,0.00019,372836,23.88325,1561077
12065,NiclasDaniels,3,0.00019,372839,23.88345,1561077
12066,nico-dangerous,3,0.00019,372842,23.88364,1561077
12067,nicoddemus,3,0.00019,372845,23.88383,1561077
12068,nicolasgramlich,3,0.00019,372848,23.88402,1561077
12069,nicolasr69,3,0.00019,372851,23.88422,1561077
12070,nightspotlight,3,0.00019,372854,23.88441,1561077
12071,nikhil-zinjurde-imgtec,3,0.00019,372857,23.88460,1561077
12072,nikki-quant,3,0.00019,372860,23.88479,1561077
12073,NikolasKomonen,3,0.00019,372863,23.88498,1561077
12074,nikstur,3,0.00019,372866,23.88518,1561077
12075,nilsotto,3,0.00019,372869,23.88537,1561077
12076,ninja-,3,0.00019,372872,23.88556,1561077
12077,ninjonxb,3,0.00019,372875,23.88575,1561077
12078,niQo,3,0.00019,372878,23.88595,1561077
12079,nishidayuya,3,0.00019,372881,23.88614,1561077
12080,nisLarry,3,0.00019,372884,23.88633,1561077
12081,nithinvithayathil,3,0.00019,372887,23.88652,1561077
12082,nitinneet23,3,0.00019,372890,23.88671,1561077
12083,njain51,3,0.00019,372893,23.88691,1561077
12084,njdart,3,0.00019,372896,23.88710,1561077
12085,nkumarom,3,0.00019,372899,23.88729,1561077
12086,nlebas,3,0.00019,372902,23.88748,1561077
12087,nmartinezb3,3,0.00019,372905,23.88767,1561077
12088,n-nachiappan,3,0.00019,372908,23.88787,1561077
12089,nnasaki,3,0.00019,372911,23.88806,1561077
12090,nnhiep,3,0.00019,372914,23.88825,1561077
12091,NoahMarconi,3,0.00019,372917,23.88844,1561077
12092,noelslice,3,0.00019,372920,23.88864,1561077
12093,nom3ad,3,0.00019,372923,23.88883,1561077
12094,nonleggouncazzo,3,0.00019,372926,23.88902,1561077
12095,nonotest,3,0.00019,372929,23.88921,1561077
12096,normAlaskari,3,0.00019,372932,23.88940,1561077
12097,Normo,3,0.00019,372935,23.88960,1561077
12098,noru,3,0.00019,372938,23.88979,1561077
12099,nova7665,3,0.00019,372941,23.88998,1561077
12100,noviceamateur,3,0.00019,372944,23.89017,1561077
12101,nowickjo,3,0.00019,372947,23.89037,1561077
12102,npatlola,3,0.00019,372950,23.89056,1561077
12103,npirotte,3,0.00019,372953,23.89075,1561077
12104,nrj-sh,3,0.00019,372956,23.89094,1561077
12105,nroose,3,0.00019,372959,23.89113,1561077
12106,ntamas,3,0.00019,372962,23.89133,1561077
12107,nthung82,3,0.00019,372965,23.89152,1561077
12108,nukarajusundeep,3,0.00019,372968,23.89171,1561077
12109,nwesoccer,3,0.00019,372971,23.89190,1561077
12110,nzakas,3,0.00019,372974,23.89210,1561077
12111,o4rz3l,3,0.00019,372977,23.89229,1561077
12112,obreitenbach,3,0.00019,372980,23.89248,1561077
12113,ocni-dtu,3,0.00019,372983,23.89267,1561077
12114,OdaDaisuke,3,0.00019,372986,23.89286,1561077
12115,odyhunter,3,0.00019,372989,23.89306,1561077
12116,oehmiche,3,0.00019,372992,23.89325,1561077
12117,ofalk,3,0.00019,372995,23.89344,1561077
12118,ofen,3,0.00019,372998,23.89363,1561077
12119,ofersadgat,3,0.00019,373001,23.89382,1561077
12120,oferzi23,3,0.00019,373004,23.89402,1561077
12121,offSwitch,3,0.00019,373007,23.89421,1561077
12122,oguzdag,3,0.00019,373010,23.89440,1561077
12123,ohhmm,3,0.00019,373013,23.89459,1561077
12124,ohmerhe,3,0.00019,373016,23.89479,1561077
12125,oh-rajendra,3,0.00019,373019,23.89498,1561077
12126,okidor,3,0.00019,373022,23.89517,1561077
12127,OLEGSHA,3,0.00019,373025,23.89536,1561077
12128,olegy2008,3,0.00019,373028,23.89555,1561077
12129,oleg-z,3,0.00019,373031,23.89575,1561077
12130,oleksandr-openweb,3,0.00019,373034,23.89594,1561077
12131,olevole,3,0.00019,373037,23.89613,1561077
12132,ollegz,3,0.00019,373040,23.89632,1561077
12133,ollie-troward,3,0.00019,373043,23.89652,1561077
12134,olnistratov,3,0.00019,373046,23.89671,1561077
12135,omar952,3,0.00019,373049,23.89690,1561077
12136,omer2500,3,0.00019,373052,23.89709,1561077
12137,omerExperitest,3,0.00019,373055,23.89728,1561077
12138,omerjacobi,3,0.00019,373058,23.89748,1561077
12139,onceking,3,0.00019,373061,23.89767,1561077
12140,ondrejbudai,3,0.00019,373064,23.89786,1561077
12141,ondrejtomcik,3,0.00019,373067,23.89805,1561077
12142,onfiro,3,0.00019,373070,23.89824,1561077
12143,onlyvitriol,3,0.00019,373073,23.89844,1561077
12144,oomk,3,0.00019,373076,23.89863,1561077
12145,opajonk,3,0.00019,373079,23.89882,1561077
12146,opedroso,3,0.00019,373082,23.89901,1561077
12147,openbravoRAL,3,0.00019,373085,23.89921,1561077
12148,opspy,3,0.00019,373088,23.89940,1561077
12149,opswatdemo,3,0.00019,373091,23.89959,1561077
12150,optimus-qa,3,0.00019,373094,23.89978,1561077
12151,oren-icx,3,0.00019,373097,23.89997,1561077
12152,orfeonomia,3,0.00019,373100,23.90017,1561077
12153,OriBenHur,3,0.00019,373103,23.90036,1561077
12154,Orygeunik,3,0.00019,373106,23.90055,1561077
12155,oscarAmarello,3,0.00019,373109,23.90074,1561077
12156,OscarRobertRodriguez,3,0.00019,373112,23.90094,1561077
12157,osechet,3,0.00019,373115,23.90113,1561077
12158,osi,3,0.00019,373118,23.90132,1561077
12159,osirisstar-hub,3,0.00019,373121,23.90151,1561077
12160,OSobky,3,0.00019,373124,23.90170,1561077
12161,ottojolanki,3,0.00019,373127,23.90190,1561077
12162,ouroboros8,3,0.00019,373130,23.90209,1561077
12163,overratedpro,3,0.00019,373133,23.90228,1561077
12164,ovevang,3,0.00019,373136,23.90247,1561077
12165,owenzhangzhengzhong,3,0.00019,373139,23.90266,1561077
12166,ox7a59,3,0.00019,373142,23.90286,1561077
12167,ozakharova,3,0.00019,373145,23.90305,1561077
12168,ozankasikci,3,0.00019,373148,23.90324,1561077
12169,ozdemirkan,3,0.00019,373151,23.90343,1561077
12170,ozgur,3,0.00019,373154,23.90363,1561077
12171,ozgurakan,3,0.00019,373157,23.90382,1561077
12172,p4sonika,3,0.00019,373160,23.90401,1561077
12173,p-8-z,3,0.00019,373163,23.90420,1561077
12174,paassdc,3,0.00019,373166,23.90439,1561077
12175,pablitoc,3,0.00019,373169,23.90459,1561077
12176,pabloa,3,0.00019,373172,23.90478,1561077
12177,pablog12,3,0.00019,373175,23.90497,1561077
12178,PabloVallejo,3,0.00019,373178,23.90516,1561077
12179,packar3k,3,0.00019,373181,23.90536,1561077
12180,packtpartner,3,0.00019,373184,23.90555,1561077
12181,paferdie,3,0.00019,373187,23.90574,1561077
12182,pagottoo,3,0.00019,373190,23.90593,1561077
12183,paiou,3,0.00019,373193,23.90612,1561077
12184,Pajk,3,0.00019,373196,23.90632,1561077
12185,PakkuDon,3,0.00019,373199,23.90651,1561077
12186,pankaj-dahiya,3,0.00019,373202,23.90670,1561077
12187,paolosystemx,3,0.00019,373205,23.90689,1561077
12188,papezt,3,0.00019,373208,23.90708,1561077
12189,paragchandra,3,0.00019,373211,23.90728,1561077
12190,paragrajput,3,0.00019,373214,23.90747,1561077
12191,parazyd,3,0.00019,373217,23.90766,1561077
12192,Parcley,3,0.00019,373220,23.90785,1561077
12193,paride,3,0.00019,373223,23.90805,1561077
12194,paruff,3,0.00019,373226,23.90824,1561077
12195,pascal-eberhard,3,0.00019,373229,23.90843,1561077
12196,Pastel001,3,0.00019,373232,23.90862,1561077
12197,patmizi,3,0.00019,373235,23.90881,1561077
12198,patrick-hallinan,3,0.00019,373238,23.90901,1561077
12199,patrickjamesbarry,3,0.00019,373241,23.90920,1561077
12200,PatrickRUG,3,0.00019,373244,23.90939,1561077
12201,PattaFeuFeu,3,0.00019,373247,23.90958,1561077
12202,PaulFang,3,0.00019,373250,23.90978,1561077
12203,pauliemcg,3,0.00019,373253,23.90997,1561077
12204,pauloantunes001,3,0.00019,373256,23.91016,1561077
12205,Paulomart,3,0.00019,373259,23.91035,1561077
12206,pault1337,3,0.00019,373262,23.91054,1561077
12207,Pauss,3,0.00019,373265,23.91074,1561077
12208,PavelKondratiev,3,0.00019,373268,23.91093,1561077
12209,pavelsavara,3,0.00019,373271,23.91112,1561077
12210,pawelkopka,3,0.00019,373274,23.91131,1561077
12211,pazoozooCH,3,0.00019,373277,23.91150,1561077
12212,paz-raon,3,0.00019,373280,23.91170,1561077
12213,pbasov,3,0.00019,373283,23.91189,1561077
12214,pBogey,3,0.00019,373286,23.91208,1561077
12215,pbrzica,3,0.00019,373289,23.91227,1561077
12216,pcarenza,3,0.00019,373292,23.91247,1561077
12217,pcaronde,3,0.00019,373295,23.91266,1561077
12218,pc-cworkman,3,0.00019,373298,23.91285,1561077
12219,pcooke2002,3,0.00019,373301,23.91304,1561077
12220,pdaw,3,0.00019,373304,23.91323,1561077
12221,pdiaz85,3,0.00019,373307,23.91343,1561077
12222,pdomineaux,3,0.00019,373310,23.91362,1561077
12223,pdsouza,3,0.00019,373313,23.91381,1561077
12224,pedropena,3,0.00019,373316,23.91400,1561077
12225,peetereczek,3,0.00019,373319,23.91420,1561077
12226,PerStirpes,3,0.00019,373322,23.91439,1561077
12227,peterjanes,3,0.00019,373325,23.91458,1561077
12228,peter-kutak,3,0.00019,373328,23.91477,1561077
12229,petermartin2002,3,0.00019,373331,23.91496,1561077
12230,petermcneely,3,0.00019,373334,23.91516,1561077
12231,petersonwsantos,3,0.00019,373337,23.91535,1561077
12232,petervdm,3,0.00019,373340,23.91554,1561077
12233,peteski22,3,0.00019,373343,23.91573,1561077
12234,petreboy14,3,0.00019,373346,23.91592,1561077
12235,petr-tichy,3,0.00019,373349,23.91612,1561077
12236,pfallclear,3,0.00019,373352,23.91631,1561077
12237,pgandarillas,3,0.00019,373355,23.91650,1561077
12238,pgermosen,3,0.00019,373358,23.91669,1561077
12239,pgieniec5tar,3,0.00019,373361,23.91689,1561077
12240,phanikumarmss,3,0.00019,373364,23.91708,1561077
12241,phaniops,3,0.00019,373367,23.91727,1561077
12242,phao5814,3,0.00019,373370,23.91746,1561077
12243,phatblat,3,0.00019,373373,23.91765,1561077
12244,phaza,3,0.00019,373376,23.91785,1561077
12245,philipwhiuk,3,0.00019,373379,23.91804,1561077
12246,phillanderson,3,0.00019,373382,23.91823,1561077
12247,philpowers,3,0.00019,373385,23.91842,1561077
12248,phlo-c,3,0.00019,373388,23.91862,1561077
12249,phonique,3,0.00019,373391,23.91881,1561077
12250,phootip,3,0.00019,373394,23.91900,1561077
12251,phylee,3,0.00019,373397,23.91919,1561077
12252,pierre-verhaeghe,3,0.00019,373400,23.91938,1561077
12253,pill663,3,0.00019,373403,23.91958,1561077
12254,pingdpk,3,0.00019,373406,23.91977,1561077
12255,pioneerlabs,3,0.00019,373409,23.91996,1561077
12256,pioto,3,0.00019,373412,23.92015,1561077
12257,PiotrBaran1010,3,0.00019,373415,23.92034,1561077
12258,Piping,3,0.00019,373418,23.92054,1561077
12259,Pisush,3,0.00019,373421,23.92073,1561077
12260,pitzqa,3,0.00019,373424,23.92092,1561077
12261,pivotalbuildguy,3,0.00019,373427,23.92111,1561077
12262,pjnkumar,3,0.00019,373430,23.92131,1561077
12263,pjwiseman,3,0.00019,373433,23.92150,1561077
12264,pkahn-zscaler,3,0.00019,373436,23.92169,1561077
12265,PKBeam,3,0.00019,373439,23.92188,1561077
12266,plaa,3,0.00019,373442,23.92207,1561077
12267,plateaukao,3,0.00019,373445,23.92227,1561077
12268,pli01,3,0.00019,373448,23.92246,1561077
12269,ploutarchos,3,0.00019,373451,23.92265,1561077
12270,plutino,3,0.00019,373454,23.92284,1561077
12271,pmmarq,3,0.00019,373457,23.92304,1561077
12272,pmprasad,3,0.00019,373460,23.92323,1561077
12273,pmyakishev,3,0.00019,373463,23.92342,1561077
12274,pnambicsystems,3,0.00019,373466,23.92361,1561077
12275,pndurette,3,0.00019,373469,23.92380,1561077
12276,podlech,3,0.00019,373472,23.92400,1561077
12277,poinu,3,0.00019,373475,23.92419,1561077
12278,polyanskyiow,3,0.00019,373478,23.92438,1561077
12279,polygon,3,0.00019,373481,23.92457,1561077
12280,pongells,3,0.00019,373484,23.92476,1561077
12281,ponsuyambu,3,0.00019,373487,23.92496,1561077
12282,pontuslaestadius,3,0.00019,373490,23.92515,1561077
12283,pooja1889,3,0.00019,373493,23.92534,1561077
12284,PoorImpulseCtrl,3,0.00019,373496,23.92553,1561077
12285,PorkchopDonut,3,0.00019,373499,23.92573,1561077
12286,postscripter8,3,0.00019,373502,23.92592,1561077
12287,PrabhashaniMohotti,3,0.00019,373505,23.92611,1561077
12288,prabhuinbarajan,3,0.00019,373508,23.92630,1561077
12289,Pranav-b-7,3,0.00019,373511,23.92649,1561077
12290,prasad12k,3,0.00019,373514,23.92669,1561077
12291,Prasannajnaeyulu,3,0.00019,373517,23.92688,1561077
12292,prashant-ee,3,0.00019,373520,23.92707,1561077
12293,praveenkthakur,3,0.00019,373523,23.92726,1561077
12294,prediktorn,3,0.00019,373526,23.92746,1561077
12295,Primer42,3,0.00019,373529,23.92765,1561077
12296,profanand,3,0.00019,373532,23.92784,1561077
12297,ProFiction,3,0.00019,373535,23.92803,1561077
12298,Proksima,3,0.00019,373538,23.92822,1561077
12299,pronovic,3,0.00019,373541,23.92842,1561077
12300,protectedMan,3,0.00019,373544,23.92861,1561077
12301,pscherz,3,0.00019,373547,23.92880,1561077
12302,pschildkamp,3,0.00019,373550,23.92899,1561077
12303,pschlan,3,0.00019,373553,23.92918,1561077
12304,pshipton,3,0.00019,373556,23.92938,1561077
12305,psung,3,0.00019,373559,23.92957,1561077
12306,pszittyay,3,0.00019,373562,23.92976,1561077
12307,pszubiak,3,0.00019,373565,23.92995,1561077
12308,ptemplier,3,0.00019,373568,23.93015,1561077
12309,ptinsley,3,0.00019,373571,23.93034,1561077
12310,ptr-dang,3,0.00019,373574,23.93053,1561077
12311,puneet-kr-sh,3,0.00019,373577,23.93072,1561077
12312,pure-marcmac,3,0.00019,373580,23.93091,1561077
12313,puremourning,3,0.00019,373583,23.93111,1561077
12314,pvolkemer,3,0.00019,373586,23.93130,1561077
12315,pvshewale,3,0.00019,373589,23.93149,1561077
12316,pwfraley,3,0.00019,373592,23.93168,1561077
12317,pxk5958,3,0.00019,373595,23.93188,1561077
12318,pypingou,3,0.00019,373598,23.93207,1561077
12319,Qasim-Aziz,3,0.00019,373601,23.93226,1561077
12320,QATew,3,0.00019,373604,23.93245,1561077
12321,qauff,3,0.00019,373607,23.93264,1561077
12322,qc2105,3,0.00019,373610,23.93284,1561077
12323,qhartman,3,0.00019,373613,23.93303,1561077
12324,qianxuanyon,3,0.00019,373616,23.93322,1561077
12325,qibobo,3,0.00019,373619,23.93341,1561077
12326,qingchen666,3,0.00019,373622,23.93360,1561077
12327,qisylvia,3,0.00019,373625,23.93380,1561077
12328,qmcyruss,3,0.00019,373628,23.93399,1561077
12329,qper,3,0.00019,373631,23.93418,1561077
12330,qsricardosevero,3,0.00019,373634,23.93437,1561077
12331,qv-8942,3,0.00019,373637,23.93457,1561077
12332,raags,3,0.00019,373640,23.93476,1561077
12333,racktear,3,0.00019,373643,23.93495,1561077
12334,radepal,3,0.00019,373646,23.93514,1561077
12335,radhaprathyusha5,3,0.00019,373649,23.93533,1561077
12336,Radicis,3,0.00019,373652,23.93553,1561077
12337,rafaborrego,3,0.00019,373655,23.93572,1561077
12338,rafael-anachoreta,3,0.00019,373658,23.93591,1561077
12339,rafaelcalleja,3,0.00019,373661,23.93610,1561077
12340,rafaelpolo19,3,0.00019,373664,23.93630,1561077
12341,RafalMaleska,3,0.00019,373667,23.93649,1561077
12342,rafeeqpv,3,0.00019,373670,23.93668,1561077
12343,raffaeleguidi,3,0.00019,373673,23.93687,1561077
12344,raffazizzi,3,0.00019,373676,23.93706,1561077
12345,raffian,3,0.00019,373679,23.93726,1561077
12346,raghawendram,3,0.00019,373682,23.93745,1561077
12347,raghu-007,3,0.00019,373685,23.93764,1561077
12348,rah-gupta,3,0.00019,373688,23.93783,1561077
12349,rahulr56,3,0.00019,373691,23.93802,1561077
12350,RahulSurwade08,3,0.00019,373694,23.93822,1561077
12351,raistlin,3,0.00019,373697,23.93841,1561077
12352,rajameka86,3,0.00019,373700,23.93860,1561077
12353,rajasaur,3,0.00019,373703,23.93879,1561077
12354,rajasekaran07,3,0.00019,373706,23.93899,1561077
12355,RajaThumati99,3,0.00019,373709,23.93918,1561077
12356,rajatjindal83,3,0.00019,373712,23.93937,1561077
12357,rajatrj16,3,0.00019,373715,23.93956,1561077
12358,Rajendraladkat1919,3,0.00019,373718,23.93975,1561077
12359,rajesh2887,3,0.00019,373721,23.93995,1561077
12360,rajvimalc,3,0.00019,373724,23.94014,1561077
12361,raksit31667,3,0.00019,373727,23.94033,1561077
12362,ralphnuessecpwr,3,0.00019,373730,23.94052,1561077
12363,Ramakrishna-Mandepudi,3,0.00019,373733,23.94072,1561077
12364,ramarahul,3,0.00019,373736,23.94091,1561077
12365,ramizrshaik,3,0.00019,373739,23.94110,1561077
12366,ramysiha,3,0.00019,373742,23.94129,1561077
12367,raniejade,3,0.00019,373745,23.94148,1561077
12368,ranyan713,3,0.00019,373748,23.94168,1561077
12369,rapkalya,3,0.00019,373751,23.94187,1561077
12370,RasmusVoss,3,0.00019,373754,23.94206,1561077
12371,RationalMonster,3,0.00019,373757,23.94225,1561077
12372,rauset,3,0.00019,373760,23.94244,1561077
12373,Raushansingh184,3,0.00019,373763,23.94264,1561077
12374,RaviChandraVeeramachaneni,3,0.00019,373766,23.94283,1561077
12375,ravirajbhatt,3,0.00019,373769,23.94302,1561077
12376,ravisalamani,3,0.00019,373772,23.94321,1561077
12377,raydouglass,3,0.00019,373775,23.94341,1561077
12378,raymondhoagland,3,0.00019,373778,23.94360,1561077
12379,rbabyuk,3,0.00019,373781,23.94379,1561077
12380,rbankole,3,0.00019,373784,23.94398,1561077
12381,Rbcum,3,0.00019,373787,23.94417,1561077
12382,rbellamy,3,0.00019,373790,23.94437,1561077
12383,rb-john,3,0.00019,373793,23.94456,1561077
12384,rboergertenable,3,0.00019,373796,23.94475,1561077
12385,rbreslin18,3,0.00019,373799,23.94494,1561077
12386,rbri,3,0.00019,373802,23.94514,1561077
12387,rcarrette,3,0.00019,373805,23.94533,1561077
12388,rcbop,3,0.00019,373808,23.94552,1561077
12389,rchekaluk,3,0.00019,373811,23.94571,1561077
12390,rdagum,3,0.00019,373814,23.94590,1561077
12391,rdickey,3,0.00019,373817,23.94610,1561077
12392,reach2ravikumarp,3,0.00019,373820,23.94629,1561077
12393,readonlyuser1,3,0.00019,373823,23.94648,1561077
12394,realitix,3,0.00019,373826,23.94667,1561077
12395,rebecamaheo,3,0.00019,373829,23.94686,1561077
12396,reckless-huang,3,0.00019,373832,23.94706,1561077
12397,RedMu,3,0.00019,373835,23.94725,1561077
12398,redsil,3,0.00019,373838,23.94744,1561077
12399,redthor,3,0.00019,373841,23.94763,1561077
12400,refortin,3,0.00019,373844,23.94783,1561077
12401,rekathiru,3,0.00019,373847,23.94802,1561077
12402,RemiCardona,3,0.00019,373850,23.94821,1561077
12403,renjujv,3,0.00019,373853,23.94840,1561077
12404,renlong567,3,0.00019,373856,23.94859,1561077
12405,renpra1803,3,0.00019,373859,23.94879,1561077
12406,RevBits,3,0.00019,373862,23.94898,1561077
12407,ReyhanPatria,3,0.00019,373865,23.94917,1561077
12408,rgumus,3,0.00019,373868,23.94936,1561077
12409,rherrad,3,0.00019,373871,23.94956,1561077
12410,rhys-rantmedia,3,0.00019,373874,23.94975,1561077
12411,RiceBowlJr,3,0.00019,373877,23.94994,1561077
12412,ricemery,3,0.00019,373880,23.95013,1561077
12413,richardallred,3,0.00019,373883,23.95032,1561077
12414,richard-fine,3,0.00019,373886,23.95052,1561077
12415,richardjq,3,0.00019,373889,23.95071,1561077
12416,ricmatsui,3,0.00019,373892,23.95090,1561077
12417,rihtak06,3,0.00019,373895,23.95109,1561077
12418,rinkypandya,3,0.00019,373898,23.95128,1561077
12419,rionam,3,0.00019,373901,23.95148,1561077
12420,ripper2hl,3,0.00019,373904,23.95167,1561077
12421,rismoney,3,0.00019,373907,23.95186,1561077
12422,rjaiwal5139,3,0.00019,373910,23.95205,1561077
12423,rjes,3,0.00019,373913,23.95225,1561077
12424,rjtch,3,0.00019,373916,23.95244,1561077
12425,rkadle,3,0.00019,373919,23.95263,1561077
12426,rmathure,3,0.00019,373922,23.95282,1561077
12427,rmeffan,3,0.00019,373925,23.95301,1561077
12428,rmisra1234,3,0.00019,373928,23.95321,1561077
12429,rngcntr,3,0.00019,373931,23.95340,1561077
12430,roastario,3,0.00019,373934,23.95359,1561077
12431,robbinscp,3,0.00019,373937,23.95378,1561077
12432,robcalcroft,3,0.00019,373940,23.95398,1561077
12433,robert14-els,3,0.00019,373943,23.95417,1561077
12434,robertdolca,3,0.00019,373946,23.95436,1561077
12435,robervexcel,3,0.00019,373949,23.95455,1561077
12436,Robinfr,3,0.00019,373952,23.95474,1561077
12437,robinfriedli,3,0.00019,373955,23.95494,1561077
12438,robingustafsson,3,0.00019,373958,23.95513,1561077
12439,robodair,3,0.00019,373961,23.95532,1561077
12440,robot9xvt,3,0.00019,373964,23.95551,1561077
12441,robvelor,3,0.00019,373967,23.95570,1561077
12442,rocket-consulting,3,0.00019,373970,23.95590,1561077
12443,rockheadjr,3,0.00019,373973,23.95609,1561077
12444,rodlogic,3,0.00019,373976,23.95628,1561077
12445,rodrigogq,3,0.00019,373979,23.95647,1561077
12446,Roesh,3,0.00019,373982,23.95667,1561077
12447,roger104,3,0.00019,373985,23.95686,1561077
12448,rogerfc,3,0.00019,373988,23.95705,1561077
12449,roicostas,3,0.00019,373991,23.95724,1561077
12450,roiros,3,0.00019,373994,23.95743,1561077
12451,rokx,3,0.00019,373997,23.95763,1561077
12452,RolandBurrows,3,0.00019,374000,23.95782,1561077
12453,rolandoldengarm,3,0.00019,374003,23.95801,1561077
12454,romancin,3,0.00019,374006,23.95820,1561077
12455,RomanIsko,3,0.00019,374009,23.95840,1561077
12456,RomanR-dev,3,0.00019,374012,23.95859,1561077
12457,romansky,3,0.00019,374015,23.95878,1561077
12458,RomanTheLegend,3,0.00019,374018,23.95897,1561077
12459,romuald,3,0.00019,374021,23.95916,1561077
12460,romvdms,3,0.00019,374024,23.95936,1561077
12461,rong280,3,0.00019,374027,23.95955,1561077
12462,ron-k,3,0.00019,374030,23.95974,1561077
12463,ronny-stauffer,3,0.00019,374033,23.95993,1561077
12464,roryblucky,3,0.00019,374036,23.96012,1561077
12465,rosca,3,0.00019,374039,23.96032,1561077
12466,roshnij7,3,0.00019,374042,23.96051,1561077
12467,Rossbro2,3,0.00019,374045,23.96070,1561077
12468,rostskadat,3,0.00019,374048,23.96089,1561077
12469,rotem925,3,0.00019,374051,23.96109,1561077
12470,rotorsolutions,3,0.00019,374054,23.96128,1561077
12471,roxana-muresan,3,0.00019,374057,23.96147,1561077
12472,Roy542,3,0.00019,374060,23.96166,1561077
12473,rozboris,3,0.00019,374063,23.96185,1561077
12474,rpassis,3,0.00019,374066,23.96205,1561077
12475,rpdedeus,3,0.00019,374069,23.96224,1561077
12476,rpeinadorgz,3,0.00019,374072,23.96243,1561077
12477,rpetrano,3,0.00019,374075,23.96262,1561077
12478,rpkim,3,0.00019,374078,23.96282,1561077
12479,rranjith406,3,0.00019,374081,23.96301,1561077
12480,rrjjvv,3,0.00019,374084,23.96320,1561077
12481,rrpari,3,0.00019,374087,23.96339,1561077
12482,rtack,3,0.00019,374090,23.96358,1561077
12483,rtayek,3,0.00019,374093,23.96378,1561077
12484,rtward,3,0.00019,374096,23.96397,1561077
12485,Rubenmp,3,0.00019,374099,23.96416,1561077
12486,RubenNL,3,0.00019,374102,23.96435,1561077
12487,rublevma,3,0.00019,374105,23.96454,1561077
12488,rubroboletus,3,0.00019,374108,23.96474,1561077
12489,rudopeters,3,0.00019,374111,23.96493,1561077
12490,ruschecker,3,0.00019,374114,23.96512,1561077
12491,rushdi,3,0.00019,374117,23.96531,1561077
12492,ruslan-k,3,0.00019,374120,23.96551,1561077
12493,rustyscottweber,3,0.00019,374123,23.96570,1561077
12494,ruudjutinant,3,0.00019,374126,23.96589,1561077
12495,r-work,3,0.00019,374129,23.96608,1561077
12496,rxf1234,3,0.00019,374132,23.96627,1561077
12497,ryaeng,3,0.00019,374135,23.96647,1561077
12498,ryandavis84,3,0.00019,374138,23.96666,1561077
12499,ryanivanka,3,0.00019,374141,23.96685,1561077
12500,ryankelly7391,3,0.00019,374144,23.96704,1561077
12501,ryanneufeld,3,0.00019,374147,23.96724,1561077
12502,ryan-summers,3,0.00019,374150,23.96743,1561077
12503,ryanwscott,3,0.00019,374153,23.96762,1561077
12504,s17t,3,0.00019,374156,23.96781,1561077
12505,s7an-it,3,0.00019,374159,23.96800,1561077
12506,saadmufti,3,0.00019,374162,23.96820,1561077
12507,saar1290,3,0.00019,374165,23.96839,1561077
12508,sabf81,3,0.00019,374168,23.96858,1561077
12509,sadok-f,3,0.00019,374171,23.96877,1561077
12510,SaffatHasan,3,0.00019,374174,23.96897,1561077
12511,sagaraspl,3,0.00019,374177,23.96916,1561077
12512,sagarkhushalani,3,0.00019,374180,23.96935,1561077
12513,sagarwanave1,3,0.00019,374183,23.96954,1561077
12514,saggl,3,0.00019,374186,23.96973,1561077
12515,saheerb,3,0.00019,374189,23.96993,1561077
12516,saimad,3,0.00019,374192,23.97012,1561077
12517,Saint762,3,0.00019,374195,23.97031,1561077
12518,saintzyo,3,0.00019,374198,23.97050,1561077
12519,sai-tej,3,0.00019,374201,23.97069,1561077
12520,sa-jbrooks,3,0.00019,374204,23.97089,1561077
12521,sakthi-dp2,3,0.00019,374207,23.97108,1561077
12522,salmaanrizvi,3,0.00019,374210,23.97127,1561077
12523,salomatu,3,0.00019,374213,23.97146,1561077
12524,sambernet,3,0.00019,374216,23.97166,1561077
12525,sambit15k,3,0.00019,374219,23.97185,1561077
12526,sameronline,3,0.00019,374222,23.97204,1561077
12527,samgd,3,0.00019,374225,23.97223,1561077
12528,samhrncir,3,0.00019,374228,23.97242,1561077
12529,sami9gag,3,0.00019,374231,23.97262,1561077
12530,samirtahir91,3,0.00019,374234,23.97281,1561077
12531,sampritavh,3,0.00019,374237,23.97300,1561077
12532,sampsonliao,3,0.00019,374240,23.97319,1561077
12533,Samseppiol,3,0.00019,374243,23.97339,1561077
12534,samuele-locatelli,3,0.00019,374246,23.97358,1561077
12535,samuelson,3,0.00019,374249,23.97377,1561077
12536,samwar,3,0.00019,374252,23.97396,1561077
12537,samwhite2,3,0.00019,374255,23.97415,1561077
12538,sandarenu,3,0.00019,374258,23.97435,1561077
12539,sandeep000,3,0.00019,374261,23.97454,1561077
12540,sandyscoffable,3,0.00019,374264,23.97473,1561077
12541,sanga,3,0.00019,374267,23.97492,1561077
12542,sanjeevgiri,3,0.00019,374270,23.97511,1561077
12543,sanjog152,3,0.00019,374273,23.97531,1561077
12544,santhu3064,3,0.00019,374276,23.97550,1561077
12545,SantoshKumarA,3,0.00019,374279,23.97569,1561077
12546,saperal,3,0.00019,374282,23.97588,1561077
12547,saretter,3,0.00019,374285,23.97608,1561077
12548,sarthak1996,3,0.00019,374288,23.97627,1561077
12549,sashashura,3,0.00019,374291,23.97646,1561077
12550,satwikabea,3,0.00019,374294,23.97665,1561077
12551,satyasreem,3,0.00019,374297,23.97684,1561077
12552,Sayanta66,3,0.00019,374300,23.97704,1561077
12553,Sayo-gs,3,0.00019,374303,23.97723,1561077
12554,sbaeurle,3,0.00019,374306,23.97742,1561077
12555,sbateman-fitbit,3,0.00019,374309,23.97761,1561077
12556,sbilinski,3,0.00019,374312,23.97781,1561077
12557,sbourlon,3,0.00019,374315,23.97800,1561077
12558,sbusetty-rythmos,3,0.00019,374318,23.97819,1561077
12559,scbunn,3,0.00019,374321,23.97838,1561077
12560,schizofreindly,3,0.00019,374324,23.97857,1561077
12561,schlauch,3,0.00019,374327,23.97877,1561077
12562,schmoli,3,0.00019,374330,23.97896,1561077
12563,schraal,3,0.00019,374333,23.97915,1561077
12564,schwjm,3,0.00019,374336,23.97934,1561077
12565,SciMan72,3,0.00019,374339,23.97953,1561077
12566,scniro,3,0.00019,374342,23.97973,1561077
12567,scorpionlion,3,0.00019,374345,23.97992,1561077
12568,scottdweber,3,0.00019,374348,23.98011,1561077
12569,SealinRepo,3,0.00019,374351,23.98030,1561077
12570,sean-abbott,3,0.00019,374354,23.98050,1561077
12571,seanenright,3,0.00019,374357,23.98069,1561077
12572,seanguo,3,0.00019,374360,23.98088,1561077
12573,seanjfellows,3,0.00019,374363,23.98107,1561077
12574,seanmckinley,3,0.00019,374366,23.98126,1561077
12575,sebasrobert,3,0.00019,374369,23.98146,1561077
12576,sebastiangaiser,3,0.00019,374372,23.98165,1561077
12577,sebastianhaeni,3,0.00019,374375,23.98184,1561077
12578,sebastianroming,3,0.00019,374378,23.98203,1561077
12579,sebbonnet,3,0.00019,374381,23.98223,1561077
12580,sebhopley,3,0.00019,374384,23.98242,1561077
12581,sebi-hgdata,3,0.00019,374387,23.98261,1561077
12582,sebthom,3,0.00019,374390,23.98280,1561077
12583,seidler2547,3,0.00019,374393,23.98299,1561077
12584,selmakna,3,0.00019,374396,23.98319,1561077
12585,selvakumar7991,3,0.00019,374399,23.98338,1561077
12586,semenmiroshnichenko,3,0.00019,374402,23.98357,1561077
12587,sendil-d,3,0.00019,374405,23.98376,1561077
12588,Senorsen,3,0.00019,374408,23.98395,1561077
12589,sensesnet,3,0.00019,374411,23.98415,1561077
12590,sentient,3,0.00019,374414,23.98434,1561077
12591,SeoKingSite,3,0.00019,374417,23.98453,1561077
12592,seqizz,3,0.00019,374420,23.98472,1561077
12593,serafss2,3,0.00019,374423,23.98492,1561077
12594,sercanacar,3,0.00019,374426,23.98511,1561077
12595,sergio-tarazona,3,0.00019,374429,23.98530,1561077
12596,serjche,3,0.00019,374432,23.98549,1561077
12597,seubert,3,0.00019,374435,23.98568,1561077
12598,sevensoft,3,0.00019,374438,23.98588,1561077
12599,sevoman-fbc,3,0.00019,374441,23.98607,1561077
12600,sfc-gh-dschumann,3,0.00019,374444,23.98626,1561077
12601,sfosterdw,3,0.00019,374447,23.98645,1561077
12602,sgithubs,3,0.00019,374450,23.98665,1561077
12603,sgmac,3,0.00019,374453,23.98684,1561077
12604,sgnewson,3,0.00019,374456,23.98703,1561077
12605,sgredell,3,0.00019,374459,23.98722,1561077
12606,sg-sehattersley,3,0.00019,374462,23.98741,1561077
12607,shadowmimosa,3,0.00019,374465,23.98761,1561077
12608,shadowXVll,3,0.00019,374468,23.98780,1561077
12609,shaharl-ia,3,0.00019,374471,23.98799,1561077
12610,shaileshrathod1811,3,0.00019,374474,23.98818,1561077
12611,shaiton,3,0.00019,374477,23.98837,1561077
12612,shaneargo,3,0.00019,374480,23.98857,1561077
12613,shanethehat,3,0.00019,374483,23.98876,1561077
12614,shankarapailoor,3,0.00019,374486,23.98895,1561077
12615,ShankarSumanth,3,0.00019,374489,23.98914,1561077
12616,shanx,3,0.00019,374492,23.98934,1561077
12617,sharadJay,3,0.00019,374495,23.98953,1561077
12618,sharatsathyanarayan,3,0.00019,374498,23.98972,1561077
12619,sharly2012,3,0.00019,374501,23.98991,1561077
12620,sharpSteff,3,0.00019,374504,23.99010,1561077
12621,shat00n,3,0.00019,374507,23.99030,1561077
12622,ShaulTransmit,3,0.00019,374510,23.99049,1561077
12623,shawnallen85,3,0.00019,374513,23.99068,1561077
12624,shawnda761,3,0.00019,374516,23.99087,1561077
12625,shawngmc,3,0.00019,374519,23.99107,1561077
12626,shawnhines,3,0.00019,374522,23.99126,1561077
12627,shcallaway,3,0.00019,374525,23.99145,1561077
12628,sheet-p,3,0.00019,374528,23.99164,1561077
12629,shekharhimanshu,3,0.00019,374531,23.99183,1561077
12630,shencan,3,0.00019,374534,23.99203,1561077
12631,shichanson,3,0.00019,374537,23.99222,1561077
12632,shieldwed,3,0.00019,374540,23.99241,1561077
12633,shirouto,3,0.00019,374543,23.99260,1561077
12634,shivalish,3,0.00019,374546,23.99279,1561077
12635,ShivamPokhriyal,3,0.00019,374549,23.99299,1561077
12636,shivam-Purohit,3,0.00019,374552,23.99318,1561077
12637,shivamsood,3,0.00019,374555,23.99337,1561077
12638,ShiZhenzhong,3,0.00019,374558,23.99356,1561077
12639,shizn,3,0.00019,374561,23.99376,1561077
12640,shlomif,3,0.00019,374564,23.99395,1561077
12641,shoelzle,3,0.00019,374567,23.99414,1561077
12642,shouko,3,0.00019,374570,23.99433,1561077
12643,showaid,3,0.00019,374573,23.99452,1561077
12644,shravanrai,3,0.00019,374576,23.99472,1561077
12645,shryta234,3,0.00019,374579,23.99491,1561077
12646,shssoichiro,3,0.00019,374582,23.99510,1561077
12647,shtraker,3,0.00019,374585,23.99529,1561077
12648,shyingsheng,3,0.00019,374588,23.99549,1561077
12649,sickyoon,3,0.00019,374591,23.99568,1561077
12650,sicrossley,3,0.00019,374594,23.99587,1561077
12651,siddhi,3,0.00019,374597,23.99606,1561077
12652,SierraGolf,3,0.00019,374600,23.99625,1561077
12653,silva96,3,0.00019,374603,23.99645,1561077
12654,simkam,3,0.00019,374606,23.99664,1561077
12655,simonabateman,3,0.00019,374609,23.99683,1561077
12656,SimonKienzler,3,0.00019,374612,23.99702,1561077
12657,simonlaw0711,3,0.00019,374615,23.99721,1561077
12658,SimonMuraya,3,0.00019,374618,23.99741,1561077
12659,SimonWaldherr,3,0.00019,374621,23.99760,1561077
12660,simon-weber,3,0.00019,374624,23.99779,1561077
12661,simzacks,3,0.00019,374627,23.99798,1561077
12662,singhm1994,3,0.00019,374630,23.99818,1561077
12663,siorellana,3,0.00019,374633,23.99837,1561077
12664,Siriah,3,0.00019,374636,23.99856,1561077
12665,SirNeo,3,0.00019,374639,23.99875,1561077
12666,sitUboo,3,0.00019,374642,23.99894,1561077
12667,sivajangam,3,0.00019,374645,23.99914,1561077
12668,sivapillai,3,0.00019,374648,23.99933,1561077
12669,sivaprf,3,0.00019,374651,23.99952,1561077
12670,sivunestori,3,0.00019,374654,23.99971,1561077
12671,sjeeva,3,0.00019,374657,23.99991,1561077
12672,sjsadowski,3,0.00019,374660,24.00010,1561077
12673,skahlhoefer,3,0.00019,374663,24.00029,1561077
12674,skatkar,3,0.00019,374666,24.00048,1561077
12675,skirdey,3,0.00019,374669,24.00067,1561077
12676,sknaga,3,0.00019,374672,24.00087,1561077
12677,skorzhevsky,3,0.00019,374675,24.00106,1561077
12678,skoslowski,3,0.00019,374678,24.00125,1561077
12679,skqist225,3,0.00019,374681,24.00144,1561077
12680,skwuent,3,0.00019,374684,24.00163,1561077
12681,skycoqueury,3,0.00019,374687,24.00183,1561077
12682,skyhitnow,3,0.00019,374690,24.00202,1561077
12683,sky-lake,3,0.00019,374693,24.00221,1561077
12684,skyline00,3,0.00019,374696,24.00240,1561077
12685,slauth,3,0.00019,374699,24.00260,1561077
12686,slawekgh,3,0.00019,374702,24.00279,1561077
12687,slcnx,3,0.00019,374705,24.00298,1561077
12688,slehan,3,0.00019,374708,24.00317,1561077
12689,sli720,3,0.00019,374711,24.00336,1561077
12690,slideon,3,0.00019,374714,24.00356,1561077
12691,slmjy,3,0.00019,374717,24.00375,1561077
12692,slotone,3,0.00019,374720,24.00394,1561077
12693,slux83,3,0.00019,374723,24.00413,1561077
12694,slv-306,3,0.00019,374726,24.00433,1561077
12695,smarmie,3,0.00019,374729,24.00452,1561077
12696,smartiniOnGitHub,3,0.00019,374732,24.00471,1561077
12697,smellouk,3,0.00019,374735,24.00490,1561077
12698,smirkybg,3,0.00019,374738,24.00509,1561077
12699,smougenot,3,0.00019,374741,24.00529,1561077
12700,SMR39,3,0.00019,374744,24.00548,1561077
12701,smvdheijden,3,0.00019,374747,24.00567,1561077
12702,snbuback,3,0.00019,374750,24.00586,1561077
12703,sncitom3,3,0.00019,374753,24.00605,1561077
12704,snguyen-ith,3,0.00019,374756,24.00625,1561077
12705,Snorlock,3,0.00019,374759,24.00644,1561077
12706,snwbr,3,0.00019,374762,24.00663,1561077
12707,sochotnicky,3,0.00019,374765,24.00682,1561077
12708,solarjoe,3,0.00019,374768,24.00702,1561077
12709,soloturn,3,0.00019,374771,24.00721,1561077
12710,SomaSharathSurya,3,0.00019,374774,24.00740,1561077
12711,sonal-chauhan,3,0.00019,374777,24.00759,1561077
12712,song316,3,0.00019,374780,24.00778,1561077
12713,songhanpoo,3,0.00019,374783,24.00798,1561077
12714,Sonix,3,0.00019,374786,24.00817,1561077
12715,sorensonpragmatics,3,0.00019,374789,24.00836,1561077
12716,sorobon,3,0.00019,374792,24.00855,1561077
12717,soualid,3,0.00019,374795,24.00875,1561077
12718,SoumyaMaitra,3,0.00019,374798,24.00894,1561077
12719,SourcePond,3,0.00019,374801,24.00913,1561077
12720,spaced,3,0.00019,374804,24.00932,1561077
12721,spagu,3,0.00019,374807,24.00951,1561077
12722,spasche,3,0.00019,374810,24.00971,1561077
12723,SPawar,3,0.00019,374813,24.00990,1561077
12724,Speakus,3,0.00019,374816,24.01009,1561077
12725,spennec,3,0.00019,374819,24.01028,1561077
12726,spherefoundry,3,0.00019,374822,24.01047,1561077
12727,spielers,3,0.00019,374825,24.01067,1561077
12728,spikkie,3,0.00019,374828,24.01086,1561077
12729,SpiReCZ,3,0.00019,374831,24.01105,1561077
12730,spoorcc,3,0.00019,374834,24.01124,1561077
12731,spunkedy,3,0.00019,374837,24.01144,1561077
12732,spyoungtech,3,0.00019,374840,24.01163,1561077
12733,sraschitor,3,0.00019,374843,24.01182,1561077
12734,src-code,3,0.00019,374846,24.01201,1561077
12735,srikanthmalyala,3,0.00019,374849,24.01220,1561077
12736,srikavya-kola,3,0.00019,374852,24.01240,1561077
12737,Srinirap,3,0.00019,374855,24.01259,1561077
12738,srohan,3,0.00019,374858,24.01278,1561077
12739,srshanmug,3,0.00019,374861,24.01297,1561077
12740,ssaamm,3,0.00019,374864,24.01317,1561077
12741,ssibahi,3,0.00019,374867,24.01336,1561077
12742,sskotha,3,0.00019,374870,24.01355,1561077
12743,ssproessig,3,0.00019,374873,24.01374,1561077
12744,staenker,3,0.00019,374876,24.01393,1561077
12745,stan3,3,0.00019,374879,24.01413,1561077
12746,stanleyhlng,3,0.00019,374882,24.01432,1561077
12747,StanleyShen,3,0.00019,374885,24.01451,1561077
12748,stanovchar,3,0.00019,374888,24.01470,1561077
12749,Stargator,3,0.00019,374891,24.01489,1561077
12750,statik,3,0.00019,374894,24.01509,1561077
12751,statsperformjanos,3,0.00019,374897,24.01528,1561077
12752,steele,3,0.00019,374900,24.01547,1561077
12753,stefanbesler,3,0.00019,374903,24.01566,1561077
12754,StefanCardnellVOSS,3,0.00019,374906,24.01586,1561077
12755,stefano-salmaso,3,0.00019,374909,24.01605,1561077
12756,stempler,3,0.00019,374912,24.01624,1561077
12757,Stephan202,3,0.00019,374915,24.01643,1561077
12758,stephanh,3,0.00019,374918,24.01662,1561077
12759,stephan-senkbeil,3,0.00019,374921,24.01682,1561077
12760,StephenDryden,3,0.00019,374924,24.01701,1561077
12761,stepkh,3,0.00019,374927,24.01720,1561077
12762,stevehiley,3,0.00019,374930,24.01739,1561077
12763,stevenaldinger,3,0.00019,374933,24.01759,1561077
12764,steveruddell,3,0.00019,374936,24.01778,1561077
12765,StFS,3,0.00019,374939,24.01797,1561077
12766,sthirugn,3,0.00019,374942,24.01816,1561077
12767,stippi2,3,0.00019,374945,24.01835,1561077
12768,stopiccot,3,0.00019,374948,24.01855,1561077
12769,stopley,3,0.00019,374951,24.01874,1561077
12770,storjarn,3,0.00019,374954,24.01893,1561077
12771,stour,3,0.00019,374957,24.01912,1561077
12772,stristr,3,0.00019,374960,24.01931,1561077
12773,stu01509,3,0.00019,374963,24.01951,1561077
12774,stuchy3,3,0.00019,374966,24.01970,1561077
12775,stvnwrgs,3,0.00019,374969,24.01989,1561077
12776,SubhashNikam,3,0.00019,374972,24.02008,1561077
12777,sublee,3,0.00019,374975,24.02028,1561077
12778,subprogram,3,0.00019,374978,24.02047,1561077
12779,Subtixx,3,0.00019,374981,24.02066,1561077
12780,suchasplus,3,0.00019,374984,24.02085,1561077
12781,sudheerpujar,3,0.00019,374987,24.02104,1561077
12782,sufyanbnk,3,0.00019,374990,24.02124,1561077
12783,sugi1987,3,0.00019,374993,24.02143,1561077
12784,Su-HackZ,3,0.00019,374996,24.02162,1561077
12785,sujeilyfonseca,3,0.00019,374999,24.02181,1561077
12786,sujitsrinivasan,3,0.00019,375002,24.02201,1561077
12787,Sulinskii,3,0.00019,375005,24.02220,1561077
12788,Sulphurium-Brimstone,3,0.00019,375008,24.02239,1561077
12789,sumeetp4,3,0.00019,375011,24.02258,1561077
12790,sumerion,3,0.00019,375014,24.02277,1561077
12791,sumith08,3,0.00019,375017,24.02297,1561077
12792,summanerd,3,0.00019,375020,24.02316,1561077
12793,summergan,3,0.00019,375023,24.02335,1561077
12794,summerm78,3,0.00019,375026,24.02354,1561077
12795,sundbry,3,0.00019,375029,24.02373,1561077
12796,sundergopalsingh,3,0.00019,375032,24.02393,1561077
12797,sungardas-cloud-devops,3,0.00019,375035,24.02412,1561077
12798,SunghoonJo-01,3,0.00019,375038,24.02431,1561077
12799,sunilkhokalay,3,0.00019,375041,24.02450,1561077
12800,sunoce,3,0.00019,375044,24.02470,1561077
12801,SuoJianfei,3,0.00019,375047,24.02489,1561077
12802,superbob,3,0.00019,375050,24.02508,1561077
12803,superchun,3,0.00019,375053,24.02527,1561077
12804,Superhans79,3,0.00019,375056,24.02546,1561077
12805,sureshreddygovindu,3,0.00019,375059,24.02566,1561077
12806,surmabck,3,0.00019,375062,24.02585,1561077
12807,Suryansh-Bhadouria-007,3,0.00019,375065,24.02604,1561077
12808,SushanSuresh,3,0.00019,375068,24.02623,1561077
12809,suukit,3,0.00019,375071,24.02643,1561077
12810,SvA1,3,0.00019,375074,24.02662,1561077
12811,Svastikkka,3,0.00019,375077,24.02681,1561077
12812,svc-github-joule,3,0.00019,375080,24.02700,1561077
12813,sveniu,3,0.00019,375083,24.02719,1561077
12814,sverkera,3,0.00019,375086,24.02739,1561077
12815,svscorp,3,0.00019,375089,24.02758,1561077
12816,swbradshaw,3,0.00019,375092,24.02777,1561077
12817,Sweepi,3,0.00019,375095,24.02796,1561077
12818,Sweety125,3,0.00019,375098,24.02815,1561077
12819,swkarr,3,0.00019,375101,24.02835,1561077
12820,SwordJason,3,0.00019,375104,24.02854,1561077
12821,SWPhantom,3,0.00019,375107,24.02873,1561077
12822,Symbianx,3,0.00019,375110,24.02892,1561077
12823,synuwxy,3,0.00019,375113,24.02912,1561077
12824,szahnfender,3,0.00019,375116,24.02931,1561077
12825,szimmer1,3,0.00019,375119,24.02950,1561077
12826,szwed,3,0.00019,375122,24.02969,1561077
12827,szylmzs,3,0.00019,375125,24.02988,1561077
12828,szym,3,0.00019,375128,24.03008,1561077
12829,SzymonLobocki,3,0.00019,375131,24.03027,1561077
12830,szymon-wlodarczyk,3,0.00019,375134,24.03046,1561077
12831,t0bst4r,3,0.00019,375137,24.03065,1561077
12832,T0mmykn1fe,3,0.00019,375140,24.03085,1561077
12833,T1m07hy,3,0.00019,375143,24.03104,1561077
12834,T1mey,3,0.00019,375146,24.03123,1561077
12835,t4traw,3,0.00019,375149,24.03142,1561077
12836,t9t,3,0.00019,375152,24.03161,1561077
12837,taibc,3,0.00019,375155,24.03181,1561077
12838,tal5ab,3,0.00019,375158,24.03200,1561077
12839,talanc,3,0.00019,375161,24.03219,1561077
12840,tallbrick,3,0.00019,375164,24.03238,1561077
12841,tam512,3,0.00019,375167,24.03257,1561077
12842,tamasflamich,3,0.00019,375170,24.03277,1561077
12843,tanghulu9312,3,0.00019,375173,24.03296,1561077
12844,tannaalok,3,0.00019,375176,24.03315,1561077
12845,tarekbadrshalaan,3,0.00019,375179,24.03334,1561077
12846,tarikabh,3,0.00019,375182,24.03354,1561077
12847,tarjei,3,0.00019,375185,24.03373,1561077
12848,tastatur,3,0.00019,375188,24.03392,1561077
12849,TatchNicolas,3,0.00019,375191,24.03411,1561077
12850,tavisdxh,3,0.00019,375194,24.03430,1561077
12851,tbrouhier,3,0.00019,375197,24.03450,1561077
12852,TD-4242,3,0.00019,375200,24.03469,1561077
12853,tdclemens,3,0.00019,375203,24.03488,1561077
12854,tdesaules,3,0.00019,375206,24.03507,1561077
12855,TDscSam,3,0.00019,375209,24.03527,1561077
12856,tdspencer3,3,0.00019,375212,24.03546,1561077
12857,tduchateau,3,0.00019,375215,24.03565,1561077
12858,Tea7ime,3,0.00019,375218,24.03584,1561077
12859,teabolt,3,0.00019,375221,24.03603,1561077
12860,techd1984,3,0.00019,375224,24.03623,1561077
12861,techzio-io,3,0.00019,375227,24.03642,1561077
12862,tedchoward,3,0.00019,375230,24.03661,1561077
12863,tedhtchang,3,0.00019,375233,24.03680,1561077
12864,teegalasv,3,0.00019,375236,24.03699,1561077
12865,teekennedy,3,0.00019,375239,24.03719,1561077
12866,tejado,3,0.00019,375242,24.03738,1561077
12867,teluka,3,0.00019,375245,24.03757,1561077
12868,temoedjin,3,0.00019,375248,24.03776,1561077
12869,Tenzian,3,0.00019,375251,24.03796,1561077
12870,teojgo,3,0.00019,375254,24.03815,1561077
12871,tersmitten,3,0.00019,375257,24.03834,1561077
12872,TestingJenkins,3,0.00019,375260,24.03853,1561077
12873,tfarmer00,3,0.00019,375263,24.03872,1561077
12874,tgeens,3,0.00019,375266,24.03892,1561077
12875,TheAppService,3,0.00019,375269,24.03911,1561077
12876,theartoflogic,3,0.00019,375272,24.03930,1561077
12877,theatricshrink,3,0.00019,375275,24.03949,1561077
12878,thebalaa,3,0.00019,375278,24.03969,1561077
12879,thebenwaters,3,0.00019,375281,24.03988,1561077
12880,thecoshman,3,0.00019,375284,24.04007,1561077
12881,thecosmicfrog,3,0.00019,375287,24.04026,1561077
12882,thefarwind,3,0.00019,375290,24.04045,1561077
12883,thegecko,3,0.00019,375293,24.04065,1561077
12884,TheLastPossibleUsernameEver,3,0.00019,375296,24.04084,1561077
12885,themanifold,3,0.00019,375299,24.04103,1561077
12886,themasterofscrumpets,3,0.00019,375302,24.04122,1561077
12887,themikenicholson,3,0.00019,375305,24.04141,1561077
12888,theminer3746,3,0.00019,375308,24.04161,1561077
12889,thenickfish,3,0.00019,375311,24.04180,1561077
12890,thepatrick,3,0.00019,375314,24.04199,1561077
12891,therumbler,3,0.00019,375317,24.04218,1561077
12892,therzv,3,0.00019,375320,24.04238,1561077
12893,theta682,3,0.00019,375323,24.04257,1561077
12894,TheTacoScott,3,0.00019,375326,24.04276,1561077
12895,thigg,3,0.00019,375329,24.04295,1561077
12896,thilanka-wijerathne,3,0.00019,375332,24.04314,1561077
12897,thisdudeiknew,3,0.00019,375335,24.04334,1561077
12898,thogaw,3,0.00019,375338,24.04353,1561077
12899,Thomah,3,0.00019,375341,24.04372,1561077
12900,thomas955,3,0.00019,375344,24.04391,1561077
12901,thomasbundgaard,3,0.00019,375347,24.04411,1561077
12902,thomas-duerr,3,0.00019,375350,24.04430,1561077
12903,ThomasPerkins1123,3,0.00019,375353,24.04449,1561077
12904,thomasstache,3,0.00019,375356,24.04468,1561077
12905,ThomasStubbe,3,0.00019,375359,24.04487,1561077
12906,thommyho,3,0.00019,375362,24.04507,1561077
12907,thylacinelol,3,0.00019,375365,24.04526,1561077
12908,tiadobatima,3,0.00019,375368,24.04545,1561077
12909,tiagoor,3,0.00019,375371,24.04564,1561077
12910,tianzhipeng-git,3,0.00019,375374,24.04584,1561077
12911,tiffloon,3,0.00019,375377,24.04603,1561077
12912,tikoflano,3,0.00019,375380,24.04622,1561077
12913,TilakShrma,3,0.00019,375383,24.04641,1561077
12914,timarmstrong,3,0.00019,375386,24.04660,1561077
12915,TimBartkowiak,3,0.00019,375389,24.04680,1561077
12916,TimeInvestor,3,0.00019,375392,24.04699,1561077
12917,timholmes,3,0.00019,375395,24.04718,1561077
12918,timmolter,3,0.00019,375398,24.04737,1561077
12919,timoha,3,0.00019,375401,24.04756,1561077
12920,timor-raiman,3,0.00019,375404,24.04776,1561077
12921,timothy-long,3,0.00019,375407,24.04795,1561077
12922,timur206,3,0.00019,375410,24.04814,1561077
12923,timvanderkooi,3,0.00019,375413,24.04833,1561077
12924,tingShean,3,0.00019,375416,24.04853,1561077
12925,tjesser-ucdavis-edu,3,0.00019,375419,24.04872,1561077
12926,tjnicholas,3,0.00019,375422,24.04891,1561077
12927,tjones-commits,3,0.00019,375425,24.04910,1561077
12928,Tjuri,3,0.00019,375428,24.04929,1561077
12929,tkrisztian95,3,0.00019,375431,24.04949,1561077
12930,tldavies,3,0.00019,375434,24.04968,1561077
12931,tmc9031,3,0.00019,375437,24.04987,1561077
12932,tnimni,3,0.00019,375440,24.05006,1561077
12933,tnsasse,3,0.00019,375443,24.05026,1561077
12934,tobiash,3,0.00019,375446,24.05045,1561077
12935,tobiashochguertel,3,0.00019,375449,24.05064,1561077
12936,tobias-richter,3,0.00019,375452,24.05083,1561077
12937,Tocard,3,0.00019,375455,24.05102,1561077
12938,tokeskovgaard,3,0.00019,375458,24.05122,1561077
12939,tom1299,3,0.00019,375461,24.05141,1561077
12940,tomasol,3,0.00019,375464,24.05160,1561077
12941,tomasz-lagodzinski-ynd,3,0.00019,375467,24.05179,1561077
12942,tomaxsas,3,0.00019,375470,24.05198,1561077
12943,tom-cn,3,0.00019,375473,24.05218,1561077
12944,TomDino,3,0.00019,375476,24.05237,1561077
12945,TomerCo,3,0.00019,375479,24.05256,1561077
12946,TomRK1089,3,0.00019,375482,24.05275,1561077
12947,tom-vanbraband-sonarsource,3,0.00019,375485,24.05295,1561077
12948,tomvmac,3,0.00019,375488,24.05314,1561077
12949,tomwj,3,0.00019,375491,24.05333,1561077
12950,toni-lyttinen,3,0.00019,375494,24.05352,1561077
12951,tonsV2,3,0.00019,375497,24.05371,1561077
12952,tonyallain,3,0.00019,375500,24.05391,1561077
12953,TonyCarratoSSS,3,0.00019,375503,24.05410,1561077
12954,tonyflint,3,0.00019,375506,24.05429,1561077
12955,tony-sweeney,3,0.00019,375509,24.05448,1561077
12956,torake,3,0.00019,375512,24.05468,1561077
12957,torgie-HBO,3,0.00019,375515,24.05487,1561077
12958,toshi38,3,0.00019,375518,24.05506,1561077
12959,tougemasta,3,0.00019,375521,24.05525,1561077
12960,tovbinm,3,0.00019,375524,24.05544,1561077
12961,tpatja-broadsoft,3,0.00019,375527,24.05564,1561077
12962,tpayne1,3,0.00019,375530,24.05583,1561077
12963,tpbowden,3,0.00019,375533,24.05602,1561077
12964,tphoney,3,0.00019,375536,24.05621,1561077
12965,tpokki,3,0.00019,375539,24.05640,1561077
12966,tpzumezawa,3,0.00019,375542,24.05660,1561077
12967,trance1st,3,0.00019,375545,24.05679,1561077
12968,treaz,3,0.00019,375548,24.05698,1561077
12969,tremble,3,0.00019,375551,24.05717,1561077
12970,trevorputbrese,3,0.00019,375554,24.05737,1561077
12971,trevorr,3,0.00019,375557,24.05756,1561077
12972,trispad,3,0.00019,375560,24.05775,1561077
12973,trivago-tgoik,3,0.00019,375563,24.05794,1561077
12974,troxor,3,0.00019,375566,24.05813,1561077
12975,trusktr,3,0.00019,375569,24.05833,1561077
12976,tsartarzan,3,0.00019,375572,24.05852,1561077
12977,tschlue,3,0.00019,375575,24.05871,1561077
12978,tsjfd,3,0.00019,375578,24.05890,1561077
12979,tsr-caubry,3,0.00019,375581,24.05910,1561077
12980,t-stamm,3,0.00019,375584,24.05929,1561077
12981,tst-kfreiheit,3,0.00019,375587,24.05948,1561077
12982,tsvi,3,0.00019,375590,24.05967,1561077
12983,TToliver,3,0.00019,375593,24.05986,1561077
12984,tuanalumi,3,0.00019,375596,24.06006,1561077
12985,tuliren,3,0.00019,375599,24.06025,1561077
12986,tumbl3w33d,3,0.00019,375602,24.06044,1561077
12987,tunderwood,3,0.00019,375605,24.06063,1561077
12988,turboBasic,3,0.00019,375608,24.06082,1561077
12989,turbokernel,3,0.00019,375611,24.06102,1561077
12990,TurnusSilver,3,0.00019,375614,24.06121,1561077
12991,turturel,3,0.00019,375617,24.06140,1561077
12992,tushartone,3,0.00019,375620,24.06159,1561077
12993,twilleit,3,0.00019,375623,24.06179,1561077
12994,Twister42,3,0.00019,375626,24.06198,1561077
12995,TWood67,3,0.00019,375629,24.06217,1561077
12996,tylernap,3,0.00019,375632,24.06236,1561077
12997,tylyccn,3,0.00019,375635,24.06255,1561077
12998,tyron,3,0.00019,375638,24.06275,1561077
12999,tzoratto,3,0.00019,375641,24.06294,1561077
13000,Ubidy,3,0.00019,375644,24.06313,1561077
13001,uchuugaka,3,0.00019,375647,24.06332,1561077
13002,udayanem,3,0.00019,375650,24.06352,1561077
13003,udayRedI,3,0.00019,375653,24.06371,1561077
13004,udderchaos,3,0.00019,375656,24.06390,1561077
13005,udit-jaiswal,3,0.00019,375659,24.06409,1561077
13006,uditjh,3,0.00019,375662,24.06428,1561077
13007,uglylee,3,0.00019,375665,24.06448,1561077
13008,ukhare,3,0.00019,375668,24.06467,1561077
13009,ukreddy-erwin,3,0.00019,375671,24.06486,1561077
13010,Ullio,3,0.00019,375674,24.06505,1561077
13011,ulrikls,3,0.00019,375677,24.06524,1561077
13012,Ulvhedin,3,0.00019,375680,24.06544,1561077
13013,umairadeeb,3,0.00019,375683,24.06563,1561077
13014,unbright,3,0.00019,375686,24.06582,1561077
13015,uniquechao,3,0.00019,375689,24.06601,1561077
13016,unitychrism,3,0.00019,375692,24.06621,1561077
13017,unlikelyzero,3,0.00019,375695,24.06640,1561077
13018,unlikezy,3,0.00019,375698,24.06659,1561077
13019,unphased,3,0.00019,375701,24.06678,1561077
13020,urbanikb,3,0.00019,375704,24.06697,1561077
13021,Urjaswi-2655,3,0.00019,375707,24.06717,1561077
13022,urol,3,0.00019,375710,24.06736,1561077
13023,UrsLange,3,0.00019,375713,24.06755,1561077
13024,usairman82,3,0.00019,375716,24.06774,1561077
13025,userkc,3,0.00019,375719,24.06794,1561077
13026,UserNotExist12,3,0.00019,375722,24.06813,1561077
13027,uwehdaub,3,0.00019,375725,24.06832,1561077
13028,v522zy,3,0.00019,375728,24.06851,1561077
13029,vadakr,3,0.00019,375731,24.06870,1561077
13030,Vadim2305,3,0.00019,375734,24.06890,1561077
13031,vadim-codefresh,3,0.00019,375737,24.06909,1561077
13032,vaibhav65,3,0.00019,375740,24.06928,1561077
13033,vajda,3,0.00019,375743,24.06947,1561077
13034,valentinvarbanov,3,0.00019,375746,24.06966,1561077
13035,ValeriiVozniuk,3,0.00019,375749,24.06986,1561077
13036,ValerioCadeddu,3,0.00019,375752,24.07005,1561077
13037,vandykej17,3,0.00019,375755,24.07024,1561077
13038,varun-vashishtha,3,0.00019,375758,24.07043,1561077
13039,vas-dev-ops,3,0.00019,375761,24.07063,1561077
13040,vasu0915,3,0.00019,375764,24.07082,1561077
13041,vasuems,3,0.00019,375767,24.07101,1561077
13042,vasyl-slobodyan,3,0.00019,375770,24.07120,1561077
13043,vbanthia,3,0.00019,375773,24.07139,1561077
13044,vblack,3,0.00019,375776,24.07159,1561077
13045,vbobade6874,3,0.00019,375779,24.07178,1561077
13046,vedantshetty,3,0.00019,375782,24.07197,1561077
13047,vehagn,3,0.00019,375785,24.07216,1561077
13048,vekexasia,3,0.00019,375788,24.07236,1561077
13049,velikanov,3,0.00019,375791,24.07255,1561077
13050,venkatramachandran,3,0.00019,375794,24.07274,1561077
13051,VenkatTMN,3,0.00019,375797,24.07293,1561077
13052,venkrao,3,0.00019,375800,24.07312,1561077
13053,vennemp,3,0.00019,375803,24.07332,1561077
13054,verhagen,3,0.00019,375806,24.07351,1561077
13055,vermut,3,0.00019,375809,24.07370,1561077
13056,Vermyndax,3,0.00019,375812,24.07389,1561077
13057,vfilanovsky,3,0.00019,375815,24.07408,1561077
13058,vgamz,3,0.00019,375818,24.07428,1561077
13059,vhartikainen,3,0.00019,375821,24.07447,1561077
13060,vicecea,3,0.00019,375824,24.07466,1561077
13061,vichak,3,0.00019,375827,24.07485,1561077
13062,victorcai0922,3,0.00019,375830,24.07505,1561077
13063,victorcampos,3,0.00019,375833,24.07524,1561077
13064,vidheer,3,0.00019,375836,24.07543,1561077
13065,vidya136,3,0.00019,375839,24.07562,1561077
13066,vigneshashokan,3,0.00019,375842,24.07581,1561077
13067,vijayhrd,3,0.00019,375845,24.07601,1561077
13068,vikasillumina,3,0.00019,375848,24.07620,1561077
13069,Viktork25,3,0.00019,375851,24.07639,1561077
13070,viktorkholod,3,0.00019,375854,24.07658,1561077
13071,Vinayteza,3,0.00019,375857,24.07678,1561077
13072,vince-franco,3,0.00019,375860,24.07697,1561077
13073,ViniciosGrein,3,0.00019,375863,24.07716,1561077
13074,viniciusroc,3,0.00019,375866,24.07735,1561077
13075,Vinnie555,3,0.00019,375869,24.07754,1561077
13076,VinodEgallapati,3,0.00019,375872,24.07774,1561077
13077,virendrachaudhary06,3,0.00019,375875,24.07793,1561077
13078,virilo,3,0.00019,375878,24.07812,1561077
13079,virtualorg1,3,0.00019,375881,24.07831,1561077
13080,vishanthbharadwaj,3,0.00019,375884,24.07850,1561077
13081,vishmegh88,3,0.00019,375887,24.07870,1561077
13082,vishveshv01,3,0.00019,375890,24.07889,1561077
13083,visibilityspots,3,0.00019,375893,24.07908,1561077
13084,vitalyiegorov,3,0.00019,375896,24.07927,1561077
13085,vivekanandg,3,0.00019,375899,24.07947,1561077
13086,vjlamp,3,0.00019,375902,24.07966,1561077
13087,vkmellon,3,0.00019,375905,24.07985,1561077
13088,VladRassokhin,3,0.00019,375908,24.08004,1561077
13089,vlastimil-dolejs,3,0.00019,375911,24.08023,1561077
13090,vlindvall,3,0.00019,375914,24.08043,1561077
13091,v-lopez,3,0.00019,375917,24.08062,1561077
13092,vlotorev,3,0.00019,375920,24.08081,1561077
13093,vmagamedov,3,0.00019,375923,24.08100,1561077
13094,vmallik59,3,0.00019,375926,24.08120,1561077
13095,vmamidela,3,0.00019,375929,24.08139,1561077
13096,vmasule,3,0.00019,375932,24.08158,1561077
13097,vmbears-marcello,3,0.00019,375935,24.08177,1561077
13098,vmintam,3,0.00019,375938,24.08196,1561077
13099,vmwarelab,3,0.00019,375941,24.08216,1561077
13100,vnugopal2000,3,0.00019,375944,24.08235,1561077
13101,Voland666,3,0.00019,375947,24.08254,1561077
13102,volkai,3,0.00019,375950,24.08273,1561077
13103,volteanu,3,0.00019,375953,24.08292,1561077
13104,vonEdfa,3,0.00019,375956,24.08312,1561077
13105,voorth,3,0.00019,375959,24.08331,1561077
13106,vpassapera,3,0.00019,375962,24.08350,1561077
13107,vpvmohan,3,0.00019,375965,24.08369,1561077
13108,vramannasoft,3,0.00019,375968,24.08389,1561077
13109,vrathore18,3,0.00019,375971,24.08408,1561077
13110,vrock28,3,0.00019,375974,24.08427,1561077
13111,vsubrama001,3,0.00019,375977,24.08446,1561077
13112,vsutrave,3,0.00019,375980,24.08465,1561077
13113,vtimejc,3,0.00019,375983,24.08485,1561077
13114,vvangestel,3,0.00019,375986,24.08504,1561077
13115,VVMichaelSawyer,3,0.00019,375989,24.08523,1561077
13116,vzickner,3,0.00019,375992,24.08542,1561077
13117,wabuhigleh,3,0.00019,375995,24.08562,1561077
13118,waeller,3,0.00019,375998,24.08581,1561077
13119,wagoodman,3,0.00019,376001,24.08600,1561077
13120,waigani,3,0.00019,376004,24.08619,1561077
13121,wakaleo,3,0.00019,376007,24.08638,1561077
13122,walker-tom,3,0.00019,376010,24.08658,1561077
13123,wallmarc,3,0.00019,376013,24.08677,1561077
13124,wandersonwhcr,3,0.00019,376016,24.08696,1561077
13125,wangchaoxiang,3,0.00019,376019,24.08715,1561077
13126,Wang-kk714,3,0.00019,376022,24.08734,1561077
13127,wangpy,3,0.00019,376025,24.08754,1561077
13128,wangyachao-1111,3,0.00019,376028,24.08773,1561077
13129,Wang-Yiran,3,0.00019,376031,24.08792,1561077
13130,warrenseine,3,0.00019,376034,24.08811,1561077
13131,waschik,3,0.00019,376037,24.08831,1561077
13132,waseemcn,3,0.00019,376040,24.08850,1561077
13133,wcd923,3,0.00019,376043,24.08869,1561077
13134,weg2g,3,0.00019,376046,24.08888,1561077
13135,weijunli-No1,3,0.00019,376049,24.08907,1561077
13136,Wei-Lin-D,3,0.00019,376052,24.08927,1561077
13137,weilu,3,0.00019,376055,24.08946,1561077
13138,wellhungwguy,3,0.00019,376058,24.08965,1561077
13139,wetterj,3,0.00019,376061,24.08984,1561077
13140,wexoni,3,0.00019,376064,24.09004,1561077
13141,wgillaspy,3,0.00019,376067,24.09023,1561077
13142,whhx,3,0.00019,376070,24.09042,1561077
13143,whitty,3,0.00019,376073,24.09061,1561077
13144,wiizzard,3,0.00019,376076,24.09080,1561077
13145,wilinger,3,0.00019,376079,24.09100,1561077
13146,WilliamMarsVolant,3,0.00019,376082,24.09119,1561077
13147,will-lauer,3,0.00019,376085,24.09138,1561077
13148,wilreichert,3,0.00019,376088,24.09157,1561077
13149,winklema,3,0.00019,376091,24.09176,1561077
13150,winston-geerlings-hybrit,3,0.00019,376094,24.09196,1561077
13151,winterDroid,3,0.00019,376097,24.09215,1561077
13152,with-joy,3,0.00019,376100,24.09234,1561077
13153,withnale,3,0.00019,376103,24.09253,1561077
13154,wjt,3,0.00019,376106,24.09273,1561077
13155,wmcg,3,0.00019,376109,24.09292,1561077
13156,Woellchen,3,0.00019,376112,24.09311,1561077
13157,Woile,3,0.00019,376115,24.09330,1561077
13158,wolfmah,3,0.00019,376118,24.09349,1561077
13159,wowandos26,3,0.00019,376121,24.09369,1561077
13160,wrbobby,3,0.00019,376124,24.09388,1561077
13161,wreggyl,3,0.00019,376127,24.09407,1561077
13162,wrotte,3,0.00019,376130,24.09426,1561077
13163,wrt54g,3,0.00019,376133,24.09446,1561077
13164,wsilva32,3,0.00019,376136,24.09465,1561077
13165,wuerzelchen,3,0.00019,376139,24.09484,1561077
13166,Wulf,3,0.00019,376142,24.09503,1561077
13167,wuzz25861,3,0.00019,376145,24.09522,1561077
13168,wzur,3,0.00019,376148,24.09542,1561077
13169,wzxjohn,3,0.00019,376151,24.09561,1561077
13170,xasor,3,0.00019,376154,24.09580,1561077
13171,xavileci,3,0.00019,376157,24.09599,1561077
13172,xavimb,3,0.00019,376160,24.09618,1561077
13173,xbazhen,3,0.00019,376163,24.09638,1561077
13174,xbeta,3,0.00019,376166,24.09657,1561077
13175,xbmono,3,0.00019,376169,24.09676,1561077
13176,xe1gyq,3,0.00019,376172,24.09695,1561077
13177,xenoglaux88,3,0.00019,376175,24.09715,1561077
13178,Xeuhua,3,0.00019,376178,24.09734,1561077
13179,Xexeno,3,0.00019,376181,24.09753,1561077
13180,xhrwp,3,0.00019,376184,24.09772,1561077
13181,xionglingfeng,3,0.00019,376187,24.09791,1561077
13182,xjg6yzl,3,0.00019,376190,24.09811,1561077
13183,xjparkerx,3,0.00019,376193,24.09830,1561077
13184,xmass,3,0.00019,376196,24.09849,1561077
13185,xMateMCPE,3,0.00019,376199,24.09868,1561077
13186,XonyON,3,0.00019,376202,24.09888,1561077
13187,xortha,3,0.00019,376205,24.09907,1561077
13188,xpicio,3,0.00019,376208,24.09926,1561077
13189,xrkffgg,3,0.00019,376211,24.09945,1561077
13190,xsc,3,0.00019,376214,24.09964,1561077
13191,xuanzhong,3,0.00019,376217,24.09984,1561077
13192,xverges,3,0.00019,376220,24.10003,1561077
13193,xwartz,3,0.00019,376223,24.10022,1561077
13194,xxbld,3,0.00019,376226,24.10041,1561077
13195,xylifyx,3,0.00019,376229,24.10060,1561077
13196,y2brianlee,3,0.00019,376232,24.10080,1561077
13197,y496237839,3,0.00019,376235,24.10099,1561077
13198,yan796,3,0.00019,376238,24.10118,1561077
13199,YangSen-qn,3,0.00019,376241,24.10137,1561077
13200,yanowitz,3,0.00019,376244,24.10157,1561077
13201,yanpak,3,0.00019,376247,24.10176,1561077
13202,yarafatin,3,0.00019,376250,24.10195,1561077
13203,yasinkarakaslar,3,0.00019,376253,24.10214,1561077
13204,yatanasov,3,0.00019,376256,24.10233,1561077
13205,yateya,3,0.00019,376259,24.10253,1561077
13206,yatli,3,0.00019,376262,24.10272,1561077
13207,Yatufo,3,0.00019,376265,24.10291,1561077
13208,yauhenishaikevich,3,0.00019,376268,24.10310,1561077
13209,ybentlili,3,0.00019,376271,24.10330,1561077
13210,ycavatars,3,0.00019,376274,24.10349,1561077
13211,ycyxuehan,3,0.00019,376277,24.10368,1561077
13212,Yeroha,3,0.00019,376280,24.10387,1561077
13213,yestin,3,0.00019,376283,24.10406,1561077
13214,yetanotherion,3,0.00019,376286,24.10426,1561077
13215,YevgeniyShpolyanskiy,3,0.00019,376289,24.10445,1561077
13216,yevgenytrcloudzone,3,0.00019,376292,24.10464,1561077
13217,y-higuchi,3,0.00019,376295,24.10483,1561077
13218,yigitbasalma,3,0.00019,376298,24.10502,1561077
13219,yihoyoung,3,0.00019,376301,24.10522,1561077
13220,yimgzz,3,0.00019,376304,24.10541,1561077
13221,ykantoni,3,0.00019,376307,24.10560,1561077
13222,ynojima,3,0.00019,376310,24.10579,1561077
13223,yoav-miles-sp,3,0.00019,376313,24.10599,1561077
13224,Yohandah,3,0.00019,376316,24.10618,1561077
13225,yoramshai,3,0.00019,376319,24.10637,1561077
13226,youjenli,3,0.00019,376322,24.10656,1561077
13227,ysabri,3,0.00019,376325,24.10675,1561077
13228,y-tara,3,0.00019,376328,24.10695,1561077
13229,yu36yuqing,3,0.00019,376331,24.10714,1561077
13230,yuanyanran,3,0.00019,376334,24.10733,1561077
13231,yulinqi,3,0.00019,376337,24.10752,1561077
13232,yuri-sergiichuk,3,0.00019,376340,24.10772,1561077
13233,Yusuke-Hiramatsu,3,0.00019,376343,24.10791,1561077
13234,YxRyaB,3,0.00019,376346,24.10810,1561077
13235,z41,3,0.00019,376349,24.10829,1561077
13236,zacheryph,3,0.00019,376352,24.10848,1561077
13237,ZacUSNYR,3,0.00019,376355,24.10868,1561077
13238,zakeeruddin21,3,0.00019,376358,24.10887,1561077
13239,zbuh,3,0.00019,376361,24.10906,1561077
13240,zbuza,3,0.00019,376364,24.10925,1561077
13241,zchen126,3,0.00019,376367,24.10944,1561077
13242,zdave,3,0.00019,376370,24.10964,1561077
13243,zdenekjanda,3,0.00019,376373,24.10983,1561077
13244,zdevi,3,0.00019,376376,24.11002,1561077
13245,zealotous,3,0.00019,376379,24.11021,1561077
13246,ZebraFlesh,3,0.00019,376382,24.11041,1561077
13247,ZeroPointEnergy,3,0.00019,376385,24.11060,1561077
13248,Zetym,3,0.00019,376388,24.11079,1561077
13249,zgolus,3,0.00019,376391,24.11098,1561077
13250,zhanglianx111,3,0.00019,376394,24.11117,1561077
13251,zhangyunlin,3,0.00019,376397,24.11137,1561077
13252,zhao1532072926,3,0.00019,376400,24.11156,1561077
13253,zhb127,3,0.00019,376403,24.11175,1561077
13254,zhibek,3,0.00019,376406,24.11194,1561077
13255,zholub,3,0.00019,376409,24.11214,1561077
13256,zhounewz,3,0.00019,376412,24.11233,1561077
13257,ZiedJlassi,3,0.00019,376415,24.11252,1561077
13258,zirzirikos,3,0.00019,376418,24.11271,1561077
13259,ziz19,3,0.00019,376421,24.11290,1561077
13260,zlesnr,3,0.00019,376424,24.11310,1561077
13261,zlosch,3,0.00019,376427,24.11329,1561077
13262,znek,3,0.00019,376430,24.11348,1561077
13263,Zocker1999NET,3,0.00019,376433,24.11367,1561077
13264,ZoeThivet,3,0.00019,376436,24.11386,1561077
13265,zohaib7king,3,0.00019,376439,24.11406,1561077
13266,zometer,3,0.00019,376442,24.11425,1561077
13267,zouhaisong,3,0.00019,376445,24.11444,1561077
13268,zou-weidong,3,0.00019,376448,24.11463,1561077
13269,zpzjzj,3,0.00019,376451,24.11483,1561077
13270,ztripez,3,0.00019,376454,24.11502,1561077
13271,zuowanbushiwo,3,0.00019,376457,24.11521,1561077
13272,zzzzzzzzzzzzz,3,0.00019,376460,24.11540,1561077
13273,0384223,2,0.00013,376462,24.11553,1561077
13274,04pmsuu1,2,0.00013,376464,24.11566,1561077
13275,0lexandra,2,0.00013,376466,24.11579,1561077
13276,0neel,2,0.00013,376468,24.11591,1561077
13277,0pens0,2,0.00013,376470,24.11604,1561077
13278,0x442E472E,2,0.00013,376472,24.11617,1561077
13279,0x91,2,0.00013,376474,24.11630,1561077
13280,0xflotus,2,0.00013,376476,24.11643,1561077
13281,0xMarK,2,0.00013,376478,24.11656,1561077
13282,0xorial,2,0.00013,376480,24.11668,1561077
13283,1026908346,2,0.00013,376482,24.11681,1561077
13284,1179325921,2,0.00013,376484,24.11694,1561077
13285,123aa113,2,0.00013,376486,24.11707,1561077
13286,1n,2,0.00013,376488,24.11720,1561077
13287,20100,2,0.00013,376490,24.11732,1561077
13288,2elite2,2,0.00013,376492,24.11745,1561077
13289,3792274,2,0.00013,376494,24.11758,1561077
13290,41412179,2,0.00013,376496,24.11771,1561077
13291,41lx,2,0.00013,376498,24.11784,1561077
13292,474846718,2,0.00013,376500,24.11796,1561077
13293,476rick,2,0.00013,376502,24.11809,1561077
13294,4kochi,2,0.00013,376504,24.11822,1561077
13295,4m3ndy,2,0.00013,376506,24.11835,1561077
13296,524c,2,0.00013,376508,24.11848,1561077
13297,5sfayas,2,0.00013,376510,24.11861,1561077
13298,7rouz,2,0.00013,376512,24.11873,1561077
13299,943739901,2,0.00013,376514,24.11886,1561077
13300,9still,2,0.00013,376516,24.11899,1561077
13301,a120889,2,0.00013,376518,24.11912,1561077
13302,a18792721831,2,0.00013,376520,24.11925,1561077
13303,a1sarao,2,0.00013,376522,24.11937,1561077
13304,a4840639,2,0.00013,376524,24.11950,1561077
13305,a60814billy,2,0.00013,376526,24.11963,1561077
13306,aaabramov,2,0.00013,376528,24.11976,1561077
13307,aabeling,2,0.00013,376530,24.11989,1561077
13308,aagarwal1012,2,0.00013,376532,24.12001,1561077
13309,aagulati15,2,0.00013,376534,24.12014,1561077
13310,aaltamir,2,0.00013,376536,24.12027,1561077
13311,aamerik,2,0.00013,376538,24.12040,1561077
13312,aantono,2,0.00013,376540,24.12053,1561077
13313,Aarex1,2,0.00013,376542,24.12066,1561077
13314,AaronDMarasco-VSI,2,0.00013,376544,24.12078,1561077
13315,AaronLuo3296,2,0.00013,376546,24.12091,1561077
13316,aaronscofield,2,0.00013,376548,24.12104,1561077
13317,aaron-seitz,2,0.00013,376550,24.12117,1561077
13318,aawilson,2,0.00013,376552,24.12130,1561077
13319,AayushPathak,2,0.00013,376554,24.12142,1561077
13320,abachelinagelia,2,0.00013,376556,24.12155,1561077
13321,abakhru,2,0.00013,376558,24.12168,1561077
13322,abalogh,2,0.00013,376560,24.12181,1561077
13323,abbashassan-py,2,0.00013,376562,24.12194,1561077
13324,abbybader,2,0.00013,376564,24.12206,1561077
13325,abcdefstar,2,0.00013,376566,24.12219,1561077
13326,abc-njspencer,2,0.00013,376568,24.12232,1561077
13327,abdelhafiz23,2,0.00013,376570,24.12245,1561077
13328,abdelino17,2,0.00013,376572,24.12258,1561077
13329,Abdennebi,2,0.00013,376574,24.12271,1561077
13330,abdidarmawan007,2,0.00013,376576,24.12283,1561077
13331,abelberhane,2,0.00013,376578,24.12296,1561077
13332,abest0,2,0.00013,376580,24.12309,1561077
13333,abesto,2,0.00013,376582,24.12322,1561077
13334,abeven,2,0.00013,376584,24.12335,1561077
13335,abguy,2,0.00013,376586,24.12347,1561077
13336,abhashar,2,0.00013,376588,24.12360,1561077
13337,AbhiramSiripurapu,2,0.00013,376590,24.12373,1561077
13338,abhishekdialpad,2,0.00013,376592,24.12386,1561077
13339,AbhishekSharma20,2,0.00013,376594,24.12399,1561077
13340,abialas,2,0.00013,376596,24.12411,1561077
13341,abidrana7,2,0.00013,376598,24.12424,1561077
13342,abmohantyj,2,0.00013,376600,24.12437,1561077
13343,abo1787,2,0.00013,376602,24.12450,1561077
13344,abouquet,2,0.00013,376604,24.12463,1561077
13345,abousias,2,0.00013,376606,24.12475,1561077
13346,Abramo-Bagnara,2,0.00013,376608,24.12488,1561077
13347,Abrasha,2,0.00013,376610,24.12501,1561077
13348,abrass,2,0.00013,376612,24.12514,1561077
13349,abraverm,2,0.00013,376614,24.12527,1561077
13350,abrochard63,2,0.00013,376616,24.12540,1561077
13351,aCandidMind,2,0.00013,376618,24.12552,1561077
13352,acanewby,2,0.00013,376620,24.12565,1561077
13353,ACB1337,2,0.00013,376622,24.12578,1561077
13354,acceleanu,2,0.00013,376624,24.12591,1561077
13355,acefei,2,0.00013,376626,24.12604,1561077
13356,achaudry31,2,0.00013,376628,24.12616,1561077
13357,achavva,2,0.00013,376630,24.12629,1561077
13358,achdevops,2,0.00013,376632,24.12642,1561077
13359,achoimet,2,0.00013,376634,24.12655,1561077
13360,acompton-slack,2,0.00013,376636,24.12668,1561077
13361,acoulton,2,0.00013,376638,24.12680,1561077
13362,acrane1,2,0.00013,376640,24.12693,1561077
13363,acrazing,2,0.00013,376642,24.12706,1561077
13364,acsipak,2,0.00013,376644,24.12719,1561077
13365,actionjack,2,0.00013,376646,24.12732,1561077
13366,acxmatos,2,0.00013,376648,24.12745,1561077
13367,acyriac,2,0.00013,376650,24.12757,1561077
13368,adam-arold,2,0.00013,376652,24.12770,1561077
13369,AdamJLemmon,2,0.00013,376654,24.12783,1561077
13370,adamjwsuch,2,0.00013,376656,24.12796,1561077
13371,adam-kosseck,2,0.00013,376658,24.12809,1561077
13372,adamMo,2,0.00013,376660,24.12821,1561077
13373,Adam-QAS,2,0.00013,376662,24.12834,1561077
13374,AdamSaleh,2,0.00013,376664,24.12847,1561077
13375,adamtharani,2,0.00013,376666,24.12860,1561077
13376,adamtkac,2,0.00013,376668,24.12873,1561077
13377,AdamZWinter,2,0.00013,376670,24.12885,1561077
13378,adastidar,2,0.00013,376672,24.12898,1561077
13379,adaughterson,2,0.00013,376674,24.12911,1561077
13380,addib,2,0.00013,376676,24.12924,1561077
13381,adefanti,2,0.00013,376678,24.12937,1561077
13382,adelanre,2,0.00013,376680,24.12950,1561077
13383,adeliyamelwin07,2,0.00013,376682,24.12962,1561077
13384,adepue,2,0.00013,376684,24.12975,1561077
13385,aderouineau,2,0.00013,376686,24.12988,1561077
13386,adi-16-7,2,0.00013,376688,24.13001,1561077
13387,adigod1,2,0.00013,376690,24.13014,1561077
13388,AdilusPrimus,2,0.00013,376692,24.13026,1561077
13389,aditiagarwal34550,2,0.00013,376694,24.13039,1561077
13390,adityagu0910,2,0.00013,376696,24.13052,1561077
13391,adityak368,2,0.00013,376698,24.13065,1561077
13392,aditya-malviya,2,0.00013,376700,24.13078,1561077
13393,adityosnrost,2,0.00013,376702,24.13090,1561077
13394,adpoint72,2,0.00013,376704,24.13103,1561077
13395,adrian256,2,0.00013,376706,24.13116,1561077
13396,adrian-at-dmi,2,0.00013,376708,24.13129,1561077
13397,adriancjr,2,0.00013,376710,24.13142,1561077
13398,AdrianPadilla,2,0.00013,376712,24.13155,1561077
13399,adrienLoustaunauPaloIt,2,0.00013,376714,24.13167,1561077
13400,adripo,2,0.00013,376716,24.13180,1561077
13401,adutton-tc,2,0.00013,376718,24.13193,1561077
13402,ady624,2,0.00013,376720,24.13206,1561077
13403,aejazuddinam,2,0.00013,376722,24.13219,1561077
13404,Aekkapong18,2,0.00013,376724,24.13231,1561077
13405,aemonge,2,0.00013,376726,24.13244,1561077
13406,aerovulpe,2,0.00013,376728,24.13257,1561077
13407,af6140,2,0.00013,376730,24.13270,1561077
13408,afanmatvey,2,0.00013,376732,24.13283,1561077
13409,affanhmalik,2,0.00013,376734,24.13295,1561077
13410,afonsosilva91,2,0.00013,376736,24.13308,1561077
13411,afraisse,2,0.00013,376738,24.13321,1561077
13412,afsadev-owner,2,0.00013,376740,24.13334,1561077
13413,agi0rgi,2,0.00013,376742,24.13347,1561077
13414,aginni,2,0.00013,376744,24.13359,1561077
13415,agis-,2,0.00013,376746,24.13372,1561077
13416,aglorei,2,0.00013,376748,24.13385,1561077
13417,aglover-zendesk,2,0.00013,376750,24.13398,1561077
13418,agubler,2,0.00013,376752,24.13411,1561077
13419,agugglez,2,0.00013,376754,24.13424,1561077
13420,agustinlare,2,0.00013,376756,24.13436,1561077
13421,aharont,2,0.00013,376758,24.13449,1561077
13422,ahmadiesa-abu,2,0.00013,376760,24.13462,1561077
13423,AhmaudArbery,2,0.00013,376762,24.13475,1561077
13424,ahmed1490,2,0.00013,376764,24.13488,1561077
13425,ahmedkhan847,2,0.00013,376766,24.13500,1561077
13426,ahmedsameha1,2,0.00013,376768,24.13513,1561077
13427,ahmetozer,2,0.00013,376770,24.13526,1561077
13428,aholbreich,2,0.00013,376772,24.13539,1561077
13429,aicochow,2,0.00013,376774,24.13552,1561077
13430,aimichelle,2,0.00013,376776,24.13564,1561077
13431,ainuoyan,2,0.00013,376778,24.13577,1561077
13432,airstandley,2,0.00013,376780,24.13590,1561077
13433,aistoica,2,0.00013,376782,24.13603,1561077
13434,aitchjoe,2,0.00013,376784,24.13616,1561077
13435,aiyasong,2,0.00013,376786,24.13629,1561077
13436,aizzycb,2,0.00013,376788,24.13641,1561077
13437,ajarzyn,2,0.00013,376790,24.13654,1561077
13438,ajaybgupta,2,0.00013,376792,24.13667,1561077
13439,ajcamilo,2,0.00013,376794,24.13680,1561077
13440,ajddsolidaris,2,0.00013,376796,24.13693,1561077
13441,ajinkyakadam,2,0.00013,376798,24.13705,1561077
13442,ajith26061995,2,0.00013,376800,24.13718,1561077
13443,ajithhub,2,0.00013,376802,24.13731,1561077
13444,ajohnstonTC,2,0.00013,376804,24.13744,1561077
13445,aj-sharpe,2,0.00013,376806,24.13757,1561077
13446,ajshastri,2,0.00013,376808,24.13769,1561077
13447,ajurry,2,0.00013,376810,24.13782,1561077
13448,ajxb,2,0.00013,376812,24.13795,1561077
13449,akanksharma,2,0.00013,376814,24.13808,1561077
13450,akarnani,2,0.00013,376816,24.13821,1561077
13451,akarsh,2,0.00013,376818,24.13834,1561077
13452,akashfoss,2,0.00013,376820,24.13846,1561077
13453,Akayeshmantha,2,0.00013,376822,24.13859,1561077
13454,akeithball,2,0.00013,376824,24.13872,1561077
13455,akhabali,2,0.00013,376826,24.13885,1561077
13456,akhaku,2,0.00013,376828,24.13898,1561077
13457,akhileshthipparthi,2,0.00013,376830,24.13910,1561077
13458,aki017,2,0.00013,376832,24.13923,1561077
13459,akin-ozer,2,0.00013,376834,24.13936,1561077
13460,akirataguchi115,2,0.00013,376836,24.13949,1561077
13461,akkatracker,2,0.00013,376838,24.13962,1561077
13462,aklemp,2,0.00013,376840,24.13974,1561077
13463,aklochkovgd,2,0.00013,376842,24.13987,1561077
13464,AkMo3,2,0.00013,376844,24.14000,1561077
13465,akrevenya,2,0.00013,376846,24.14013,1561077
13466,akrikos,2,0.00013,376848,24.14026,1561077
13467,akshatKunwar,2,0.00013,376850,24.14039,1561077
13468,AkshayPathak,2,0.00013,376852,24.14051,1561077
13469,aksth,2,0.00013,376854,24.14064,1561077
13470,a-kulakov,2,0.00013,376856,24.14077,1561077
13471,AlainD-,2,0.00013,376858,24.14090,1561077
13472,alanb-sony,2,0.00013,376860,24.14103,1561077
13473,alanm11,2,0.00013,376862,24.14115,1561077
13474,alan-mas,2,0.00013,376864,24.14128,1561077
13475,alanreynosov,2,0.00013,376866,24.14141,1561077
13476,alany9552,2,0.00013,376868,24.14154,1561077
13477,alapshin,2,0.00013,376870,24.14167,1561077
13478,alayor,2,0.00013,376872,24.14179,1561077
13479,albertoal,2,0.00013,376874,24.14192,1561077
13480,albertoarias,2,0.00013,376876,24.14205,1561077
13481,albertsj1,2,0.00013,376878,24.14218,1561077
13482,albertxie,2,0.00013,376880,24.14231,1561077
13483,albustax,2,0.00013,376882,24.14243,1561077
13484,alclonky,2,0.00013,376884,24.14256,1561077
13485,aleiphoenix,2,0.00013,376886,24.14269,1561077
13486,alejozlv,2,0.00013,376888,24.14282,1561077
13487,aleksa2808,2,0.00013,376890,24.14295,1561077
13488,AleksanderBG,2,0.00013,376892,24.14308,1561077
13489,aleksandra-tarkowska,2,0.00013,376894,24.14320,1561077
13490,AleksandrNull,2,0.00013,376896,24.14333,1561077
13491,AleMartinez-Devops,2,0.00013,376898,24.14346,1561077
13492,AlerantAppNGIN,2,0.00013,376900,24.14359,1561077
13493,aleskandro,2,0.00013,376902,24.14372,1561077
13494,alessiotrivisonno,2,0.00013,376904,24.14384,1561077
13495,alex067,2,0.00013,376906,24.14397,1561077
13496,alex131290,2,0.00013,376908,24.14410,1561077
13497,alex4108,2,0.00013,376910,24.14423,1561077
13498,AlexandarY,2,0.00013,376912,24.14436,1561077
13499,Alexander1972,2,0.00013,376914,24.14448,1561077
13500,alexanderjohn,2,0.00013,376916,24.14461,1561077
13501,Alexander-Paeshin,2,0.00013,376918,24.14474,1561077
13502,alexandersavin93,2,0.00013,376920,24.14487,1561077
13503,alexandru-georgescu-hs,2,0.00013,376922,24.14500,1561077
13504,AlexAtLeanPath,2,0.00013,376924,24.14513,1561077
13505,alexberry,2,0.00013,376926,24.14525,1561077
13506,alexbramham,2,0.00013,376928,24.14538,1561077
13507,alexburlton,2,0.00013,376930,24.14551,1561077
13508,alexcern,2,0.00013,376932,24.14564,1561077
13509,alexcfaber,2,0.00013,376934,24.14577,1561077
13510,alexei-znamensky-movile,2,0.00013,376936,24.14589,1561077
13511,AlexeyCL,2,0.00013,376938,24.14602,1561077
13512,alexeyc-lohika-tix,2,0.00013,376940,24.14615,1561077
13513,alexey-panopta,2,0.00013,376942,24.14628,1561077
13514,AlexeyUzhva,2,0.00013,376944,24.14641,1561077
13515,AlexisMtr,2,0.00013,376946,24.14653,1561077
13516,alexlopashev,2,0.00013,376948,24.14666,1561077
13517,AlexMcDuffMiller,2,0.00013,376950,24.14679,1561077
13518,alexmcmillan,2,0.00013,376952,24.14692,1561077
13519,alexmreis,2,0.00013,376954,24.14705,1561077
13520,alexmufatti,2,0.00013,376956,24.14718,1561077
13521,alexpasca,2,0.00013,376958,24.14730,1561077
13522,alexrussell,2,0.00013,376960,24.14743,1561077
13523,alex-sainer,2,0.00013,376962,24.14756,1561077
13524,AlexSchultz-clumio,2,0.00013,376964,24.14769,1561077
13525,alexshenyuefei,2,0.00013,376966,24.14782,1561077
13526,alexsheppard11,2,0.00013,376968,24.14794,1561077
13527,alex-slynko-wonga,2,0.00013,376970,24.14807,1561077
13528,alexsniffin,2,0.00013,376972,24.14820,1561077
13529,alextaran1996,2,0.00013,376974,24.14833,1561077
13530,AlexTzib,2,0.00013,376976,24.14846,1561077
13531,Alex-Vol,2,0.00013,376978,24.14858,1561077
13532,alfonsocora,2,0.00013,376980,24.14871,1561077
13533,algoRhythm99,2,0.00013,376982,24.14884,1561077
13534,aliaksei-karneyeu,2,0.00013,376984,24.14897,1561077
13535,alibazlamit,2,0.00013,376986,24.14910,1561077
13536,aligx,2,0.00013,376988,24.14923,1561077
13537,alinsoare,2,0.00013,376990,24.14935,1561077
13538,AlisterFields,2,0.00013,376992,24.14948,1561077
13539,alivespirit,2,0.00013,376994,24.14961,1561077
13540,alivx,2,0.00013,376996,24.14974,1561077
13541,aliyakamercan,2,0.00013,376998,24.14987,1561077
13542,alkazar,2,0.00013,377000,24.14999,1561077
13543,alkersan,2,0.00013,377002,24.15012,1561077
13544,allardhoeve,2,0.00013,377004,24.15025,1561077
13545,allen12921,2,0.00013,377006,24.15038,1561077
13546,allidev,2,0.00013,377008,24.15051,1561077
13547,AlliotTech,2,0.00013,377010,24.15063,1561077
13548,allyunion,2,0.00013,377012,24.15076,1561077
13549,almoskvin,2,0.00013,377014,24.15089,1561077
13550,alon-dotan-starkware,2,0.00013,377016,24.15102,1561077
13551,AlpherJang,2,0.00013,377018,24.15115,1561077
13552,Alps86,2,0.00013,377020,24.15128,1561077
13553,AlterMellion,2,0.00013,377022,24.15140,1561077
13554,AltranManatree,2,0.00013,377024,24.15153,1561077
13555,ALutchko,2,0.00013,377026,24.15166,1561077
13556,AlVoronin,2,0.00013,377028,24.15179,1561077
13557,alzahm,2,0.00013,377030,24.15192,1561077
13558,amanda-student,2,0.00013,377032,24.15204,1561077
13559,AmaniChou,2,0.00013,377034,24.15217,1561077
13560,Amanjain4269,2,0.00013,377036,24.15230,1561077
13561,aman-raza,2,0.00013,377038,24.15243,1561077
13562,amareshbonam,2,0.00013,377040,24.15256,1561077
13563,amareshray,2,0.00013,377042,24.15268,1561077
13564,amarlier,2,0.00013,377044,24.15281,1561077
13565,amb8l,2,0.00013,377046,24.15294,1561077
13566,ambition1,2,0.00013,377048,24.15307,1561077
13567,amccarty,2,0.00013,377050,24.15320,1561077
13568,amccrodan,2,0.00013,377052,24.15332,1561077
13569,amcghie,2,0.00013,377054,24.15345,1561077
13570,amdokamal,2,0.00013,377056,24.15358,1561077
13571,amelenty,2,0.00013,377058,24.15371,1561077
13572,a-mellor,2,0.00013,377060,24.15384,1561077
13573,amenaafreen,2,0.00013,377062,24.15397,1561077
13574,amenon90,2,0.00013,377064,24.15409,1561077
13575,amerkel2,2,0.00013,377066,24.15422,1561077
13576,Amerousful,2,0.00013,377068,24.15435,1561077
13577,amershhadee,2,0.00013,377070,24.15448,1561077
13578,amezentzev,2,0.00013,377072,24.15461,1561077
13579,amhest,2,0.00013,377074,24.15473,1561077
13580,aminJenkinsX,2,0.00013,377076,24.15486,1561077
13581,Amir345,2,0.00013,377078,24.15499,1561077
13582,amir-barkal,2,0.00013,377080,24.15512,1561077
13583,amirkrasnic,2,0.00013,377082,24.15525,1561077
13584,AmirWiener,2,0.00013,377084,24.15537,1561077
13585,amiryo,2,0.00013,377086,24.15550,1561077
13586,Amishakumari544,2,0.00013,377088,24.15563,1561077
13587,amit3992,2,0.00013,377090,24.15576,1561077
13588,amit-gueta,2,0.00013,377092,24.15589,1561077
13589,amith1108,2,0.00013,377094,24.15602,1561077
13590,amitlt,2,0.00013,377096,24.15614,1561077
13591,amitnanaware,2,0.00013,377098,24.15627,1561077
13592,amit-yp,2,0.00013,377100,24.15640,1561077
13593,Amjadhpc,2,0.00013,377102,24.15653,1561077
13594,amol-kalshetty,2,0.00013,377104,24.15666,1561077
13595,amolpg,2,0.00013,377106,24.15678,1561077
13596,amoravek,2,0.00013,377108,24.15691,1561077
13597,amorrortu,2,0.00013,377110,24.15704,1561077
13598,amphied,2,0.00013,377112,24.15717,1561077
13599,Amrkamel1,2,0.00013,377114,24.15730,1561077
13600,amruthapbhat,2,0.00013,377116,24.15742,1561077
13601,amueller0011stad,2,0.00013,377118,24.15755,1561077
13602,amulobaev-aurea,2,0.00013,377120,24.15768,1561077
13603,AmundsenJunior,2,0.00013,377122,24.15781,1561077
13604,amuresia,2,0.00013,377124,24.15794,1561077
13605,amyb12345,2,0.00013,377126,24.15807,1561077
13606,amy-bachir,2,0.00013,377128,24.15819,1561077
13607,anadimisra,2,0.00013,377130,24.15832,1561077
13608,analytically,2,0.00013,377132,24.15845,1561077
13609,anandautam1,2,0.00013,377134,24.15858,1561077
13610,anandavj,2,0.00013,377136,24.15871,1561077
13611,anandpalanisamy,2,0.00013,377138,24.15883,1561077
13612,AnAnonymousFriend,2,0.00013,377140,24.15896,1561077
13613,anantvardhan04,2,0.00013,377142,24.15909,1561077
13614,ananyahn,2,0.00013,377144,24.15922,1561077
13615,Anchal-kansal,2,0.00013,377146,24.15935,1561077
13616,andersonshatch,2,0.00013,377148,24.15947,1561077
13617,andgoldin,2,0.00013,377150,24.15960,1561077
13618,AndLindemann,2,0.00013,377152,24.15973,1561077
13619,andrask,2,0.00013,377154,24.15986,1561077
13620,andras-petres-ullink,2,0.00013,377156,24.15999,1561077
13621,andrcuns,2,0.00013,377158,24.16012,1561077
13622,andreadelfino,2,0.00013,377160,24.16024,1561077
13623,andrealai75,2,0.00013,377162,24.16037,1561077
13624,andrea-mosk,2,0.00013,377164,24.16050,1561077
13625,AndreasBergmeier6176,2,0.00013,377166,24.16063,1561077
13626,AndreasBS,2,0.00013,377168,24.16076,1561077
13627,andrechrist,2,0.00013,377170,24.16088,1561077
13628,andred,2,0.00013,377172,24.16101,1561077
13629,andrefmarques,2,0.00013,377174,24.16114,1561077
13630,andreihavri90,2,0.00013,377176,24.16127,1561077
13631,andreikom,2,0.00013,377178,24.16140,1561077
13632,andreisidorenko,2,0.00013,377180,24.16152,1561077
13633,andreisilviudragnea,2,0.00013,377182,24.16165,1561077
13634,andrejska,2,0.00013,377184,24.16178,1561077
13635,andrejs-sisojevs,2,0.00013,377186,24.16191,1561077
13636,AndresFPineros,2,0.00013,377188,24.16204,1561077
13637,andretw,2,0.00013,377190,24.16216,1561077
13638,andrewandante,2,0.00013,377192,24.16229,1561077
13639,andrew-est,2,0.00013,377194,24.16242,1561077
13640,andrewhaighcell,2,0.00013,377196,24.16255,1561077
13641,andrewjapar,2,0.00013,377198,24.16268,1561077
13642,andrewmcgilvray,2,0.00013,377200,24.16281,1561077
13643,andrewmelis,2,0.00013,377202,24.16293,1561077
13644,andrewnicols,2,0.00013,377204,24.16306,1561077
13645,Andrewpk,2,0.00013,377206,24.16319,1561077
13646,Andrey14-88,2,0.00013,377208,24.16332,1561077
13647,andreyakostovsap,2,0.00013,377210,24.16345,1561077
13648,AndreyBelym,2,0.00013,377212,24.16357,1561077
13649,andrey-bondar-dron,2,0.00013,377214,24.16370,1561077
13650,andrey-fomin,2,0.00013,377216,24.16383,1561077
13651,andreyshamray,2,0.00013,377218,24.16396,1561077
13652,andreyzh,2,0.00013,377220,24.16409,1561077
13653,andwaitforit,2,0.00013,377222,24.16421,1561077
13654,andydude,2,0.00013,377224,24.16434,1561077
13655,Andy-GetPostman,2,0.00013,377226,24.16447,1561077
13656,andygrove,2,0.00013,377228,24.16460,1561077
13657,andypeckys-vertex,2,0.00013,377230,24.16473,1561077
13658,angerson,2,0.00013,377232,24.16486,1561077
13659,anguswilliams,2,0.00013,377234,24.16498,1561077
13660,aniketkmindstix,2,0.00013,377236,24.16511,1561077
13661,anilsaini1212,2,0.00013,377238,24.16524,1561077
13662,anitawoodruff,2,0.00013,377240,24.16537,1561077
13663,anjaliojha1234563,2,0.00013,377242,24.16550,1561077
13664,Anjuyadav85,2,0.00013,377244,24.16562,1561077
13665,ankingcodes,2,0.00013,377246,24.16575,1561077
13666,ankithriday,2,0.00013,377248,24.16588,1561077
13667,ankitmi,2,0.00013,377250,24.16601,1561077
13668,anklohia,2,0.00013,377252,24.16614,1561077
13669,AnkurGel,2,0.00013,377254,24.16626,1561077
13670,ankurshashcode,2,0.00013,377256,24.16639,1561077
13671,ankushgoel27,2,0.00013,377258,24.16652,1561077
13672,anmcghie,2,0.00013,377260,24.16665,1561077
13673,anmolghosh,2,0.00013,377262,24.16678,1561077
13674,annettemccullough,2,0.00013,377264,24.16691,1561077
13675,anniekvandijk,2,0.00013,377266,24.16703,1561077
13676,anoppe,2,0.00013,377268,24.16716,1561077
13677,Ant0wan,2,0.00013,377270,24.16729,1561077
13678,anthonysuterag,2,0.00013,377272,24.16742,1561077
13679,AnthonyTonda,2,0.00013,377274,24.16755,1561077
13680,antibarbie,2,0.00013,377276,24.16767,1561077
13681,antikaspar,2,0.00013,377278,24.16780,1561077
13682,Antillean,2,0.00013,377280,24.16793,1561077
13683,antoiner77,2,0.00013,377282,24.16806,1561077
13684,antoninbiret,2,0.00013,377284,24.16819,1561077
13685,Antonio-Melo,2,0.00013,377286,24.16831,1561077
13686,antonio-petricca,2,0.00013,377288,24.16844,1561077
13687,AntoniusGolly,2,0.00013,377290,24.16857,1561077
13688,anton-mesnyankin,2,0.00013,377292,24.16870,1561077
13689,antonputra,2,0.00013,377294,24.16883,1561077
13690,antonsmyk,2,0.00013,377296,24.16896,1561077
13691,AntonTyutin,2,0.00013,377298,24.16908,1561077
13692,antooro,2,0.00013,377300,24.16921,1561077
13693,antwise,2,0.00013,377302,24.16934,1561077
13694,anu-baskar,2,0.00013,377304,24.16947,1561077
13695,AnubhavHawk,2,0.00013,377306,24.16960,1561077
13696,anujdevopslearn,2,0.00013,377308,24.16972,1561077
13697,anydoby,2,0.00013,377310,24.16985,1561077
13698,AnyISalIn,2,0.00013,377312,24.16998,1561077
13699,aoriglia,2,0.00013,377314,24.17011,1561077
13700,apahari,2,0.00013,377316,24.17024,1561077
13701,apallier,2,0.00013,377318,24.17036,1561077
13702,APEdevelopment,2,0.00013,377320,24.17049,1561077
13703,apelsina,2,0.00013,377322,24.17062,1561077
13704,apenen,2,0.00013,377324,24.17075,1561077
13705,apetro,2,0.00013,377326,24.17088,1561077
13706,apg84,2,0.00013,377328,24.17101,1561077
13707,apgsga-jhe,2,0.00013,377330,24.17113,1561077
13708,apieraf,2,0.00013,377332,24.17126,1561077
13709,apilikov,2,0.00013,377334,24.17139,1561077
13710,aplsek,2,0.00013,377336,24.17152,1561077
13711,apohorilyi,2,0.00013,377338,24.17165,1561077
13712,aporthos974,2,0.00013,377340,24.17177,1561077
13713,aporwal3,2,0.00013,377342,24.17190,1561077
13714,approximatenumber,2,0.00013,377344,24.17203,1561077
13715,aprueller,2,0.00013,377346,24.17216,1561077
13716,aps554,2,0.00013,377348,24.17229,1561077
13717,aptester,2,0.00013,377350,24.17241,1561077
13718,ar2rh,2,0.00013,377352,24.17254,1561077
13719,Aradesk,2,0.00013,377354,24.17267,1561077
13720,arahja,2,0.00013,377356,24.17280,1561077
13721,arana198,2,0.00013,377358,24.17293,1561077
13722,arareko,2,0.00013,377360,24.17305,1561077
13723,Aravindan,2,0.00013,377362,24.17318,1561077
13724,Aravindios,2,0.00013,377364,24.17331,1561077
13725,arbabnazar,2,0.00013,377366,24.17344,1561077
13726,archmonk,2,0.00013,377368,24.17357,1561077
13727,arcones,2,0.00013,377370,24.17370,1561077
13728,arctouch-laurentinoneto,2,0.00013,377372,24.17382,1561077
13729,arcvpatel,2,0.00013,377374,24.17395,1561077
13730,Ardem,2,0.00013,377376,24.17408,1561077
13731,arekfu,2,0.00013,377378,24.17421,1561077
13732,argoyal,2,0.00013,377380,24.17434,1561077
13733,arianne-detorres,2,0.00013,377382,24.17446,1561077
13734,arielril,2,0.00013,377384,24.17459,1561077
13735,ariessanchezsulit,2,0.00013,377386,24.17472,1561077
13736,arijeet-majumdar,2,0.00013,377388,24.17485,1561077
13737,aritratony,2,0.00013,377390,24.17498,1561077
13738,arjang,2,0.00013,377392,24.17510,1561077
13739,arjunmenon,2,0.00013,377394,24.17523,1561077
13740,arko-r,2,0.00013,377396,24.17536,1561077
13741,armbraggins,2,0.00013,377398,24.17549,1561077
13742,armorKing11,2,0.00013,377400,24.17562,1561077
13743,arnestorksen,2,0.00013,377402,24.17575,1561077
13744,arnihermann,2,0.00013,377404,24.17587,1561077
13745,arnitolog,2,0.00013,377406,24.17600,1561077
13746,arnlaugsson,2,0.00013,377408,24.17613,1561077
13747,ARogovsky,2,0.00013,377410,24.17626,1561077
13748,arpiatek,2,0.00013,377412,24.17639,1561077
13749,arpita02-98,2,0.00013,377414,24.17651,1561077
13750,arpt,2,0.00013,377416,24.17664,1561077
13751,ar-qun,2,0.00013,377418,24.17677,1561077
13752,arseniybanayev,2,0.00013,377420,24.17690,1561077
13753,arslanjavaid1,2,0.00013,377422,24.17703,1561077
13754,Artalus,2,0.00013,377424,24.17715,1561077
13755,artem-kosenko,2,0.00013,377426,24.17728,1561077
13756,artevel,2,0.00013,377428,24.17741,1561077
13757,artgon,2,0.00013,377430,24.17754,1561077
13758,arthurflame,2,0.00013,377432,24.17767,1561077
13759,ArtikUA,2,0.00013,377434,24.17780,1561077
13760,artjomaverin,2,0.00013,377436,24.17792,1561077
13761,artlovecode,2,0.00013,377438,24.17805,1561077
13762,artur-borys,2,0.00013,377440,24.17818,1561077
13763,arturmkr,2,0.00013,377442,24.17831,1561077
13764,Artuto,2,0.00013,377444,24.17844,1561077
13765,arungeorge101,2,0.00013,377446,24.17856,1561077
13766,arunskurian,2,0.00013,377448,24.17869,1561077
13767,arunssasidhar,2,0.00013,377450,24.17882,1561077
13768,arvera,2,0.00013,377452,24.17895,1561077
13769,Arymtoteles,2,0.00013,377454,24.17908,1561077
13770,asafm,2,0.00013,377456,24.17920,1561077
13771,asafpelegcodes,2,0.00013,377458,24.17933,1561077
13772,asc3ns10n,2,0.00013,377460,24.17946,1561077
13773,ascarpino,2,0.00013,377462,24.17959,1561077
13774,ascotti-beyond,2,0.00013,377464,24.17972,1561077
13775,ascottix,2,0.00013,377466,24.17985,1561077
13776,AScripnic,2,0.00013,377468,24.17997,1561077
13777,Asday,2,0.00013,377470,24.18010,1561077
13778,asetty,2,0.00013,377472,24.18023,1561077
13779,asgeirf,2,0.00013,377474,24.18036,1561077
13780,ashashev,2,0.00013,377476,24.18049,1561077
13781,asherber,2,0.00013,377478,24.18061,1561077
13782,asherungar-ceva,2,0.00013,377480,24.18074,1561077
13783,ashes999,2,0.00013,377482,24.18087,1561077
13784,ashish-ck,2,0.00013,377484,24.18100,1561077
13785,ashishjuyal,2,0.00013,377486,24.18113,1561077
13786,ashishmusale,2,0.00013,377488,24.18125,1561077
13787,ashishparkhi,2,0.00013,377490,24.18138,1561077
13788,Ashissh021,2,0.00013,377492,24.18151,1561077
13789,AshitaSingamsetty,2,0.00013,377494,24.18164,1561077
13790,ashleymercer,2,0.00013,377496,24.18177,1561077
13791,ashoofly,2,0.00013,377498,24.18189,1561077
13792,ashpreet-dlt,2,0.00013,377500,24.18202,1561077
13793,asi-cider,2,0.00013,377502,24.18215,1561077
13794,asidorenko-nexonia,2,0.00013,377504,24.18228,1561077
13795,asirbu2002,2,0.00013,377506,24.18241,1561077
13796,askmike1,2,0.00013,377508,24.18254,1561077
13797,asknet,2,0.00013,377510,24.18266,1561077
13798,asloan7,2,0.00013,377512,24.18279,1561077
13799,asmith34,2,0.00013,377514,24.18292,1561077
13800,asos-VasilisKortsimelidis,2,0.00013,377516,24.18305,1561077
13801,astifter,2,0.00013,377518,24.18318,1561077
13802,AStuntman,2,0.00013,377520,24.18330,1561077
13803,aszmyd,2,0.00013,377522,24.18343,1561077
13804,atanner27,2,0.00013,377524,24.18356,1561077
13805,ataylor-r7,2,0.00013,377526,24.18369,1561077
13806,athamour1,2,0.00013,377528,24.18382,1561077
13807,athingisathing,2,0.00013,377530,24.18394,1561077
13808,athoma13,2,0.00013,377532,24.18407,1561077
13809,atiniir,2,0.00013,377534,24.18420,1561077
13810,AtrikeshM,2,0.00013,377536,24.18433,1561077
13811,AtulRajput01,2,0.00013,377538,24.18446,1561077
13812,atul-tewari,2,0.00013,377540,24.18459,1561077
13813,aubertaa,2,0.00013,377542,24.18471,1561077
13814,aureliesalles,2,0.00013,377544,24.18484,1561077
13815,auselen,2,0.00013,377546,24.18497,1561077
13816,austen-herbst,2,0.00013,377548,24.18510,1561077
13817,austinfath,2,0.00013,377550,24.18523,1561077
13818,austinlawless,2,0.00013,377552,24.18535,1561077
13819,avakkachen,2,0.00013,377554,24.18548,1561077
13820,avara1986,2,0.00013,377556,24.18561,1561077
13821,avbasov,2,0.00013,377558,24.18574,1561077
13822,avblink,2,0.00013,377560,24.18587,1561077
13823,AvdhutPandit,2,0.00013,377562,24.18599,1561077
13824,aventadorm,2,0.00013,377564,24.18612,1561077
13825,avijitsarkar123,2,0.00013,377566,24.18625,1561077
13826,avonengel,2,0.00013,377568,24.18638,1561077
13827,avshimo,2,0.00013,377570,24.18651,1561077
13828,awang-parasoft,2,0.00013,377572,24.18664,1561077
13829,AWesthoff,2,0.00013,377574,24.18676,1561077
13830,awilkins-frel,2,0.00013,377576,24.18689,1561077
13831,awithersdd,2,0.00013,377578,24.18702,1561077
13832,awright-oak9,2,0.00013,377580,24.18715,1561077
13833,axel-h,2,0.00013,377582,24.18728,1561077
13834,AxelNennker,2,0.00013,377584,24.18740,1561077
13835,axiix-sr,2,0.00013,377586,24.18753,1561077
13836,ayesha-fir,2,0.00013,377588,24.18766,1561077
13837,ayk33,2,0.00013,377590,24.18779,1561077
13838,ayoub-benali,2,0.00013,377592,24.18792,1561077
13839,ayushvar,2,0.00013,377594,24.18804,1561077
13840,aziziazizan9,2,0.00013,377596,24.18817,1561077
13841,Azulinho,2,0.00013,377598,24.18830,1561077
13842,b0rengar,2,0.00013,377600,24.18843,1561077
13843,b4oshany,2,0.00013,377602,24.18856,1561077
13844,baarse,2,0.00013,377604,24.18869,1561077
13845,babanjot,2,0.00013,377606,24.18881,1561077
13846,bad2cat,2,0.00013,377608,24.18894,1561077
13847,BadForYa,2,0.00013,377610,24.18907,1561077
13848,badmadrad,2,0.00013,377612,24.18920,1561077
13849,Badspler,2,0.00013,377614,24.18933,1561077
13850,bahrmichael,2,0.00013,377616,24.18945,1561077
13851,baijupadmanabhan,2,0.00013,377618,24.18958,1561077
13852,bajajamit01,2,0.00013,377620,24.18971,1561077
13853,Bajotumn,2,0.00013,377622,24.18984,1561077
13854,balawama,2,0.00013,377624,24.18997,1561077
13855,baldrs,2,0.00013,377626,24.19009,1561077
13856,ballwood,2,0.00013,377628,24.19022,1561077
13857,bandoshintaro,2,0.00013,377630,24.19035,1561077
13858,bane73,2,0.00013,377632,24.19048,1561077
13859,banghuaji,2,0.00013,377634,24.19061,1561077
13860,Banibaal,2,0.00013,377636,24.19073,1561077
13861,bansalp004,2,0.00013,377638,24.19086,1561077
13862,baoxiaopan,2,0.00013,377640,24.19099,1561077
13863,barakwei,2,0.00013,377642,24.19112,1561077
13864,baranowb,2,0.00013,377644,24.19125,1561077
13865,bardyr,2,0.00013,377646,24.19138,1561077
13866,barefootcaveman,2,0.00013,377648,24.19150,1561077
13867,barissimsek,2,0.00013,377650,24.19163,1561077
13868,baritonehands,2,0.00013,377652,24.19176,1561077
13869,barretts,2,0.00013,377654,24.19189,1561077
13870,barryhagan,2,0.00013,377656,24.19202,1561077
13871,bartlomiejsawicki,2,0.00013,377658,24.19214,1561077
13872,bartos,2,0.00013,377660,24.19227,1561077
13873,bartoszkosiorek-tomtom,2,0.00013,377662,24.19240,1561077
13874,basava12345,2,0.00013,377664,24.19253,1561077
13875,bashbang,2,0.00013,377666,24.19266,1561077
13876,basilboonk,2,0.00013,377668,24.19278,1561077
13877,bayeslearner,2,0.00013,377670,24.19291,1561077
13878,bazimov,2,0.00013,377672,24.19304,1561077
13879,bbergquist0930,2,0.00013,377674,24.19317,1561077
13880,bbgobie,2,0.00013,377676,24.19330,1561077
13881,bblay,2,0.00013,377678,24.19343,1561077
13882,bblondin,2,0.00013,377680,24.19355,1561077
13883,bcarpio,2,0.00013,377682,24.19368,1561077
13884,bchbchbch,2,0.00013,377684,24.19381,1561077
13885,bchuntley,2,0.00013,377686,24.19394,1561077
13886,bcooleyViasat,2,0.00013,377688,24.19407,1561077
13887,bcoveny,2,0.00013,377690,24.19419,1561077
13888,bcuff,2,0.00013,377692,24.19432,1561077
13889,bdefeyter,2,0.00013,377694,24.19445,1561077
13890,bdeneuter,2,0.00013,377696,24.19458,1561077
13891,bdhaak,2,0.00013,377698,24.19471,1561077
13892,bdmorgan,2,0.00013,377700,24.19483,1561077
13893,bdovaz,2,0.00013,377702,24.19496,1561077
13894,Beast12,2,0.00013,377704,24.19509,1561077
13895,Bebef,2,0.00013,377706,24.19522,1561077
13896,BeChris,2,0.00013,377708,24.19535,1561077
13897,bedge,2,0.00013,377710,24.19548,1561077
13898,b-edwin-bianchi,2,0.00013,377712,24.19560,1561077
13899,beedemo,2,0.00013,377714,24.19573,1561077
13900,beiske,2,0.00013,377716,24.19586,1561077
13901,Belluk,2,0.00013,377718,24.19599,1561077
13902,bemsha,2,0.00013,377720,24.19612,1561077
13903,ben8p,2,0.00013,377722,24.19624,1561077
13904,benbenja,2,0.00013,377724,24.19637,1561077
13905,BenCoffeed,2,0.00013,377726,24.19650,1561077
13906,benday280412,2,0.00013,377728,24.19663,1561077
13907,benhamidene,2,0.00013,377730,24.19676,1561077
13908,benholtz,2,0.00013,377732,24.19688,1561077
13909,benhot,2,0.00013,377734,24.19701,1561077
13910,beniamin-kis,2,0.00013,377736,24.19714,1561077
13911,benke33,2,0.00013,377738,24.19727,1561077
13912,benkiefer,2,0.00013,377740,24.19740,1561077
13913,BenKletzine,2,0.00013,377742,24.19753,1561077
13914,benmullin333,2,0.00013,377744,24.19765,1561077
13915,Benny-Beermann,2,0.00013,377746,24.19778,1561077
13916,Benoit-DunandLaisin,2,0.00013,377748,24.19791,1561077
13917,benoitm76,2,0.00013,377750,24.19804,1561077
13918,bentlifetattoo,2,0.00013,377752,24.19817,1561077
13919,benweissmann,2,0.00013,377754,24.19829,1561077
13920,benzionyunger,2,0.00013,377756,24.19842,1561077
13921,berezhinskiy,2,0.00013,377758,24.19855,1561077
13922,berkesokhan,2,0.00013,377760,24.19868,1561077
13923,BerkOFF,2,0.00013,377762,24.19881,1561077
13924,BernandoLR,2,0.00013,377764,24.19893,1561077
13925,bernard-wagner,2,0.00013,377766,24.19906,1561077
13926,BernhardBerbuir,2,0.00013,377768,24.19919,1561077
13927,bertagaz,2,0.00013,377770,24.19932,1561077
13928,bertbuchholz,2,0.00013,377772,24.19945,1561077
13929,bertouttier,2,0.00013,377774,24.19958,1561077
13930,bertpersyn,2,0.00013,377776,24.19970,1561077
13931,berwyn,2,0.00013,377778,24.19983,1561077
13932,beykery,2,0.00013,377780,24.19996,1561077
13933,bfloyd89,2,0.00013,377782,24.20009,1561077
13934,bgeesaman,2,0.00013,377784,24.20022,1561077
13935,bgehman,2,0.00013,377786,24.20034,1561077
13936,bgloeckle,2,0.00013,377788,24.20047,1561077
13937,bgottfried91,2,0.00013,377790,24.20060,1561077
13938,bgreeley,2,0.00013,377792,24.20073,1561077
13939,bharathrajbk,2,0.00013,377794,24.20086,1561077
13940,bharsh,2,0.00013,377796,24.20098,1561077
13941,bhat-man,2,0.00013,377798,24.20111,1561077
13942,bhenderson,2,0.00013,377800,24.20124,1561077
13943,bheupers,2,0.00013,377802,24.20137,1561077
13944,bhgraham,2,0.00013,377804,24.20150,1561077
13945,Bhiva-b,2,0.00013,377806,24.20162,1561077
13946,bhouston,2,0.00013,377808,24.20175,1561077
13947,bhumika-goyal,2,0.00013,377810,24.20188,1561077
13948,bhuvanbhatt84,2,0.00013,377812,24.20201,1561077
13949,biels,2,0.00013,377814,24.20214,1561077
13950,bigedd6513,2,0.00013,377816,24.20227,1561077
13951,bigloupe,2,0.00013,377818,24.20239,1561077
13952,bigmoby,2,0.00013,377820,24.20252,1561077
13953,bigpuritz,2,0.00013,377822,24.20265,1561077
13954,bigwheels16,2,0.00013,377824,24.20278,1561077
13955,bikwan,2,0.00013,377826,24.20291,1561077
13956,bilke,2,0.00013,377828,24.20303,1561077
13957,billcchung,2,0.00013,377830,24.20316,1561077
13958,billism1,2,0.00013,377832,24.20329,1561077
13959,billyteves,2,0.00013,377834,24.20342,1561077
13960,binishababu,2,0.00013,377836,24.20355,1561077
13961,binlab,2,0.00013,377838,24.20367,1561077
13962,binoydev,2,0.00013,377840,24.20380,1561077
13963,BipinXavier,2,0.00013,377842,24.20393,1561077
13964,birfincankafein,2,0.00013,377844,24.20406,1561077
13965,Bitals,2,0.00013,377846,24.20419,1561077
13966,bitcoder,2,0.00013,377848,24.20432,1561077
13967,bitmeise,2,0.00013,377850,24.20444,1561077
13968,bitonator,2,0.00013,377852,24.20457,1561077
13969,bixycler,2,0.00013,377854,24.20470,1561077
13970,bjacobs1,2,0.00013,377856,24.20483,1561077
13971,bjakubiak,2,0.00013,377858,24.20496,1561077
13972,bjmi,2,0.00013,377860,24.20508,1561077
13973,Bjorn576,2,0.00013,377862,24.20521,1561077
13974,bjornbak,2,0.00013,377864,24.20534,1561077
13975,bjusufbe,2,0.00013,377866,24.20547,1561077
13976,bkahlerventer,2,0.00013,377868,24.20560,1561077
13977,bkwart,2,0.00013,377870,24.20572,1561077
13978,Blackbaud-JagjeetChadha,2,0.00013,377872,24.20585,1561077
13979,Blackbaud-JasonCrowe,2,0.00013,377874,24.20598,1561077
13980,black-mirror-1,2,0.00013,377876,24.20611,1561077
13981,Blacktiger,2,0.00013,377878,24.20624,1561077
13982,bladerunner512,2,0.00013,377880,24.20637,1561077
13983,blaines,2,0.00013,377882,24.20649,1561077
13984,blaketmiller,2,0.00013,377884,24.20662,1561077
13985,blastik,2,0.00013,377886,24.20675,1561077
13986,blocknotes,2,0.00013,377888,24.20688,1561077
13987,blontic,2,0.00013,377890,24.20701,1561077
13988,blueandgold,2,0.00013,377892,24.20713,1561077
13989,bluejaguar,2,0.00013,377894,24.20726,1561077
13990,blundell,2,0.00013,377896,24.20739,1561077
13991,blundercon,2,0.00013,377898,24.20752,1561077
13992,BLWood,2,0.00013,377900,24.20765,1561077
13993,bmenasha,2,0.00013,377902,24.20777,1561077
13994,bmiguel-teixeira,2,0.00013,377904,24.20790,1561077
13995,BMOD89,2,0.00013,377906,24.20803,1561077
13996,bmordue,2,0.00013,377908,24.20816,1561077
13997,boazetsec,2,0.00013,377910,24.20829,1561077
13998,bobbetter,2,0.00013,377912,24.20842,1561077
13999,BobDu,2,0.00013,377914,24.20854,1561077
14000,Bobillot,2,0.00013,377916,24.20867,1561077
14001,bobowang2017,2,0.00013,377918,24.20880,1561077
14002,bobsru,2,0.00013,377920,24.20893,1561077
14003,BocharnikovDmitry,2,0.00013,377922,24.20906,1561077
14004,bochen87,2,0.00013,377924,24.20918,1561077
14005,bochulindra,2,0.00013,377926,24.20931,1561077
14006,bodhi-one,2,0.00013,377928,24.20944,1561077
14007,Bogus-Coder,2,0.00013,377930,24.20957,1561077
14008,bols-blue,2,0.00013,377932,24.20970,1561077
14009,bolt-alex-somai,2,0.00013,377934,24.20982,1561077
14010,Bomme,2,0.00013,377936,24.20995,1561077
14011,bond-os,2,0.00013,377938,24.21008,1561077
14012,Bonsomer,2,0.00013,377940,24.21021,1561077
14013,boostrack,2,0.00013,377942,24.21034,1561077
14014,boris779,2,0.00013,377944,24.21046,1561077
14015,borisyukd,2,0.00013,377946,24.21059,1561077
14016,BorX,2,0.00013,377948,24.21072,1561077
14017,BorysDrozhak,2,0.00013,377950,24.21085,1561077
14018,botchniaque,2,0.00013,377952,24.21098,1561077
14019,bo-tu,2,0.00013,377954,24.21111,1561077
14020,Boumbles,2,0.00013,377956,24.21123,1561077
14021,bpazera,2,0.00013,377958,24.21136,1561077
14022,bpinske,2,0.00013,377960,24.21149,1561077
14023,bpotere,2,0.00013,377962,24.21162,1561077
14024,bradleydamato,2,0.00013,377964,24.21175,1561077
14025,bradrhod,2,0.00013,377966,24.21187,1561077
14026,brainsam,2,0.00013,377968,24.21200,1561077
14027,brandones,2,0.00013,377970,24.21213,1561077
14028,brauliobezerra,2,0.00013,377972,24.21226,1561077
14029,braunly,2,0.00013,377974,24.21239,1561077
14030,BreaGaudioso,2,0.00013,377976,24.21251,1561077
14031,BreakBB,2,0.00013,377978,24.21264,1561077
14032,bremac,2,0.00013,377980,24.21277,1561077
14033,bremnes,2,0.00013,377982,24.21290,1561077
14034,brentley,2,0.00013,377984,24.21303,1561077
14035,brentm5,2,0.00013,377986,24.21316,1561077
14036,Bresiu,2,0.00013,377988,24.21328,1561077
14037,Brhett,2,0.00013,377990,24.21341,1561077
14038,briancole01,2,0.00013,377992,24.21354,1561077
14039,BriandUlysse,2,0.00013,377994,24.21367,1561077
14040,briankabuyesonos,2,0.00013,377996,24.21380,1561077
14041,brianmori,2,0.00013,377998,24.21392,1561077
14042,BrianRossmajer,2,0.00013,378000,24.21405,1561077
14043,briansneddon,2,0.00013,378002,24.21418,1561077
14044,briceruzand,2,0.00013,378004,24.21431,1561077
14045,Brick7Face,2,0.00013,378006,24.21444,1561077
14046,bridadan,2,0.00013,378008,24.21456,1561077
14047,BringWookieToMe,2,0.00013,378010,24.21469,1561077
14048,Bronco-Lopez,2,0.00013,378012,24.21482,1561077
14049,bronik,2,0.00013,378014,24.21495,1561077
14050,brookeireland,2,0.00013,378016,24.21508,1561077
14051,brownp2k,2,0.00013,378018,24.21521,1561077
14052,brthor,2,0.00013,378020,24.21533,1561077
14053,bruce-szalwinski,2,0.00013,378022,24.21546,1561077
14054,brucex,2,0.00013,378024,24.21559,1561077
14055,BrundaBS,2,0.00013,378026,24.21572,1561077
14056,brunnert,2,0.00013,378028,24.21585,1561077
14057,brunoballekens,2,0.00013,378030,24.21597,1561077
14058,brunobasto,2,0.00013,378032,24.21610,1561077
14059,brunocarneiro,2,0.00013,378034,24.21623,1561077
14060,brusdev,2,0.00013,378036,24.21636,1561077
14061,bruvik,2,0.00013,378038,24.21649,1561077
14062,brx19,2,0.00013,378040,24.21661,1561077
14063,bryanlaura736,2,0.00013,378042,24.21674,1561077
14064,Bryann,2,0.00013,378044,24.21687,1561077
14065,bryanpatton,2,0.00013,378046,24.21700,1561077
14066,bryceyang,2,0.00013,378048,24.21713,1561077
14067,BrydenOliver,2,0.00013,378050,24.21726,1561077
14068,bsama,2,0.00013,378052,24.21738,1561077
14069,bschulte,2,0.00013,378054,24.21751,1561077
14070,bseib,2,0.00013,378056,24.21764,1561077
14071,bshah0408,2,0.00013,378058,24.21777,1561077
14072,bskrtich,2,0.00013,378060,24.21790,1561077
14073,bsmithyman,2,0.00013,378062,24.21802,1561077
14074,bsquizz,2,0.00013,378064,24.21815,1561077
14075,bthharper,2,0.00013,378066,24.21828,1561077
14076,BubacarrC,2,0.00013,378068,24.21841,1561077
14077,budtmo,2,0.00013,378070,24.21854,1561077
14078,buffcode,2,0.00013,378072,24.21866,1561077
14079,buggyb12,2,0.00013,378074,24.21879,1561077
14080,bugsbunnyshah,2,0.00013,378076,24.21892,1561077
14081,bugsduggan,2,0.00013,378078,24.21905,1561077
14082,BuhtigithuB,2,0.00013,378080,24.21918,1561077
14083,Bukama,2,0.00013,378082,24.21931,1561077
14084,bukovjanmic,2,0.00013,378084,24.21943,1561077
14085,bulnv,2,0.00013,378086,24.21956,1561077
14086,bureauguy,2,0.00013,378088,24.21969,1561077
14087,burghduffkc,2,0.00013,378090,24.21982,1561077
14088,bvaksdal-20,2,0.00013,378092,24.21995,1561077
14089,bvarner,2,0.00013,378094,24.22007,1561077
14090,bwmaas,2,0.00013,378096,24.22020,1561077
14091,byrner75,2,0.00013,378098,24.22033,1561077
14092,byronmansfield,2,0.00013,378100,24.22046,1561077
14093,c0t0d0s1,2,0.00013,378102,24.22059,1561077
14094,c3p0-maif,2,0.00013,378104,24.22071,1561077
14095,cafedeflore,2,0.00013,378106,24.22084,1561077
14096,cah-louis-verzi,2,0.00013,378108,24.22097,1561077
14097,caijh,2,0.00013,378110,24.22110,1561077
14098,calebjsmith7,2,0.00013,378112,24.22123,1561077
14099,calmandniceperson,2,0.00013,378114,24.22135,1561077
14100,CalvinAllen,2,0.00013,378116,24.22148,1561077
14101,cameron314,2,0.00013,378118,24.22161,1561077
14102,camerontesterman,2,0.00013,378120,24.22174,1561077
14103,cam-itv,2,0.00013,378122,24.22187,1561077
14104,camperjett,2,0.00013,378124,24.22200,1561077
14105,Camusensei,2,0.00013,378126,24.22212,1561077
14106,canadiancreed,2,0.00013,378128,24.22225,1561077
14107,CanboSaha,2,0.00013,378130,24.22238,1561077
14108,caneleex,2,0.00013,378132,24.22251,1561077
14109,canit00,2,0.00013,378134,24.22264,1561077
14110,caongocthai,2,0.00013,378136,24.22276,1561077
14111,capeflynn,2,0.00013,378138,24.22289,1561077
14112,CaporalDead,2,0.00013,378140,24.22302,1561077
14113,CapriciousRebel,2,0.00013,378142,24.22315,1561077
14114,CaptainPatate,2,0.00013,378144,24.22328,1561077
14115,capturematt,2,0.00013,378146,24.22340,1561077
14116,carehart,2,0.00013,378148,24.22353,1561077
14117,carlfriedrich,2,0.00013,378150,24.22366,1561077
14118,carlochess,2,0.00013,378152,24.22379,1561077
14119,carlos4242,2,0.00013,378154,24.22392,1561077
14120,carlosignaciom,2,0.00013,378156,24.22405,1561077
14121,carlossmartini,2,0.00013,378158,24.22417,1561077
14122,carltonwhitehead,2,0.00013,378160,24.22430,1561077
14123,carocad,2,0.00013,378162,24.22443,1561077
14124,carpediem-777,2,0.00013,378164,24.22456,1561077
14125,carsongee,2,0.00013,378166,24.22469,1561077
14126,carsonmclean,2,0.00013,378168,24.22481,1561077
14127,caspercba,2,0.00013,378170,24.22494,1561077
14128,caugello,2,0.00013,378172,24.22507,1561077
14129,cawolfkreo,2,0.00013,378174,24.22520,1561077
14130,cbamelis,2,0.00013,378176,24.22533,1561077
14131,cboves,2,0.00013,378178,24.22545,1561077
14132,cbpr,2,0.00013,378180,24.22558,1561077
14133,CBR09,2,0.00013,378182,24.22571,1561077
14134,cbuckleytbi,2,0.00013,378184,24.22584,1561077
14135,cbuechler,2,0.00013,378186,24.22597,1561077
14136,cburlacu,2,0.00013,378188,24.22610,1561077
14137,cccaternberg,2,0.00013,378190,24.22622,1561077
14138,cchar,2,0.00013,378192,24.22635,1561077
14139,cchesser,2,0.00013,378194,24.22648,1561077
14140,ccppoo,2,0.00013,378196,24.22661,1561077
14141,cddeleon,2,0.00013,378198,24.22674,1561077
14142,cdknorow,2,0.00013,378200,24.22686,1561077
14143,CedricGatay,2,0.00013,378202,24.22699,1561077
14144,cedricje,2,0.00013,378204,24.22712,1561077
14145,cedrico2016,2,0.00013,378206,24.22725,1561077
14146,Celebes,2,0.00013,378208,24.22738,1561077
14147,CelesteGH,2,0.00013,378210,24.22750,1561077
14148,cesarjorgemartinez,2,0.00013,378212,24.22763,1561077
14149,cesarpball,2,0.00013,378214,24.22776,1561077
14150,cfregly,2,0.00013,378216,24.22789,1561077
14151,CGarces,2,0.00013,378218,24.22802,1561077
14152,cgarcia2863,2,0.00013,378220,24.22815,1561077
14153,CGavrila,2,0.00013,378222,24.22827,1561077
14154,cglrkn,2,0.00013,378224,24.22840,1561077
14155,cgrubesol,2,0.00013,378226,24.22853,1561077
14156,cgudrian,2,0.00013,378228,24.22866,1561077
14157,chabom2017,2,0.00013,378230,24.22879,1561077
14158,chadburrus,2,0.00013,378232,24.22891,1561077
14159,chainlink,2,0.00013,378234,24.22904,1561077
14160,chaitanyakuber,2,0.00013,378236,24.22917,1561077
14161,ChaitanyaPramod,2,0.00013,378238,24.22930,1561077
14162,chaiwatmat,2,0.00013,378240,24.22943,1561077
14163,chakraborty89subhajit,2,0.00013,378242,24.22955,1561077
14164,Chandana-pabathi,2,0.00013,378244,24.22968,1561077
14165,chandrapola,2,0.00013,378246,24.22981,1561077
14166,changmink,2,0.00013,378248,24.22994,1561077
14167,chanj14ebsco,2,0.00013,378250,24.23007,1561077
14168,chapmanc,2,0.00013,378252,24.23019,1561077
14169,charan28,2,0.00013,378254,24.23032,1561077
14170,charford,2,0.00013,378256,24.23045,1561077
14171,charleshamel73,2,0.00013,378258,24.23058,1561077
14172,charlesivie,2,0.00013,378260,24.23071,1561077
14173,charlottehoare,2,0.00013,378262,24.23084,1561077
14174,chasip,2,0.00013,378264,24.23096,1561077
14175,chattr,2,0.00013,378266,24.23109,1561077
14176,chauhang,2,0.00013,378268,24.23122,1561077
14177,chawkins88,2,0.00013,378270,24.23135,1561077
14178,chazzly,2,0.00013,378272,24.23148,1561077
14179,chdavi,2,0.00013,378274,24.23160,1561077
14180,chder,2,0.00013,378276,24.23173,1561077
14181,chEbba,2,0.00013,378278,24.23186,1561077
14182,cheesesashimi,2,0.00013,378280,24.23199,1561077
14183,cheetisrinivas,2,0.00013,378282,24.23212,1561077
14184,chefren,2,0.00013,378284,24.23224,1561077
14185,chefsa,2,0.00013,378286,24.23237,1561077
14186,chelnak,2,0.00013,378288,24.23250,1561077
14187,chenchensheng,2,0.00013,378290,24.23263,1561077
14188,chenkychenko,2,0.00013,378292,24.23276,1561077
14189,ChenMin46,2,0.00013,378294,24.23289,1561077
14190,chenqiaorui,2,0.00013,378296,24.23301,1561077
14191,chenyan0107,2,0.00013,378298,24.23314,1561077
14192,cheries,2,0.00013,378300,24.23327,1561077
14193,cherokie,2,0.00013,378302,24.23340,1561077
14194,cherran,2,0.00013,378304,24.23353,1561077
14195,cherylhughey,2,0.00013,378306,24.23365,1561077
14196,chess-levin,2,0.00013,378308,24.23378,1561077
14197,chetancyberoi,2,0.00013,378310,24.23391,1561077
14198,ChetanGoti,2,0.00013,378312,24.23404,1561077
14199,ChethanUK,2,0.00013,378314,24.23417,1561077
14200,chetmancini,2,0.00013,378316,24.23429,1561077
14201,chiarng,2,0.00013,378318,24.23442,1561077
14202,chiccorusso,2,0.00013,378320,24.23455,1561077
14203,chichimotsu,2,0.00013,378322,24.23468,1561077
14204,chiefbarefoot,2,0.00013,378324,24.23481,1561077
14205,chilibreaker,2,0.00013,378326,24.23494,1561077
14206,chintanvadgama,2,0.00013,378328,24.23506,1561077
14207,chips-bo,2,0.00013,378330,24.23519,1561077
14208,chitraj8,2,0.00013,378332,24.23532,1561077
14209,Chivolta,2,0.00013,378334,24.23545,1561077
14210,chkp-adamr,2,0.00013,378336,24.23558,1561077
14211,chmontgomery,2,0.00013,378338,24.23570,1561077
14212,chobe,2,0.00013,378340,24.23583,1561077
14213,chorrylan,2,0.00013,378342,24.23596,1561077
14214,choutman,2,0.00013,378344,24.23609,1561077
14215,chpro,2,0.00013,378346,24.23622,1561077
14216,ChriFo,2,0.00013,378348,24.23634,1561077
14217,chrillux,2,0.00013,378350,24.23647,1561077
14218,ChrisAJS,2,0.00013,378352,24.23660,1561077
14219,chris-daw,2,0.00013,378354,24.23673,1561077
14220,ChrisDunneFlyPay,2,0.00013,378356,24.23686,1561077
14221,chrisduong,2,0.00013,378358,24.23699,1561077
14222,ChrisEverling,2,0.00013,378360,24.23711,1561077
14223,chrisferry,2,0.00013,378362,24.23724,1561077
14224,chrisgelhaus,2,0.00013,378364,24.23737,1561077
14225,chris-kiick-sp,2,0.00013,378366,24.23750,1561077
14226,chrislin22,2,0.00013,378368,24.23763,1561077
14227,chrismcx,2,0.00013,378370,24.23775,1561077
14228,chrismeyersfsu,2,0.00013,378372,24.23788,1561077
14229,ChrisR69,2,0.00013,378374,24.23801,1561077
14230,ChrisRBe,2,0.00013,378376,24.23814,1561077
14231,christa-blunt,2,0.00013,378378,24.23827,1561077
14232,christiangda,2,0.00013,378380,24.23839,1561077
14233,Christilut,2,0.00013,378382,24.23852,1561077
14234,ChristopheBougere,2,0.00013,378384,24.23865,1561077
14235,christophehenry,2,0.00013,378386,24.23878,1561077
14236,christophe-henry-devoteam,2,0.00013,378388,24.23891,1561077
14237,christopherdoak,2,0.00013,378390,24.23903,1561077
14238,christopo,2,0.00013,378392,24.23916,1561077
14239,ChtrMshipper,2,0.00013,378394,24.23929,1561077
14240,chuanjin,2,0.00013,378396,24.23942,1561077
14241,chuckwhite279,2,0.00013,378398,24.23955,1561077
14242,chunming08,2,0.00013,378400,24.23968,1561077
14243,chunyap28,2,0.00013,378402,24.23980,1561077
14244,churrops,2,0.00013,378404,24.23993,1561077
14245,ciantfv456,2,0.00013,378406,24.24006,1561077
14246,ci-arq,2,0.00013,378408,24.24019,1561077
14247,cigano,2,0.00013,378410,24.24032,1561077
14248,cimbalek,2,0.00013,378412,24.24044,1561077
14249,CIPO-GIT,2,0.00013,378414,24.24057,1561077
14250,CityHawk,2,0.00013,378416,24.24070,1561077
14251,CJHarmath,2,0.00013,378418,24.24083,1561077
14252,cjquintero,2,0.00013,378420,24.24096,1561077
14253,cjt0226,2,0.00013,378422,24.24108,1561077
14254,cjw296,2,0.00013,378424,24.24121,1561077
14255,ck1125,2,0.00013,378426,24.24134,1561077
14256,ck3nn,2,0.00013,378428,24.24147,1561077
14257,ckhajavi,2,0.00013,378430,24.24160,1561077
14258,ckopparthi,2,0.00013,378432,24.24173,1561077
14259,ckuhn,2,0.00013,378434,24.24185,1561077
14260,claasd,2,0.00013,378436,24.24198,1561077
14261,clamprecht01,2,0.00013,378438,24.24211,1561077
14262,clanie,2,0.00013,378440,24.24224,1561077
14263,claudijd,2,0.00013,378442,24.24237,1561077
14264,ClaudiuCudla,2,0.00013,378444,24.24249,1561077
14265,claycephas,2,0.00013,378446,24.24262,1561077
14266,claydanford,2,0.00013,378448,24.24275,1561077
14267,clebio,2,0.00013,378450,24.24288,1561077
14268,cledorze,2,0.00013,378452,24.24301,1561077
14269,clemans,2,0.00013,378454,24.24313,1561077
14270,Cliabhach,2,0.00013,378456,24.24326,1561077
14271,Click2Cloud-neutron,2,0.00013,378458,24.24339,1561077
14272,CloCkWeRX,2,0.00013,378460,24.24352,1561077
14273,clokanku,2,0.00013,378462,24.24365,1561077
14274,closeratio,2,0.00013,378464,24.24378,1561077
14275,clrung,2,0.00013,378466,24.24390,1561077
14276,clsaa,2,0.00013,378468,24.24403,1561077
14277,cluk33,2,0.00013,378470,24.24416,1561077
14278,cmchoi2000,2,0.00013,378472,24.24429,1561077
14279,cmilam87,2,0.00013,378474,24.24442,1561077
14280,cmketchu,2,0.00013,378476,24.24454,1561077
14281,cmosetick,2,0.00013,378478,24.24467,1561077
14282,cmpsoares91,2,0.00013,378480,24.24480,1561077
14283,cmurphy208,2,0.00013,378482,24.24493,1561077
14284,cmware43,2,0.00013,378484,24.24506,1561077
14285,cnelson,2,0.00013,378486,24.24518,1561077
14286,Cobraeti,2,0.00013,378488,24.24531,1561077
14287,cocktailer,2,0.00013,378490,24.24544,1561077
14288,cocoon923,2,0.00013,378492,24.24557,1561077
14289,CodeChameleon,2,0.00013,378494,24.24570,1561077
14290,codemedow,2,0.00013,378496,24.24583,1561077
14291,coderade,2,0.00013,378498,24.24595,1561077
14292,coderthetyler,2,0.00013,378500,24.24608,1561077
14293,Coding-Hen,2,0.00013,378502,24.24621,1561077
14294,cody2569,2,0.00013,378504,24.24634,1561077
14295,codylample,2,0.00013,378506,24.24647,1561077
14296,Coffee0127,2,0.00013,378508,24.24659,1561077
14297,colbynh,2,0.00013,378510,24.24672,1561077
14298,colder219,2,0.00013,378512,24.24685,1561077
14299,colutti,2,0.00013,378514,24.24698,1561077
14300,comicfans,2,0.00013,378516,24.24711,1561077
14301,commanda,2,0.00013,378518,24.24723,1561077
14302,common1994,2,0.00013,378520,24.24736,1561077
14303,comscience15,2,0.00013,378522,24.24749,1561077
14304,conkers87,2,0.00013,378524,24.24762,1561077
14305,conradolega,2,0.00013,378526,24.24775,1561077
14306,conradoverta,2,0.00013,378528,24.24788,1561077
14307,constructivetim,2,0.00013,378530,24.24800,1561077
14308,cookeem,2,0.00013,378532,24.24813,1561077
14309,cooldeaaap1,2,0.00013,378534,24.24826,1561077
14310,coolpalani,2,0.00013,378536,24.24839,1561077
14311,corest,2,0.00013,378538,24.24852,1561077
14312,CorneliaChristof,2,0.00013,378540,24.24864,1561077
14313,corradomatt,2,0.00013,378542,24.24877,1561077
14314,coty,2,0.00013,378544,24.24890,1561077
14315,cowai,2,0.00013,378546,24.24903,1561077
14316,cowlinator,2,0.00013,378548,24.24916,1561077
14317,coxc24,2,0.00013,378550,24.24928,1561077
14318,cozziniisdown,2,0.00013,378552,24.24941,1561077
14319,cPanelRicky,2,0.00013,378554,24.24954,1561077
14320,cprenzberg,2,0.00013,378556,24.24967,1561077
14321,cp-samantha,2,0.00013,378558,24.24980,1561077
14322,cr1315,2,0.00013,378560,24.24992,1561077
14323,cr4igo,2,0.00013,378562,24.25005,1561077
14324,craigedmunds,2,0.00013,378564,24.25018,1561077
14325,crasp,2,0.00013,378566,24.25031,1561077
14326,crayfishx,2,0.00013,378568,24.25044,1561077
14327,crazyglasses,2,0.00013,378570,24.25057,1561077
14328,crazyvan25,2,0.00013,378572,24.25069,1561077
14329,creativewild,2,0.00013,378574,24.25082,1561077
14330,creechy,2,0.00013,378576,24.25095,1561077
14331,CrepeClown,2,0.00013,378578,24.25108,1561077
14332,Cressida8,2,0.00013,378580,24.25121,1561077
14333,crichaud,2,0.00013,378582,24.25133,1561077
14334,crislacumba,2,0.00013,378584,24.25146,1561077
14335,cristiangiagante,2,0.00013,378586,24.25159,1561077
14336,cromination,2,0.00013,378588,24.25172,1561077
14337,crrobinson14,2,0.00013,378590,24.25185,1561077
14338,cryptoe,2,0.00013,378592,24.25197,1561077
14339,cs96and,2,0.00013,378594,24.25210,1561077
14340,csakaszamok,2,0.00013,378596,24.25223,1561077
14341,csmith131314,2,0.00013,378598,24.25236,1561077
14342,css-inverso,2,0.00013,378600,24.25249,1561077
14343,cs-tsui,2,0.00013,378602,24.25262,1561077
14344,ctaclas,2,0.00013,378604,24.25274,1561077
14345,cten,2,0.00013,378606,24.25287,1561077
14346,cterrykenzan,2,0.00013,378608,24.25300,1561077
14347,CtxIstvans,2,0.00013,378610,24.25313,1561077
14348,cuky23,2,0.00013,378612,24.25326,1561077
14349,curi0s,2,0.00013,378614,24.25338,1561077
14350,CuriousQA,2,0.00013,378616,24.25351,1561077
14351,curtisgit,2,0.00013,378618,24.25364,1561077
14352,cvrooman,2,0.00013,378620,24.25377,1561077
14353,cwansart,2,0.00013,378622,24.25390,1561077
14354,cwiley982,2,0.00013,378624,24.25402,1561077
14355,cw-pratik,2,0.00013,378626,24.25415,1561077
14356,cxsimon,2,0.00013,378628,24.25428,1561077
14357,cybe,2,0.00013,378630,24.25441,1561077
14358,Cyberbeni,2,0.00013,378632,24.25454,1561077
14359,cybertiger,2,0.00013,378634,24.25467,1561077
14360,cybik,2,0.00013,378636,24.25479,1561077
14361,cybul7,2,0.00013,378638,24.25492,1561077
14362,cyotek,2,0.00013,378640,24.25505,1561077
14363,cypheon,2,0.00013,378642,24.25518,1561077
14364,cyphus,2,0.00013,378644,24.25531,1561077
14365,cyprianno,2,0.00013,378646,24.25543,1561077
14366,CyrilBurd,2,0.00013,378648,24.25556,1561077
14367,cyril-sebastian,2,0.00013,378650,24.25569,1561077
14368,cystal-dot,2,0.00013,378652,24.25582,1561077
14369,Cythwell,2,0.00013,378654,24.25595,1561077
14370,cyxinda,2,0.00013,378656,24.25607,1561077
14371,czerasz-allianz,2,0.00013,378658,24.25620,1561077
14372,czm41k,2,0.00013,378660,24.25633,1561077
14373,d10i,2,0.00013,378662,24.25646,1561077
14374,d1ndra,2,0.00013,378664,24.25659,1561077
14375,d40sithui,2,0.00013,378666,24.25672,1561077
14376,d4n1k,2,0.00013,378668,24.25684,1561077
14377,d8v1dee,2,0.00013,378670,24.25697,1561077
14378,dachenzi,2,0.00013,378672,24.25710,1561077
14379,dafenko,2,0.00013,378674,24.25723,1561077
14380,Daklon,2,0.00013,378676,24.25736,1561077
14381,dalejoel,2,0.00013,378678,24.25748,1561077
14382,dalikrisz,2,0.00013,378680,24.25761,1561077
14383,dami95,2,0.00013,378682,24.25774,1561077
14384,damian87x,2,0.00013,378684,24.25787,1561077
14385,damianmadeira,2,0.00013,378686,24.25800,1561077
14386,damienbeaufils,2,0.00013,378688,24.25812,1561077
14387,damiengallagher,2,0.00013,378690,24.25825,1561077
14388,damyan,2,0.00013,378692,24.25838,1561077
14389,DanaShteiman,2,0.00013,378694,24.25851,1561077
14390,dandaolrian,2,0.00013,378696,24.25864,1561077
14391,danebert,2,0.00013,378698,24.25876,1561077
14392,DanEngelbrecht,2,0.00013,378700,24.25889,1561077
14393,dangerfield,2,0.00013,378702,24.25902,1561077
14394,dangoldin,2,0.00013,378704,24.25915,1561077
14395,dangthanh360,2,0.00013,378706,24.25928,1561077
14396,danibram,2,0.00013,378708,24.25941,1561077
14397,daniel4567,2,0.00013,378710,24.25953,1561077
14398,danielalejandrohc,2,0.00013,378712,24.25966,1561077
14399,danielbathke,2,0.00013,378714,24.25979,1561077
14400,DanielBCoffaro,2,0.00013,378716,24.25992,1561077
14401,DanielCasali,2,0.00013,378718,24.26005,1561077
14402,danielfariati,2,0.00013,378720,24.26017,1561077
14403,danielkraaijbax,2,0.00013,378722,24.26030,1561077
14404,danielksan81,2,0.00013,378724,24.26043,1561077
14405,danielmoorthy,2,0.00013,378726,24.26056,1561077
14406,danielrusev,2,0.00013,378728,24.26069,1561077
14407,danielst-hybris,2,0.00013,378730,24.26081,1561077
14408,danieltaub96,2,0.00013,378732,24.26094,1561077
14409,danisafta,2,0.00013,378734,24.26107,1561077
14410,danish-1997,2,0.00013,378736,24.26120,1561077
14411,daniyalsuri6,2,0.00013,378738,24.26133,1561077
14412,danizquierdo18,2,0.00013,378740,24.26146,1561077
14413,danmaas,2,0.00013,378742,24.26158,1561077
14414,dannftk,2,0.00013,378744,24.26171,1561077
14415,Danny02,2,0.00013,378746,24.26184,1561077
14416,DanWilczyk-Cashplus,2,0.00013,378748,24.26197,1561077
14417,DareDevil73,2,0.00013,378750,24.26210,1561077
14418,darin-willits,2,0.00013,378752,24.26222,1561077
14419,Dark0096,2,0.00013,378754,24.26235,1561077
14420,darkmudley,2,0.00013,378756,24.26248,1561077
14421,darkprisco,2,0.00013,378758,24.26261,1561077
14422,darora,2,0.00013,378760,24.26274,1561077
14423,darrengarvey,2,0.00013,378762,24.26286,1561077
14424,darrensony,2,0.00013,378764,24.26299,1561077
14425,darshangandhi,2,0.00013,378766,24.26312,1561077
14426,darthg8r,2,0.00013,378768,24.26325,1561077
14427,darwish,2,0.00013,378770,24.26338,1561077
14428,dashersw,2,0.00013,378772,24.26351,1561077
14429,Dashrath18,2,0.00013,378774,24.26363,1561077
14430,dashvvv,2,0.00013,378776,24.26376,1561077
14431,dasJ,2,0.00013,378778,24.26389,1561077
14432,datangliang,2,0.00013,378780,24.26402,1561077
14433,DatsoJRel,2,0.00013,378782,24.26415,1561077
14434,dave-juicelabs,2,0.00013,378784,24.26427,1561077
14435,daverickdunn,2,0.00013,378786,24.26440,1561077
14436,david0,2,0.00013,378788,24.26453,1561077
14437,DavidAntliff,2,0.00013,378790,24.26466,1561077
14438,DavidBates,2,0.00013,378792,24.26479,1561077
14439,davidcsi,2,0.00013,378794,24.26491,1561077
14440,davidecavestro,2,0.00013,378796,24.26504,1561077
14441,davideuler,2,0.00013,378798,24.26517,1561077
14442,davidgiga1993,2,0.00013,378800,24.26530,1561077
14443,davidhan3,2,0.00013,378802,24.26543,1561077
14444,david-in-perth,2,0.00013,378804,24.26556,1561077
14445,davidjwriter,2,0.00013,378806,24.26568,1561077
14446,davidkiser,2,0.00013,378808,24.26581,1561077
14447,davidluque1,2,0.00013,378810,24.26594,1561077
14448,davidmdm,2,0.00013,378812,24.26607,1561077
14449,davidmogar,2,0.00013,378814,24.26620,1561077
14450,davidpelfree,2,0.00013,378816,24.26632,1561077
14451,DavidRayner,2,0.00013,378818,24.26645,1561077
14452,davidrochin,2,0.00013,378820,24.26658,1561077
14453,DavidRutqvist,2,0.00013,378822,24.26671,1561077
14454,davidsainty,2,0.00013,378824,24.26684,1561077
14455,davidsvantesson,2,0.00013,378826,24.26696,1561077
14456,DavidTian123,2,0.00013,378828,24.26709,1561077
14457,david-wells-1,2,0.00013,378830,24.26722,1561077
14458,davidwin3,2,0.00013,378832,24.26735,1561077
14459,davidyorr,2,0.00013,378834,24.26748,1561077
14460,davioooh,2,0.00013,378836,24.26760,1561077
14461,davividal,2,0.00013,378838,24.26773,1561077
14462,dawn-minion,2,0.00013,378840,24.26786,1561077
14463,day0hero,2,0.00013,378842,24.26799,1561077
14464,dbb9h,2,0.00013,378844,24.26812,1561077
14465,DBenicy,2,0.00013,378846,24.26825,1561077
14466,dberzano,2,0.00013,378848,24.26837,1561077
14467,dbroeglin,2,0.00013,378850,24.26850,1561077
14468,dbrunkow,2,0.00013,378852,24.26863,1561077
14469,dbwest,2,0.00013,378854,24.26876,1561077
14470,dc232,2,0.00013,378856,24.26889,1561077
14471,dcalap,2,0.00013,378858,24.26901,1561077
14472,dccampbell,2,0.00013,378860,24.26914,1561077
14473,DCkQ6,2,0.00013,378862,24.26927,1561077
14474,dclacher,2,0.00013,378864,24.26940,1561077
14475,dcleao,2,0.00013,378866,24.26953,1561077
14476,dcl-lily,2,0.00013,378868,24.26965,1561077
14477,dcollazosc,2,0.00013,378870,24.26978,1561077
14478,dcowan-vestmark,2,0.00013,378872,24.26991,1561077
14479,dcparker88,2,0.00013,378874,24.27004,1561077
14480,dcrowe,2,0.00013,378876,24.27017,1561077
14481,dcshiman,2,0.00013,378878,24.27030,1561077
14482,DD5HT,2,0.00013,378880,24.27042,1561077
14483,ddd-workshop,2,0.00013,378882,24.27055,1561077
14484,ddevassy,2,0.00013,378884,24.27068,1561077
14485,ddryden,2,0.00013,378886,24.27081,1561077
14486,ddunkin,2,0.00013,378888,24.27094,1561077
14487,ddup1,2,0.00013,378890,24.27106,1561077
14488,dead10ck,2,0.00013,378892,24.27119,1561077
14489,deafol,2,0.00013,378894,24.27132,1561077
14490,deathlyrage,2,0.00013,378896,24.27145,1561077
14491,deathrowe,2,0.00013,378898,24.27158,1561077
14492,debanne,2,0.00013,378900,24.27170,1561077
14493,debasishbsws,2,0.00013,378902,24.27183,1561077
14494,DeChrish,2,0.00013,378904,24.27196,1561077
14495,deedeky,2,0.00013,378906,24.27209,1561077
14496,deepakguna,2,0.00013,378908,24.27222,1561077
14497,Deepakkothandan,2,0.00013,378910,24.27235,1561077
14498,deepakkt-a,2,0.00013,378912,24.27247,1561077
14499,Deepak-trinesis,2,0.00013,378914,24.27260,1561077
14500,DeepthiBahndary,2,0.00013,378916,24.27273,1561077
14501,DefteZ,2,0.00013,378918,24.27286,1561077
14502,defuse,2,0.00013,378920,24.27299,1561077
14503,dejayc,2,0.00013,378922,24.27311,1561077
14504,Delanee9,2,0.00013,378924,24.27324,1561077
14505,DemianTinkiel,2,0.00013,378926,24.27337,1561077
14506,demoawsgaurav,2,0.00013,378928,24.27350,1561077
14507,demotascha,2,0.00013,378930,24.27363,1561077
14508,den1ska,2,0.00013,378932,24.27375,1561077
14509,dendydo,2,0.00013,378934,24.27388,1561077
14510,dengayevskiy,2,0.00013,378936,24.27401,1561077
14511,dengliyao,2,0.00013,378938,24.27414,1561077
14512,den-gts,2,0.00013,378940,24.27427,1561077
14513,denishamann1337,2,0.00013,378942,24.27440,1561077
14514,dennispan,2,0.00013,378944,24.27452,1561077
14515,dennsya,2,0.00013,378946,24.27465,1561077
14516,dennyferra,2,0.00013,378948,24.27478,1561077
14517,deona1,2,0.00013,378950,24.27491,1561077
14518,deploy-pando,2,0.00013,378952,24.27504,1561077
14519,derheld42,2,0.00013,378954,24.27516,1561077
14520,derlarsschneider,2,0.00013,378956,24.27529,1561077
14521,derwasp,2,0.00013,378958,24.27542,1561077
14522,desaiak,2,0.00013,378960,24.27555,1561077
14523,desolat,2,0.00013,378962,24.27568,1561077
14524,dev4dev,2,0.00013,378964,24.27580,1561077
14525,devalnor,2,0.00013,378966,24.27593,1561077
14526,devalru,2,0.00013,378968,24.27606,1561077
14527,Dev-Ashank,2,0.00013,378970,24.27619,1561077
14528,devc0n,2,0.00013,378972,24.27632,1561077
14529,devcfgc,2,0.00013,378974,24.27645,1561077
14530,developerinlondon,2,0.00013,378976,24.27657,1561077
14531,dev-hana,2,0.00013,378978,24.27670,1561077
14532,devloper910,2,0.00013,378980,24.27683,1561077
14533,devops2seedlink,2,0.00013,378982,24.27696,1561077
14534,devops-arena,2,0.00013,378984,24.27709,1561077
14535,devops-expanse,2,0.00013,378986,24.27721,1561077
14536,devopsgong,2,0.00013,378988,24.27734,1561077
14537,DevOps-IT,2,0.00013,378990,24.27747,1561077
14538,devopsn,2,0.00013,378992,24.27760,1561077
14539,devopsteam605,2,0.00013,378994,24.27773,1561077
14540,devos50,2,0.00013,378996,24.27785,1561077
14541,dev-samples,2,0.00013,378998,24.27798,1561077
14542,dex80526,2,0.00013,379000,24.27811,1561077
14543,dezren39,2,0.00013,379002,24.27824,1561077
14544,DF11121990,2,0.00013,379004,24.27837,1561077
14545,dforbesfds,2,0.00013,379006,24.27849,1561077
14546,dgarc23,2,0.00013,379008,24.27862,1561077
14547,dgiffordaudio,2,0.00013,379010,24.27875,1561077
14548,dg-nvm,2,0.00013,379012,24.27888,1561077
14549,dgoldhar,2,0.00013,379014,24.27901,1561077
14550,dgounaris,2,0.00013,379016,24.27914,1561077
14551,dhaffner,2,0.00013,379018,24.27926,1561077
14552,dhagener,2,0.00013,379020,24.27939,1561077
14553,dhartford,2,0.00013,379022,24.27952,1561077
14554,dhendo,2,0.00013,379024,24.27965,1561077
14555,dhirabayashi,2,0.00013,379026,24.27978,1561077
14556,dhnukem,2,0.00013,379028,24.27990,1561077
14557,dhodovsk,2,0.00013,379030,24.28003,1561077
14558,DhruvManchala,2,0.00013,379032,24.28016,1561077
14559,dhurum,2,0.00013,379034,24.28029,1561077
14560,dhutty,2,0.00013,379036,24.28042,1561077
14561,diaojunxian,2,0.00013,379038,24.28054,1561077
14562,dibyah,2,0.00013,379040,24.28067,1561077
14563,dicardopegb,2,0.00013,379042,24.28080,1561077
14564,didacrarbones,2,0.00013,379044,24.28093,1561077
14565,dieh,2,0.00013,379046,24.28106,1561077
14566,dietmax,2,0.00013,379048,24.28119,1561077
14567,dig412,2,0.00013,379050,24.28131,1561077
14568,digitalbuddha,2,0.00013,379052,24.28144,1561077
14569,DigitalTravelDuck,2,0.00013,379054,24.28157,1561077
14570,dijolin,2,0.00013,379056,24.28170,1561077
14571,Dileep1314,2,0.00013,379058,24.28183,1561077
14572,Dileeprithvi,2,0.00013,379060,24.28195,1561077
14573,dilippai,2,0.00013,379062,24.28208,1561077
14574,dimaka-wix,2,0.00013,379064,24.28221,1561077
14575,dimarray,2,0.00013,379066,24.28234,1561077
14576,dinbtechit,2,0.00013,379068,24.28247,1561077
14577,dineshdh,2,0.00013,379070,24.28259,1561077
14578,dinfer,2,0.00013,379072,24.28272,1561077
14579,dinglonggang666,2,0.00013,379074,24.28285,1561077
14580,dinhluongzalora,2,0.00013,379076,24.28298,1561077
14581,dionjansen,2,0.00013,379078,24.28311,1561077
14582,dipeca,2,0.00013,379080,24.28324,1561077
14583,direvius,2,0.00013,379082,24.28336,1561077
14584,dirkh71,2,0.00013,379084,24.28349,1561077
14585,dirkhain,2,0.00013,379086,24.28362,1561077
14586,dirtyharrycallahan,2,0.00013,379088,24.28375,1561077
14587,disha-wani,2,0.00013,379090,24.28388,1561077
14588,Diskiddin,2,0.00013,379092,24.28400,1561077
14589,dittos,2,0.00013,379094,24.28413,1561077
14590,diwannikhil,2,0.00013,379096,24.28426,1561077
14591,diwap,2,0.00013,379098,24.28439,1561077
14592,dja-fr,2,0.00013,379100,24.28452,1561077
14593,djdevin,2,0.00013,379102,24.28464,1561077
14594,dje,2,0.00013,379104,24.28477,1561077
14595,djeverett,2,0.00013,379106,24.28490,1561077
14596,djl197,2,0.00013,379108,24.28503,1561077
14597,djlindstr,2,0.00013,379110,24.28516,1561077
14598,djmonki,2,0.00013,379112,24.28529,1561077
14599,djom20,2,0.00013,379114,24.28541,1561077
14600,DJW-00000,2,0.00013,379116,24.28554,1561077
14601,djwbbn,2,0.00013,379118,24.28567,1561077
14602,d-kazmiers,2,0.00013,379120,24.28580,1561077
14603,dkluba,2,0.00013,379122,24.28593,1561077
14604,Dkra,2,0.00013,379124,24.28605,1561077
14605,dlaugt,2,0.00013,379126,24.28618,1561077
14606,dlcc,2,0.00013,379128,24.28631,1561077
14607,dleavitt802,2,0.00013,379130,24.28644,1561077
14608,dlorch,2,0.00013,379132,24.28657,1561077
14609,dlstonedl,2,0.00013,379134,24.28669,1561077
14610,d-luk,2,0.00013,379136,24.28682,1561077
14611,dlvenable,2,0.00013,379138,24.28695,1561077
14612,dmakhno4gd,2,0.00013,379140,24.28708,1561077
14613,dmarzan,2,0.00013,379142,24.28721,1561077
14614,dmc,2,0.00013,379144,24.28733,1561077
14615,dmcguire81,2,0.00013,379146,24.28746,1561077
14616,dmitrii,2,0.00013,379148,24.28759,1561077
14617,dmitrymz,2,0.00013,379150,24.28772,1561077
14618,Dmitry-SigmaSW,2,0.00013,379152,24.28785,1561077
14619,dndungu,2,0.00013,379154,24.28798,1561077
14620,dnjp,2,0.00013,379156,24.28810,1561077
14621,Doccrazy,2,0.00013,379158,24.28823,1561077
14622,DoDoENT,2,0.00013,379160,24.28836,1561077
14623,Dokki-767,2,0.00013,379162,24.28849,1561077
14624,Dolnor,2,0.00013,379164,24.28862,1561077
14625,domazaris,2,0.00013,379166,24.28874,1561077
14626,dominicphillips,2,0.00013,379168,24.28887,1561077
14627,dominik42,2,0.00013,379170,24.28900,1561077
14628,DonAtMabl,2,0.00013,379172,24.28913,1561077
14629,donatoe,2,0.00013,379174,24.28926,1561077
14630,doncraig,2,0.00013,379176,24.28938,1561077
14631,donghui,2,0.00013,379178,24.28951,1561077
14632,DonGiulio,2,0.00013,379180,24.28964,1561077
14633,dongo0223,2,0.00013,379182,24.28977,1561077
14634,dongseokk,2,0.00013,379184,24.28990,1561077
14635,donnydavis,2,0.00013,379186,24.29003,1561077
14636,doogieho7,2,0.00013,379188,24.29015,1561077
14637,dorisgjata,2,0.00013,379190,24.29028,1561077
14638,dosa9876,2,0.00013,379192,24.29041,1561077
14639,douardda,2,0.00013,379194,24.29054,1561077
14640,doubret,2,0.00013,379196,24.29067,1561077
14641,DouglasLam,2,0.00013,379198,24.29079,1561077
14642,DoxtorDoz,2,0.00013,379200,24.29092,1561077
14643,dp304,2,0.00013,379202,24.29105,1561077
14644,dparvath,2,0.00013,379204,24.29118,1561077
14645,dplavcic,2,0.00013,379206,24.29131,1561077
14646,d-pluschaev,2,0.00013,379208,24.29143,1561077
14647,dpollastrini,2,0.00013,379210,24.29156,1561077
14648,dport2531,2,0.00013,379212,24.29169,1561077
14649,dpuglielli,2,0.00013,379214,24.29182,1561077
14650,dpyoung2,2,0.00013,379216,24.29195,1561077
14651,dqwork,2,0.00013,379218,24.29208,1561077
14652,DracoAter,2,0.00013,379220,24.29220,1561077
14653,DracoBlue,2,0.00013,379222,24.29233,1561077
14654,DragonBay,2,0.00013,379224,24.29246,1561077
14655,drakenfly,2,0.00013,379226,24.29259,1561077
14656,drallop1,2,0.00013,379228,24.29272,1561077
14657,drazzib,2,0.00013,379230,24.29284,1561077
14658,drbeka,2,0.00013,379232,24.29297,1561077
14659,dreich-nucleus,2,0.00013,379234,24.29310,1561077
14660,dresnick-sf,2,0.00013,379236,24.29323,1561077
14661,drew-holt,2,0.00013,379238,24.29336,1561077
14662,drew-jana,2,0.00013,379240,24.29348,1561077
14663,drewwaranissonos,2,0.00013,379242,24.29361,1561077
14664,drg2,2,0.00013,379244,24.29374,1561077
14665,drgomesp,2,0.00013,379246,24.29387,1561077
14666,dribler,2,0.00013,379248,24.29400,1561077
14667,DrLeh,2,0.00013,379250,24.29413,1561077
14668,droca,2,0.00013,379252,24.29425,1561077
14669,droidpl,2,0.00013,379254,24.29438,1561077
14670,drorasaf,2,0.00013,379256,24.29451,1561077
14671,DrozdYana,2,0.00013,379258,24.29464,1561077
14672,drPytho,2,0.00013,379260,24.29477,1561077
14673,drsm79,2,0.00013,379262,24.29489,1561077
14674,drtuxwang,2,0.00013,379264,24.29502,1561077
14675,drubitsa,2,0.00013,379266,24.29515,1561077
14676,drvora,2,0.00013,379268,24.29528,1561077
14677,drweber,2,0.00013,379270,24.29541,1561077
14678,dry4ng,2,0.00013,379272,24.29553,1561077
14679,drywheat,2,0.00013,379274,24.29566,1561077
14680,dscreve,2,0.00013,379276,24.29579,1561077
14681,dspeers,2,0.00013,379278,24.29592,1561077
14682,dsrysr,2,0.00013,379280,24.29605,1561077
14683,dss539,2,0.00013,379282,24.29618,1561077
14684,dstruct88,2,0.00013,379284,24.29630,1561077
14685,dszuksztul,2,0.00013,379286,24.29643,1561077
14686,dten,2,0.00013,379288,24.29656,1561077
14687,dthagard,2,0.00013,379290,24.29669,1561077
14688,DTHaydon,2,0.00013,379292,24.29682,1561077
14689,duanzhanling,2,0.00013,379294,24.29694,1561077
14690,dudeche,2,0.00013,379296,24.29707,1561077
14691,Dudssource,2,0.00013,379298,24.29720,1561077
14692,duhanmin,2,0.00013,379300,24.29733,1561077
14693,Duhemm,2,0.00013,379302,24.29746,1561077
14694,dummy-woo,2,0.00013,379304,24.29758,1561077
14695,duncanphillips,2,0.00013,379306,24.29771,1561077
14696,dunchych,2,0.00013,379308,24.29784,1561077
14697,duncwa,2,0.00013,379310,24.29797,1561077
14698,durera,2,0.00013,379312,24.29810,1561077
14699,duro,2,0.00013,379314,24.29822,1561077
14700,durubayram,2,0.00013,379316,24.29835,1561077
14701,dustyburwell,2,0.00013,379318,24.29848,1561077
14702,duvvurun,2,0.00013,379320,24.29861,1561077
14703,duynb92,2,0.00013,379322,24.29874,1561077
14704,DuyTonThat,2,0.00013,379324,24.29887,1561077
14705,dvelardez,2,0.00013,379326,24.29899,1561077
14706,dvelitchkov,2,0.00013,379328,24.29912,1561077
14707,dvhegde,2,0.00013,379330,24.29925,1561077
14708,dvpierce,2,0.00013,379332,24.29938,1561077
14709,DwaineGarden,2,0.00013,379334,24.29951,1561077
14710,dwimsey,2,0.00013,379336,24.29963,1561077
14711,dx-pbuckley,2,0.00013,379338,24.29976,1561077
14712,dxu429,2,0.00013,379340,24.29989,1561077
14713,Dyakovvn,2,0.00013,379342,24.30002,1561077
14714,dylangarrett,2,0.00013,379344,24.30015,1561077
14715,dylan-tock,2,0.00013,379346,24.30027,1561077
14716,dynamind,2,0.00013,379348,24.30040,1561077
14717,DzianisH,2,0.00013,379350,24.30053,1561077
14718,dzmitry-moisa,2,0.00013,379352,24.30066,1561077
14719,e2etesterviu,2,0.00013,379354,24.30079,1561077
14720,e2tony2000,2,0.00013,379356,24.30092,1561077
14721,e4r7hbug,2,0.00013,379358,24.30104,1561077
14722,earvidso,2,0.00013,379360,24.30117,1561077
14723,ebc12345678,2,0.00013,379362,24.30130,1561077
14724,ebirn,2,0.00013,379364,24.30143,1561077
14725,ebour,2,0.00013,379366,24.30156,1561077
14726,e-bulatnikov,2,0.00013,379368,24.30168,1561077
14727,EchoEasy,2,0.00013,379370,24.30181,1561077
14728,eclar,2,0.00013,379372,24.30194,1561077
14729,eczernikowski,2,0.00013,379374,24.30207,1561077
14730,edana-dev,2,0.00013,379376,24.30220,1561077
14731,edaugherty,2,0.00013,379378,24.30232,1561077
14732,eder7,2,0.00013,379380,24.30245,1561077
14733,edgibbs,2,0.00013,379382,24.30258,1561077
14734,edh-oss,2,0.00013,379384,24.30271,1561077
14735,ednesic,2,0.00013,379386,24.30284,1561077
14736,edpaget,2,0.00013,379388,24.30297,1561077
14737,edperry,2,0.00013,379390,24.30309,1561077
14738,edstefan-ts,2,0.00013,379392,24.30322,1561077
14739,edthorne,2,0.00013,379394,24.30335,1561077
14740,Eduard3000,2,0.00013,379396,24.30348,1561077
14741,eduardrudko,2,0.00013,379398,24.30361,1561077
14742,edvinysz,2,0.00013,379400,24.30373,1561077
14743,edwardpro,2,0.00013,379402,24.30386,1561077
14744,edwinyumakiuchi,2,0.00013,379404,24.30399,1561077
14745,EdZilla,2,0.00013,379406,24.30412,1561077
14746,efine,2,0.00013,379408,24.30425,1561077
14747,efriandika,2,0.00013,379410,24.30437,1561077
14748,egarbi,2,0.00013,379412,24.30450,1561077
14749,egordqa,2,0.00013,379414,24.30463,1561077
14750,ehberger,2,0.00013,379416,24.30476,1561077
14751,ehelms,2,0.00013,379418,24.30489,1561077
14752,ehershey,2,0.00013,379420,24.30502,1561077
14753,ehildebrandt,2,0.00013,379422,24.30514,1561077
14754,ehsanera,2,0.00013,379424,24.30527,1561077
14755,ehudyonasi,2,0.00013,379426,24.30540,1561077
14756,eivinhb,2,0.00013,379428,24.30553,1561077
14757,Eiygy1992,2,0.00013,379430,24.30566,1561077
14758,ejhobbs,2,0.00013,379432,24.30578,1561077
14759,ejschoen,2,0.00013,379434,24.30591,1561077
14760,ekeren,2,0.00013,379436,24.30604,1561077
14761,ekonkov,2,0.00013,379438,24.30617,1561077
14762,ekuznetsov,2,0.00013,379440,24.30630,1561077
14763,elasticdog,2,0.00013,379442,24.30642,1561077
14764,elatt,2,0.00013,379444,24.30655,1561077
14765,eldo26,2,0.00013,379446,24.30668,1561077
14766,eldontc,2,0.00013,379448,24.30681,1561077
14767,eleksir,2,0.00013,379450,24.30694,1561077
14768,elewis787,2,0.00013,379452,24.30706,1561077
14769,elferink,2,0.00013,379454,24.30719,1561077
14770,eliahrebstock,2,0.00013,379456,24.30732,1561077
14771,EliaSaSe,2,0.00013,379458,24.30745,1561077
14772,elielhernandez-natgeo,2,0.00013,379460,24.30758,1561077
14773,Eli-Goldberg,2,0.00013,379462,24.30771,1561077
14774,Elimas,2,0.00013,379464,24.30783,1561077
14775,elishevaHa,2,0.00013,379466,24.30796,1561077
14776,elivaughan,2,0.00013,379468,24.30809,1561077
14777,eljonny,2,0.00013,379470,24.30822,1561077
14778,elkangaroo,2,0.00013,379472,24.30835,1561077
14779,Ellaluo,2,0.00013,379474,24.30847,1561077
14780,eller86,2,0.00013,379476,24.30860,1561077
14781,ellieMayVelasquez,2,0.00013,379478,24.30873,1561077
14782,elmo-space,2,0.00013,379480,24.30886,1561077
14783,elnur,2,0.00013,379482,24.30899,1561077
14784,elora-walmisley,2,0.00013,379484,24.30911,1561077
14785,elouanKeryell-Even,2,0.00013,379486,24.30924,1561077
14786,elrandira,2,0.00013,379488,24.30937,1561077
14787,elsoybean,2,0.00013,379490,24.30950,1561077
14788,Eluetkehans,2,0.00013,379492,24.30963,1561077
14789,elyday,2,0.00013,379494,24.30976,1561077
14790,elygre,2,0.00013,379496,24.30988,1561077
14791,elyobo,2,0.00013,379498,24.31001,1561077
14792,em1l1o,2,0.00013,379500,24.31014,1561077
14793,emarin,2,0.00013,379502,24.31027,1561077
14794,emelkomurcu,2,0.00013,379504,24.31040,1561077
14795,emenda-support,2,0.00013,379506,24.31052,1561077
14796,emillerccb,2,0.00013,379508,24.31065,1561077
14797,emmanuelstroem,2,0.00013,379510,24.31078,1561077
14798,Emmavv,2,0.00013,379512,24.31091,1561077
14799,emmm-dee,2,0.00013,379514,24.31104,1561077
14800,empath75,2,0.00013,379516,24.31116,1561077
14801,empinator,2,0.00013,379518,24.31129,1561077
14802,en7h,2,0.00013,379520,24.31142,1561077
14803,enarciso,2,0.00013,379522,24.31155,1561077
14804,encyphered,2,0.00013,379524,24.31168,1561077
14805,Endle,2,0.00013,379526,24.31181,1561077
14806,endofcake,2,0.00013,379528,24.31193,1561077
14807,EnemyCanine,2,0.00013,379530,24.31206,1561077
14808,engbuild,2,0.00013,379532,24.31219,1561077
14809,enjoycx,2,0.00013,379534,24.31232,1561077
14810,enki211,2,0.00013,379536,24.31245,1561077
14811,EnriqueAlmanza,2,0.00013,379538,24.31257,1561077
14812,enriquegh,2,0.00013,379540,24.31270,1561077
14813,Enteee,2,0.00013,379542,24.31283,1561077
14814,envimate-opensource,2,0.00013,379544,24.31296,1561077
14815,EnziinSystem,2,0.00013,379546,24.31309,1561077
14816,EoinGriffin-AI,2,0.00013,379548,24.31321,1561077
14817,epasham,2,0.00013,379550,24.31334,1561077
14818,e-pettersson-ericsson,2,0.00013,379552,24.31347,1561077
14819,EpicKiwi,2,0.00013,379554,24.31360,1561077
14820,epidemia,2,0.00013,379556,24.31373,1561077
14821,equate76,2,0.00013,379558,24.31386,1561077
14822,eranmekler,2,0.00013,379560,24.31398,1561077
14823,ericbf,2,0.00013,379562,24.31411,1561077
14824,ericdalling,2,0.00013,379564,24.31424,1561077
14825,erickeliseo,2,0.00013,379566,24.31437,1561077
14826,ericmikkelsen,2,0.00013,379568,24.31450,1561077
14827,EricRossC,2,0.00013,379570,24.31462,1561077
14828,ericsessions,2,0.00013,379572,24.31475,1561077
14829,erictankok,2,0.00013,379574,24.31488,1561077
14830,ericyu2018,2,0.00013,379576,24.31501,1561077
14831,erikdeweerdt,2,0.00013,379578,24.31514,1561077
14832,ErikEngerd,2,0.00013,379580,24.31526,1561077
14833,er-jagdish,2,0.00013,379582,24.31539,1561077
14834,erlangparasu,2,0.00013,379584,24.31552,1561077
14835,ernestask,2,0.00013,379586,24.31565,1561077
14836,errodr,2,0.00013,379588,24.31578,1561077
14837,ervuks,2,0.00013,379590,24.31590,1561077
14838,erwannT,2,0.00013,379592,24.31603,1561077
14839,erzz,2,0.00013,379594,24.31616,1561077
14840,esfomeado,2,0.00013,379596,24.31629,1561077
14841,esgjenkins,2,0.00013,379598,24.31642,1561077
14842,eshackelford-ias,2,0.00013,379600,24.31655,1561077
14843,esphen,2,0.00013,379602,24.31667,1561077
14844,espoelstra,2,0.00013,379604,24.31680,1561077
14845,estei,2,0.00013,379606,24.31693,1561077
14846,etavela,2,0.00013,379608,24.31706,1561077
14847,etherge,2,0.00013,379610,24.31719,1561077
14848,etraikov,2,0.00013,379612,24.31731,1561077
14849,etrikp,2,0.00013,379614,24.31744,1561077
14850,eugene-cloudinary,2,0.00013,379616,24.31757,1561077
14851,eugeneovsyannikov,2,0.00013,379618,24.31770,1561077
14852,EugeneWImprint,2,0.00013,379620,24.31783,1561077
14853,eugeniapotapska,2,0.00013,379622,24.31795,1561077
14854,eugen-korentsov,2,0.00013,379624,24.31808,1561077
14855,EusebiusAditya,2,0.00013,379626,24.31821,1561077
14856,eva-mueller-coremedia,2,0.00013,379628,24.31834,1561077
14857,EvandroSilvestre,2,0.00013,379630,24.31847,1561077
14858,EvanMAmstutz,2,0.00013,379632,24.31860,1561077
14859,EvanSchnellMDT,2,0.00013,379634,24.31872,1561077
14860,evansj,2,0.00013,379636,24.31885,1561077
14861,Evanthx,2,0.00013,379638,24.31898,1561077
14862,evanzeller-vi,2,0.00013,379640,24.31911,1561077
14863,everalan10,2,0.00013,379642,24.31924,1561077
14864,EvgenyKuzavlev,2,0.00013,379644,24.31936,1561077
14865,evilDave,2,0.00013,379646,24.31949,1561077
14866,evilmilo,2,0.00013,379648,24.31962,1561077
14867,ewh0005,2,0.00013,379650,24.31975,1561077
14868,ewollesen,2,0.00013,379652,24.31988,1561077
14869,ewongbb,2,0.00013,379654,24.32000,1561077
14870,ewortzman,2,0.00013,379656,24.32013,1561077
14871,excelsior1984,2,0.00013,379658,24.32026,1561077
14872,exequielrafaela,2,0.00013,379660,24.32039,1561077
14873,exic,2,0.00013,379662,24.32052,1561077
14874,exoaturner,2,0.00013,379664,24.32065,1561077
14875,experimentalinsanity,2,0.00013,379666,24.32077,1561077
14876,ExpertNET,2,0.00013,379668,24.32090,1561077
14877,exploiz,2,0.00013,379670,24.32103,1561077
14878,expz,2,0.00013,379672,24.32116,1561077
14879,eXtrem0us,2,0.00013,379674,24.32129,1561077
14880,eyalstoler,2,0.00013,379676,24.32141,1561077
14881,EyckSDLuo,2,0.00013,379678,24.32154,1561077
14882,eyeballz,2,0.00013,379680,24.32167,1561077
14883,eyelock,2,0.00013,379682,24.32180,1561077
14884,EZhao-Quest,2,0.00013,379684,24.32193,1561077
14885,f00f,2,0.00013,379686,24.32205,1561077
14886,fabiankle,2,0.00013,379688,24.32218,1561077
14887,fabianopimentel,2,0.00013,379690,24.32231,1561077
14888,fabiofetter,2,0.00013,379692,24.32244,1561077
14889,FabreLucaS,2,0.00013,379694,24.32257,1561077
14890,fabrice-morato,2,0.00013,379696,24.32270,1561077
14891,fabstu,2,0.00013,379698,24.32282,1561077
14892,Faheetah,2,0.00013,379700,24.32295,1561077
14893,failattu,2,0.00013,379702,24.32308,1561077
14894,faircreek,2,0.00013,379704,24.32321,1561077
14895,faisalrazzak,2,0.00013,379706,24.32334,1561077
14896,falkartis,2,0.00013,379708,24.32346,1561077
14897,falkon42,2,0.00013,379710,24.32359,1561077
14898,fallberg,2,0.00013,379712,24.32372,1561077
14899,falsedlah,2,0.00013,379714,24.32385,1561077
14900,famer,2,0.00013,379716,24.32398,1561077
14901,famoushz,2,0.00013,379718,24.32410,1561077
14902,FanchTheSystem,2,0.00013,379720,24.32423,1561077
14903,fanghuafan,2,0.00013,379722,24.32436,1561077
14904,farhin-khan-persistent,2,0.00013,379724,24.32449,1561077
14905,farkasseb,2,0.00013,379726,24.32462,1561077
14906,faroguy,2,0.00013,379728,24.32475,1561077
14907,fastloris,2,0.00013,379730,24.32487,1561077
14908,fawaf,2,0.00013,379732,24.32500,1561077
14909,Faylixe,2,0.00013,379734,24.32513,1561077
14910,fbarthez,2,0.00013,379736,24.32526,1561077
14911,fbongiovanni29,2,0.00013,379738,24.32539,1561077
14912,fcalderon,2,0.00013,379740,24.32551,1561077
14913,fchandra09,2,0.00013,379742,24.32564,1561077
14914,fdevans,2,0.00013,379744,24.32577,1561077
14915,fdouek,2,0.00013,379746,24.32590,1561077
14916,fdstevex,2,0.00013,379748,24.32603,1561077
14917,feanil,2,0.00013,379750,24.32615,1561077
14918,feber,2,0.00013,379752,24.32628,1561077
14919,Fedonono,2,0.00013,379754,24.32641,1561077
14920,fedor-git,2,0.00013,379756,24.32654,1561077
14921,fehpapito,2,0.00013,379758,24.32667,1561077
14922,felipeplets,2,0.00013,379760,24.32679,1561077
14923,FelixBechstein0000,2,0.00013,379762,24.32692,1561077
14924,FelixJo,2,0.00013,379764,24.32705,1561077
14925,femithz,2,0.00013,379766,24.32718,1561077
14926,fenchu,2,0.00013,379768,24.32731,1561077
14927,fengerzh,2,0.00013,379770,24.32744,1561077
14928,feralislatr,2,0.00013,379772,24.32756,1561077
14929,FernandoTBarros,2,0.00013,379774,24.32769,1561077
14930,ferpizza,2,0.00013,379776,24.32782,1561077
14931,fessmage,2,0.00013,379778,24.32795,1561077
14932,fetmar,2,0.00013,379780,24.32808,1561077
14933,fezno,2,0.00013,379782,24.32820,1561077
14934,fferguson,2,0.00013,379784,24.32833,1561077
14935,fff,2,0.00013,379786,24.32846,1561077
14936,ffinkdevs,2,0.00013,379788,24.32859,1561077
14937,fforloff,2,0.00013,379790,24.32872,1561077
14938,ffsetit,2,0.00013,379792,24.32884,1561077
14939,fgakk,2,0.00013,379794,24.32897,1561077
14940,fgather,2,0.00013,379796,24.32910,1561077
14941,fgeckeler,2,0.00013,379798,24.32923,1561077
14942,fh345392977,2,0.00013,379800,24.32936,1561077
14943,FHannes,2,0.00013,379802,24.32949,1561077
14944,fhchina,2,0.00013,379804,24.32961,1561077
14945,fhossfel,2,0.00013,379806,24.32974,1561077
14946,ficusyou,2,0.00013,379808,24.32987,1561077
14947,fidelski,2,0.00013,379810,24.33000,1561077
14948,fimbulvetr,2,0.00013,379812,24.33013,1561077
14949,fiorillj,2,0.00013,379814,24.33025,1561077
14950,firatkucuk,2,0.00013,379816,24.33038,1561077
14951,firebike,2,0.00013,379818,24.33051,1561077
14952,fisabelle,2,0.00013,379820,24.33064,1561077
14953,fiznool,2,0.00013,379822,24.33077,1561077
14954,fl0l-gouze,2,0.00013,379824,24.33089,1561077
14955,flapp,2,0.00013,379826,24.33102,1561077
14956,FlashSheridan,2,0.00013,379828,24.33115,1561077
14957,flauberbmc,2,0.00013,379830,24.33128,1561077
14958,flauflauf,2,0.00013,379832,24.33141,1561077
14959,fliespl,2,0.00013,379834,24.33154,1561077
14960,Flightkick,2,0.00013,379836,24.33166,1561077
14961,fliiiix,2,0.00013,379838,24.33179,1561077
14962,flipy,2,0.00013,379840,24.33192,1561077
14963,Floby,2,0.00013,379842,24.33205,1561077
14964,Flohack74,2,0.00013,379844,24.33218,1561077
14965,f-lopes,2,0.00013,379846,24.33230,1561077
14966,flopma,2,0.00013,379848,24.33243,1561077
14967,fluxens,2,0.00013,379850,24.33256,1561077
14968,flying-snail0630,2,0.00013,379852,24.33269,1561077
14969,fmuscolino,2,0.00013,379854,24.33282,1561077
14970,fobban,2,0.00013,379856,24.33294,1561077
14971,FordyceGarfield,2,0.00013,379858,24.33307,1561077
14972,forresthopkinsa,2,0.00013,379860,24.33320,1561077
14973,fracklen,2,0.00013,379862,24.33333,1561077
14974,fraisse,2,0.00013,379864,24.33346,1561077
14975,framer8,2,0.00013,379866,24.33359,1561077
14976,FrancisVila,2,0.00013,379868,24.33371,1561077
14977,francois-baptiste,2,0.00013,379870,24.33384,1561077
14978,FrancoSabadini,2,0.00013,379872,24.33397,1561077
14979,frank-bee,2,0.00013,379874,24.33410,1561077
14980,Frank-Schmitt,2,0.00013,379876,24.33423,1561077
14981,frankvHoof93,2,0.00013,379878,24.33435,1561077
14982,frankyjquintero,2,0.00013,379880,24.33448,1561077
14983,Fraysa,2,0.00013,379882,24.33461,1561077
14984,FredericLatour,2,0.00013,379884,24.33474,1561077
14985,fredyw,2,0.00013,379886,24.33487,1561077
14986,freemantest123,2,0.00013,379888,24.33499,1561077
14987,FrelliBB,2,0.00013,379890,24.33512,1561077
14988,frenchzed,2,0.00013,379892,24.33525,1561077
14989,frickjack,2,0.00013,379894,24.33538,1561077
14990,FridMehdi,2,0.00013,379896,24.33551,1561077
14991,FriedlTheFox,2,0.00013,379898,24.33563,1561077
14992,friesoft,2,0.00013,379900,24.33576,1561077
14993,frodelu,2,0.00013,379902,24.33589,1561077
14994,froemra,2,0.00013,379904,24.33602,1561077
14995,fruiti-lewis,2,0.00013,379906,24.33615,1561077
14996,frvasquezjaquez,2,0.00013,379908,24.33628,1561077
14997,frzme,2,0.00013,379910,24.33640,1561077
14998,fschloesser,2,0.00013,379912,24.33653,1561077
14999,fslevoaca-ionos,2,0.00013,379914,24.33666,1561077
15000,fukusukei,2,0.00013,379916,24.33679,1561077
15001,funkyfisch,2,0.00013,379918,24.33692,1561077
15002,fuz-rahm,2,0.00013,379920,24.33704,1561077
15003,fuzzPnutt,2,0.00013,379922,24.33717,1561077
15004,FWFabio,2,0.00013,379924,24.33730,1561077
15005,Fxhnd,2,0.00013,379926,24.33743,1561077
15006,FYanTsoft,2,0.00013,379928,24.33756,1561077
15007,fyi-coursera,2,0.00013,379930,24.33768,1561077
15008,fzp123,2,0.00013,379932,24.33781,1561077
15009,g1ps,2,0.00013,379934,24.33794,1561077
15010,G271an,2,0.00013,379936,24.33807,1561077
15011,g4gps,2,0.00013,379938,24.33820,1561077
15012,gab1one,2,0.00013,379940,24.33833,1561077
15013,gabayavi,2,0.00013,379942,24.33845,1561077
15014,gabialex27,2,0.00013,379944,24.33858,1561077
15015,gaborage,2,0.00013,379946,24.33871,1561077
15016,gabrielmathias,2,0.00013,379948,24.33884,1561077
15017,gabrielpasv,2,0.00013,379950,24.33897,1561077
15018,gabrilabs75,2,0.00013,379952,24.33909,1561077
15019,gaga-github,2,0.00013,379954,24.33922,1561077
15020,gagseba1,2,0.00013,379956,24.33935,1561077
15021,GajenderTyagi,2,0.00013,379958,24.33948,1561077
15022,gakhrejah,2,0.00013,379960,24.33961,1561077
15023,Galehault,2,0.00013,379962,24.33973,1561077
15024,galindroasml,2,0.00013,379964,24.33986,1561077
15025,galunto,2,0.00013,379966,24.33999,1561077
15026,galvarado,2,0.00013,379968,24.34012,1561077
15027,gami74,2,0.00013,379970,24.34025,1561077
15028,gammpamm,2,0.00013,379972,24.34038,1561077
15029,ganasubrgit,2,0.00013,379974,24.34050,1561077
15030,ganeshgk,2,0.00013,379976,24.34063,1561077
15031,ganeshvl,2,0.00013,379978,24.34076,1561077
15032,gaodan-fang,2,0.00013,379980,24.34089,1561077
15033,gaodm1,2,0.00013,379982,24.34102,1561077
15034,Gaoithe,2,0.00013,379984,24.34114,1561077
15035,garethbowles,2,0.00013,379986,24.34127,1561077
15036,GarryBullock,2,0.00013,379988,24.34140,1561077
15037,gary287,2,0.00013,379990,24.34153,1561077
15038,gastendonk,2,0.00013,379992,24.34166,1561077
15039,gastlygem,2,0.00013,379994,24.34178,1561077
15040,gastonfournier,2,0.00013,379996,24.34191,1561077
15041,gaussye,2,0.00013,379998,24.34204,1561077
15042,GautierDig,2,0.00013,380000,24.34217,1561077
15043,gbarilska,2,0.00013,380002,24.34230,1561077
15044,gberesta,2,0.00013,380004,24.34243,1561077
15045,gbloggs,2,0.00013,380006,24.34255,1561077
15046,gbrivate,2,0.00013,380008,24.34268,1561077
15047,gburrell,2,0.00013,380010,24.34281,1561077
15048,gcarre,2,0.00013,380012,24.34294,1561077
15049,gchan2,2,0.00013,380014,24.34307,1561077
15050,gclabon,2,0.00013,380016,24.34319,1561077
15051,gcoelho,2,0.00013,380018,24.34332,1561077
15052,gct-faisal,2,0.00013,380020,24.34345,1561077
15053,gdhaworth,2,0.00013,380022,24.34358,1561077
15054,gdippolito,2,0.00013,380024,24.34371,1561077
15055,gd-jroberts,2,0.00013,380026,24.34383,1561077
15056,gdlxn-ibm,2,0.00013,380028,24.34396,1561077
15057,g-doc,2,0.00013,380030,24.34409,1561077
15058,gdzien,2,0.00013,380032,24.34422,1561077
15059,geanpalacios,2,0.00013,380034,24.34435,1561077
15060,geardleyTC,2,0.00013,380036,24.34448,1561077
15061,geco82,2,0.00013,380038,24.34460,1561077
15062,gedefran,2,0.00013,380040,24.34473,1561077
15063,Geek3carl,2,0.00013,380042,24.34486,1561077
15064,Geekays,2,0.00013,380044,24.34499,1561077
15065,geekyfox90,2,0.00013,380046,24.34512,1561077
15066,gene-pavlovsky,2,0.00013,380048,24.34524,1561077
15067,george-007,2,0.00013,380050,24.34537,1561077
15068,GeorgeAdams95,2,0.00013,380052,24.34550,1561077
15069,GeorgeCartyZerolight,2,0.00013,380054,24.34563,1561077
15070,georgemarrows,2,0.00013,380056,24.34576,1561077
15071,georgevicbell,2,0.00013,380058,24.34588,1561077
15072,georgiee,2,0.00013,380060,24.34601,1561077
15073,gerethd,2,0.00013,380062,24.34614,1561077
15074,g-ericso,2,0.00013,380064,24.34627,1561077
15075,geripgeri,2,0.00013,380066,24.34640,1561077
15076,gerrito333,2,0.00013,380068,24.34652,1561077
15077,gesundes,2,0.00013,380070,24.34665,1561077
15078,getsidecarjenkins,2,0.00013,380072,24.34678,1561077
15079,gezn,2,0.00013,380074,24.34691,1561077
15080,gferreri,2,0.00013,380076,24.34704,1561077
15081,GGG-SM,2,0.00013,380078,24.34717,1561077
15082,ggirou,2,0.00013,380080,24.34729,1561077
15083,ggrell,2,0.00013,380082,24.34742,1561077
15084,GGross5213,2,0.00013,380084,24.34755,1561077
15085,gh8a,2,0.00013,380086,24.34768,1561077
15086,Ghjnut,2,0.00013,380088,24.34781,1561077
15087,gh-km,2,0.00013,380090,24.34793,1561077
15088,ghofraneCh,2,0.00013,380092,24.34806,1561077
15089,g-host-one,2,0.00013,380094,24.34819,1561077
15090,gh-srudra,2,0.00013,380096,24.34832,1561077
15091,Gi0rgi0s,2,0.00013,380098,24.34845,1561077
15092,giacgbj,2,0.00013,380100,24.34857,1561077
15093,giacomolozito,2,0.00013,380102,24.34870,1561077
15094,gideao,2,0.00013,380104,24.34883,1561077
15095,giedriusramas,2,0.00013,380106,24.34896,1561077
15096,giladwolff,2,0.00013,380108,24.34909,1561077
15097,giles-jason,2,0.00013,380110,24.34922,1561077
15098,Gillingham,2,0.00013,380112,24.34934,1561077
15099,gilzellner,2,0.00013,380114,24.34947,1561077
15100,gimolai,2,0.00013,380116,24.34960,1561077
15101,giovinazzorocco,2,0.00013,380118,24.34973,1561077
15102,giridhar08,2,0.00013,380120,24.34986,1561077
15103,girstenbrei,2,0.00013,380122,24.34998,1561077
15104,giTan7,2,0.00013,380124,24.35011,1561077
15105,gitckluser,2,0.00013,380126,24.35024,1561077
15106,gitcodernitish,2,0.00013,380128,24.35037,1561077
15107,github4sanjay,2,0.00013,380130,24.35050,1561077
15108,gitkent,2,0.00013,380132,24.35062,1561077
15109,gkarabin,2,0.00013,380134,24.35075,1561077
15110,gkg-sg,2,0.00013,380136,24.35088,1561077
15111,gkhnsmsk,2,0.00013,380138,24.35101,1561077
15112,glajchs,2,0.00013,380140,24.35114,1561077
15113,glefevre,2,0.00013,380142,24.35127,1561077
15114,glfp,2,0.00013,380144,24.35139,1561077
15115,glhfior,2,0.00013,380146,24.35152,1561077
15116,glittle,2,0.00013,380148,24.35165,1561077
15117,gloriateodoro,2,0.00013,380150,24.35178,1561077
15118,gloutsch,2,0.00013,380152,24.35191,1561077
15119,glureau,2,0.00013,380154,24.35203,1561077
15120,glynnforrest,2,0.00013,380156,24.35216,1561077
15121,gm12367,2,0.00013,380158,24.35229,1561077
15122,gmaiztegi,2,0.00013,380160,24.35242,1561077
15123,gmale,2,0.00013,380162,24.35255,1561077
15124,gmarchiny,2,0.00013,380164,24.35267,1561077
15125,gmattar,2,0.00013,380166,24.35280,1561077
15126,gmckerrell,2,0.00013,380168,24.35293,1561077
15127,GMDSantana,2,0.00013,380170,24.35306,1561077
15128,gmeghnag,2,0.00013,380172,24.35319,1561077
15129,gmfrasca,2,0.00013,380174,24.35332,1561077
15130,GMouron,2,0.00013,380176,24.35344,1561077
15131,gmsa,2,0.00013,380178,24.35357,1561077
15132,gnikonorov,2,0.00013,380180,24.35370,1561077
15133,gnometsunami,2,0.00013,380182,24.35383,1561077
15134,gnychis,2,0.00013,380184,24.35396,1561077
15135,godbyk,2,0.00013,380186,24.35408,1561077
15136,godinezj,2,0.00013,380188,24.35421,1561077
15137,godrja,2,0.00013,380190,24.35434,1561077
15138,Godtrilla,2,0.00013,380192,24.35447,1561077
15139,gogotanaka,2,0.00013,380194,24.35460,1561077
15140,gohonsen,2,0.00013,380196,24.35472,1561077
15141,gokugiant,2,0.00013,380198,24.35485,1561077
15142,gonchik,2,0.00013,380200,24.35498,1561077
15143,gorky,2,0.00013,380202,24.35511,1561077
15144,gortazar,2,0.00013,380204,24.35524,1561077
15145,gosuwachu,2,0.00013,380206,24.35536,1561077
15146,Got99,2,0.00013,380208,24.35549,1561077
15147,GoTheExtraMile,2,0.00013,380210,24.35562,1561077
15148,gotoworld,2,0.00013,380212,24.35575,1561077
15149,GouravSardana,2,0.00013,380214,24.35588,1561077
15150,Gowlar,2,0.00013,380216,24.35601,1561077
15151,gowrishankarsundersc,2,0.00013,380218,24.35613,1561077
15152,gozdal,2,0.00013,380220,24.35626,1561077
15153,gozer2222,2,0.00013,380222,24.35639,1561077
15154,gp-gurpreetbaidwan,2,0.00013,380224,24.35652,1561077
15155,gpi63,2,0.00013,380226,24.35665,1561077
15156,gpolek,2,0.00013,380228,24.35677,1561077
15157,gpreston-riot,2,0.00013,380230,24.35690,1561077
15158,grabowski-d,2,0.00013,380232,24.35703,1561077
15159,graeson,2,0.00013,380234,24.35716,1561077
15160,grahamehorner,2,0.00013,380236,24.35729,1561077
15161,grajsor,2,0.00013,380238,24.35741,1561077
15162,graphicsminded,2,0.00013,380240,24.35754,1561077
15163,gravityuser,2,0.00013,380242,24.35767,1561077
15164,grecoj,2,0.00013,380244,24.35780,1561077
15165,greenfieldtech-davidb,2,0.00013,380246,24.35793,1561077
15166,GregDomjan,2,0.00013,380248,24.35806,1561077
15167,greggian,2,0.00013,380250,24.35818,1561077
15168,gregnightingale,2,0.00013,380252,24.35831,1561077
15169,gregorywojcik,2,0.00013,380254,24.35844,1561077
15170,grid-dev,2,0.00013,380256,24.35857,1561077
15171,grierj,2,0.00013,380258,24.35870,1561077
15172,grifenpierre,2,0.00013,380260,24.35882,1561077
15173,griffin,2,0.00013,380262,24.35895,1561077
15174,grifonas,2,0.00013,380264,24.35908,1561077
15175,grigarr,2,0.00013,380266,24.35921,1561077
15176,GrimmCloud,2,0.00013,380268,24.35934,1561077
15177,grischa,2,0.00013,380270,24.35946,1561077
15178,Grokzen,2,0.00013,380272,24.35959,1561077
15179,gruberro,2,0.00013,380274,24.35972,1561077
15180,gruebel,2,0.00013,380276,24.35985,1561077
15181,Grunny,2,0.00013,380278,24.35998,1561077
15182,grzechup,2,0.00013,380280,24.36011,1561077
15183,grzegorzSpiewak,2,0.00013,380282,24.36023,1561077
15184,grzesikluk,2,0.00013,380284,24.36036,1561077
15185,gsantner,2,0.00013,380286,24.36049,1561077
15186,gschurck,2,0.00013,380288,24.36062,1561077
15187,gsouzab,2,0.00013,380290,24.36075,1561077
15188,gssiyankai,2,0.00013,380292,24.36087,1561077
15189,gs-vmenon,2,0.00013,380294,24.36100,1561077
15190,gtaylor1981,2,0.00013,380296,24.36113,1561077
15191,gtrindade,2,0.00013,380298,24.36126,1561077
15192,guange2015,2,0.00013,380300,24.36139,1561077
15193,guangnix,2,0.00013,380302,24.36151,1561077
15194,Guanyan1996,2,0.00013,380304,24.36164,1561077
15195,gucchisk,2,0.00013,380306,24.36177,1561077
15196,gudlyf,2,0.00013,380308,24.36190,1561077
15197,guese11,2,0.00013,380310,24.36203,1561077
15198,guilhermemota,2,0.00013,380312,24.36216,1561077
15199,Guillaume-Mayer,2,0.00013,380314,24.36228,1561077
15200,guillermobandres,2,0.00013,380316,24.36241,1561077
15201,gujiwork,2,0.00013,380318,24.36254,1561077
15202,gunabca,2,0.00013,380320,24.36267,1561077
15203,guneesh27,2,0.00013,380322,24.36280,1561077
15204,GunnarKarlsson,2,0.00013,380324,24.36292,1561077
15205,guppy0130,2,0.00013,380326,24.36305,1561077
15206,gurtejkochhar,2,0.00013,380328,24.36318,1561077
15207,guscott,2,0.00013,380330,24.36331,1561077
15208,guymers,2,0.00013,380332,24.36344,1561077
15209,gvenka008c,2,0.00013,380334,24.36356,1561077
15210,gynter,2,0.00013,380336,24.36369,1561077
15211,gzhang1-quest,2,0.00013,380338,24.36382,1561077
15212,gzoom13,2,0.00013,380340,24.36395,1561077
15213,h33x0,2,0.00013,380342,24.36408,1561077
15214,h3nrique,2,0.00013,380344,24.36420,1561077
15215,HabibMAALEM,2,0.00013,380346,24.36433,1561077
15216,habutre,2,0.00013,380348,24.36446,1561077
15217,hacfi,2,0.00013,380350,24.36459,1561077
15218,hack19-hub,2,0.00013,380352,24.36472,1561077
15219,hackrid,2,0.00013,380354,24.36485,1561077
15220,hacs4myhome,2,0.00013,380356,24.36497,1561077
15221,hadesh,2,0.00013,380358,24.36510,1561077
15222,hadwen,2,0.00013,380360,24.36523,1561077
15223,haiduc32,2,0.00013,380362,24.36536,1561077
15224,haisum,2,0.00013,380364,24.36549,1561077
15225,Haitianisgood,2,0.00013,380366,24.36561,1561077
15226,halftan,2,0.00013,380368,24.36574,1561077
15227,halvorgb,2,0.00013,380370,24.36587,1561077
15228,hamaney,2,0.00013,380372,24.36600,1561077
15229,hamidzr,2,0.00013,380374,24.36613,1561077
15230,hammett,2,0.00013,380376,24.36625,1561077
15231,hamzanasir443,2,0.00013,380378,24.36638,1561077
15232,hamzanatek,2,0.00013,380380,24.36651,1561077
15233,hansi-b,2,0.00013,380382,24.36664,1561077
15234,Hans-JakobHoltzTT,2,0.00013,380384,24.36677,1561077
15235,harbulot,2,0.00013,380386,24.36690,1561077
15236,hardboiled,2,0.00013,380388,24.36702,1561077
15237,HariDurga,2,0.00013,380390,24.36715,1561077
15238,harigitgub,2,0.00013,380392,24.36728,1561077
15239,hari-mopuri,2,0.00013,380394,24.36741,1561077
15240,harishk623,2,0.00013,380396,24.36754,1561077
15241,harleybaum,2,0.00013,380398,24.36766,1561077
15242,harriswong,2,0.00013,380400,24.36779,1561077
15243,HarryHoudini,2,0.00013,380402,24.36792,1561077
15244,harry-or-potter,2,0.00013,380404,24.36805,1561077
15245,harryurban,2,0.00013,380406,24.36818,1561077
15246,harshal-99,2,0.00013,380408,24.36830,1561077
15247,Harshit-Paul,2,0.00013,380410,24.36843,1561077
15248,hasansna,2,0.00013,380412,24.36856,1561077
15249,hasmikg,2,0.00013,380414,24.36869,1561077
15250,hassan-mohsen,2,0.00013,380416,24.36882,1561077
15251,hasterhorb,2,0.00013,380418,24.36895,1561077
15252,hauhsu,2,0.00013,380420,24.36907,1561077
15253,hauke-d,2,0.00013,380422,24.36920,1561077
15254,haydentherapper,2,0.00013,380424,24.36933,1561077
15255,HB-2012,2,0.00013,380426,24.36946,1561077
15256,hb951396063,2,0.00013,380428,24.36959,1561077
15257,HBO2,2,0.00013,380430,24.36971,1561077
15258,hc000,2,0.00013,380432,24.36984,1561077
15259,hchowdhary,2,0.00013,380434,24.36997,1561077
15260,hdanak,2,0.00013,380436,24.37010,1561077
15261,hdelossantos,2,0.00013,380438,24.37023,1561077
15262,hdhoang,2,0.00013,380440,24.37035,1561077
15263,Heartdeath,2,0.00013,380442,24.37048,1561077
15264,heathjmorgange,2,0.00013,380444,24.37061,1561077
15265,heckerdj,2,0.00013,380446,24.37074,1561077
15266,hector-tn,2,0.00013,380448,24.37087,1561077
15267,Heena-tuli,2,0.00013,380450,24.37100,1561077
15268,Hejado,2,0.00013,380452,24.37112,1561077
15269,hellerbarde,2,0.00013,380454,24.37125,1561077
15270,hellxz,2,0.00013,380456,24.37138,1561077
15271,helmuthva,2,0.00013,380458,24.37151,1561077
15272,helmut-lang,2,0.00013,380460,24.37164,1561077
15273,hendych,2,0.00013,380462,24.37176,1561077
15274,Heneman,2,0.00013,380464,24.37189,1561077
15275,henkf,2,0.00013,380466,24.37202,1561077
15276,henrylawson,2,0.00013,380468,24.37215,1561077
15277,henrytran026,2,0.00013,380470,24.37228,1561077
15278,henrywang,2,0.00013,380472,24.37240,1561077
15279,Hentheroot,2,0.00013,380474,24.37253,1561077
15280,heowc,2,0.00013,380476,24.37266,1561077
15281,herman-nu,2,0.00013,380478,24.37279,1561077
15282,Herrera93,2,0.00013,380480,24.37292,1561077
15283,herrmanntom,2,0.00013,380482,24.37305,1561077
15284,herrphon,2,0.00013,380484,24.37317,1561077
15285,herzog31,2,0.00013,380486,24.37330,1561077
15286,hesteban-tuenti,2,0.00013,380488,24.37343,1561077
15287,hetang,2,0.00013,380490,24.37356,1561077
15288,heutschibogdan,2,0.00013,380492,24.37369,1561077
15289,Hext123,2,0.00013,380494,24.37381,1561077
15290,HeyLazySunnyKid,2,0.00013,380496,24.37394,1561077
15291,hfrenzel,2,0.00013,380498,24.37407,1561077
15292,hhaamm,2,0.00013,380500,24.37420,1561077
15293,hicjcn,2,0.00013,380502,24.37433,1561077
15294,hicnar,2,0.00013,380504,24.37445,1561077
15295,hiddevdm,2,0.00013,380506,24.37458,1561077
15296,hideakihal,2,0.00013,380508,24.37471,1561077
15297,hidroh,2,0.00013,380510,24.37484,1561077
15298,hilafish1,2,0.00013,380512,24.37497,1561077
15299,himanshucip,2,0.00013,380514,24.37509,1561077
15300,himasimplisafe,2,0.00013,380516,24.37522,1561077
15301,hindessm,2,0.00013,380518,24.37535,1561077
15302,hint66,2,0.00013,380520,24.37548,1561077
15303,Hinterwaeldlers,2,0.00013,380522,24.37561,1561077
15304,HirazawaUi,2,0.00013,380524,24.37574,1561077
15305,hirose31,2,0.00013,380526,24.37586,1561077
15306,historypeats,2,0.00013,380528,24.37599,1561077
15307,hjhafner,2,0.00013,380530,24.37612,1561077
15308,hlaf,2,0.00013,380532,24.37625,1561077
15309,hlechuga,2,0.00013,380534,24.37638,1561077
15310,hlorofos,2,0.00013,380536,24.37650,1561077
15311,hmacalgit,2,0.00013,380538,24.37663,1561077
15312,hmeerlo,2,0.00013,380540,24.37676,1561077
15313,hmmxp,2,0.00013,380542,24.37689,1561077
15314,hnicke,2,0.00013,380544,24.37702,1561077
15315,hnrkndrssn,2,0.00013,380546,24.37714,1561077
15316,hoffmale,2,0.00013,380548,24.37727,1561077
15317,hogstrom,2,0.00013,380550,24.37740,1561077
15318,hok-tong-ck,2,0.00013,380552,24.37753,1561077
15319,holgercn,2,0.00013,380554,24.37766,1561077
15320,holger-hoffmann,2,0.00013,380556,24.37779,1561077
15321,holybit,2,0.00013,380558,24.37791,1561077
15322,homeles,2,0.00013,380560,24.37804,1561077
15323,honeynagrikar,2,0.00013,380562,24.37817,1561077
15324,honzasvoby,2,0.00013,380564,24.37830,1561077
15325,hosseinkol,2,0.00013,380566,24.37843,1561077
15326,hossman,2,0.00013,380568,24.37855,1561077
15327,hostalp,2,0.00013,380570,24.37868,1561077
15328,hpareek1996,2,0.00013,380572,24.37881,1561077
15329,hqfking,2,0.00013,380574,24.37894,1561077
15330,hrabo,2,0.00013,380576,24.37907,1561077
15331,hrbust-liu,2,0.00013,380578,24.37919,1561077
15332,HristoStoyanovMM,2,0.00013,380580,24.37932,1561077
15333,hristozov,2,0.00013,380582,24.37945,1561077
15334,hrivera-ntap,2,0.00013,380584,24.37958,1561077
15335,hs115488,2,0.00013,380586,24.37971,1561077
15336,hschaa,2,0.00013,380588,24.37984,1561077
15337,htgurukul,2,0.00013,380590,24.37996,1561077
15338,hualoqueros,2,0.00013,380592,24.38009,1561077
15339,HuangFuFw,2,0.00013,380594,24.38022,1561077
15340,HuangJY777,2,0.00013,380596,24.38035,1561077
15341,huasipango,2,0.00013,380598,24.38048,1561077
15342,hubertgrzeskowiak,2,0.00013,380600,24.38060,1561077
15343,hubez,2,0.00013,380602,24.38073,1561077
15344,HubMiner,2,0.00013,380604,24.38086,1561077
15345,hugodahl,2,0.00013,380606,24.38099,1561077
15346,hugohenley,2,0.00013,380608,24.38112,1561077
15347,hugosanchezmartinez,2,0.00013,380610,24.38124,1561077
15348,hujiachun,2,0.00013,380612,24.38137,1561077
15349,humbled,2,0.00013,380614,24.38150,1561077
15350,Hungleminh,2,0.00013,380616,24.38163,1561077
15351,Hunter-Goolsbey,2,0.00013,380618,24.38176,1561077
15352,hurzelpurzel,2,0.00013,380620,24.38189,1561077
15353,hu-tmx,2,0.00013,380622,24.38201,1561077
15354,huyang,2,0.00013,380624,24.38214,1561077
15355,huzichunjohn,2,0.00013,380626,24.38227,1561077
15356,hwestphal,2,0.00013,380628,24.38240,1561077
15357,hwilsey-r7,2,0.00013,380630,24.38253,1561077
15358,hydev,2,0.00013,380632,24.38265,1561077
15359,HYmian,2,0.00013,380634,24.38278,1561077
15360,i059304,2,0.00013,380636,24.38291,1561077
15361,i5okie,2,0.00013,380638,24.38304,1561077
15362,iabramov,2,0.00013,380640,24.38317,1561077
15363,iamargentum,2,0.00013,380642,24.38329,1561077
15364,iamcdonald,2,0.00013,380644,24.38342,1561077
15365,iamonuwa,2,0.00013,380646,24.38355,1561077
15366,iamsharife,2,0.00013,380648,24.38368,1561077
15367,iangithubusername,2,0.00013,380650,24.38381,1561077
15368,Ian-Rossi-aimtheory,2,0.00013,380652,24.38393,1561077
15369,Ian-T-Price,2,0.00013,380654,24.38406,1561077
15370,IanVS,2,0.00013,380656,24.38419,1561077
15371,ianw6886,2,0.00013,380658,24.38432,1561077
15372,ianzanderson,2,0.00013,380660,24.38445,1561077
15373,iapplejohn,2,0.00013,380662,24.38458,1561077
15374,i-avalos,2,0.00013,380664,24.38470,1561077
15375,ibalosh,2,0.00013,380666,24.38483,1561077
15376,ibmcuijunluke,2,0.00013,380668,24.38496,1561077
15377,IceBoosteR,2,0.00013,380670,24.38509,1561077
15378,ichiong,2,0.00013,380672,24.38522,1561077
15379,iczechowski,2,0.00013,380674,24.38534,1561077
15380,idea360,2,0.00013,380676,24.38547,1561077
15381,idemidenko,2,0.00013,380678,24.38560,1561077
15382,idogadiel,2,0.00013,380680,24.38573,1561077
15383,idolum,2,0.00013,380682,24.38586,1561077
15384,idontsov,2,0.00013,380684,24.38598,1561077
15385,iFunbox,2,0.00013,380686,24.38611,1561077
15386,igloocube,2,0.00013,380688,24.38624,1561077
15387,Ignition,2,0.00013,380690,24.38637,1561077
15388,igor-clog-io,2,0.00013,380692,24.38650,1561077
15389,igorhou,2,0.00013,380694,24.38663,1561077
15390,IgorTimoshenko,2,0.00013,380696,24.38675,1561077
15391,igorvsd,2,0.00013,380698,24.38688,1561077
15392,ihakhverdiyev2019,2,0.00013,380700,24.38701,1561077
15393,ijuma,2,0.00013,380702,24.38714,1561077
15394,IKOBH,2,0.00013,380704,24.38727,1561077
15395,ikoutras-epages,2,0.00013,380706,24.38739,1561077
15396,Ikuze,2,0.00013,380708,24.38752,1561077
15397,ilanbiala,2,0.00013,380710,24.38765,1561077
15398,ileler,2,0.00013,380712,24.38778,1561077
15399,ileoo-boox,2,0.00013,380714,24.38791,1561077
15400,ilgonmic,2,0.00013,380716,24.38803,1561077
15401,iliasaddab,2,0.00013,380718,24.38816,1561077
15402,iljapavlovs,2,0.00013,380720,24.38829,1561077
15403,ilor,2,0.00013,380722,24.38842,1561077
15404,Iluvatari,2,0.00013,380724,24.38855,1561077
15405,imann24,2,0.00013,380726,24.38868,1561077
15406,imlcs,2,0.00013,380728,24.38880,1561077
15407,immortal-ziyang,2,0.00013,380730,24.38893,1561077
15408,imperialguy,2,0.00013,380732,24.38906,1561077
15409,improvebartek,2,0.00013,380734,24.38919,1561077
15410,Imransysg,2,0.00013,380736,24.38932,1561077
15411,InbarRose,2,0.00013,380738,24.38944,1561077
15412,Incognito,2,0.00013,380740,24.38957,1561077
15413,Incognito357,2,0.00013,380742,24.38970,1561077
15414,indiepopart,2,0.00013,380744,24.38983,1561077
15415,ineb,2,0.00013,380746,24.38996,1561077
15416,INFERN04,2,0.00013,380748,24.39008,1561077
15417,ingesolvoll,2,0.00013,380750,24.39021,1561077
15418,inish777,2,0.00013,380752,24.39034,1561077
15419,insane4sure,2,0.00013,380754,24.39047,1561077
15420,Intrepidd,2,0.00013,380756,24.39060,1561077
15421,intrigeri,2,0.00013,380758,24.39073,1561077
15422,InuSasha,2,0.00013,380760,24.39085,1561077
15423,inverse,2,0.00013,380762,24.39098,1561077
15424,iomac,2,0.00013,380764,24.39111,1561077
15425,iomarcovalente,2,0.00013,380766,24.39124,1561077
15426,ionelanton,2,0.00013,380768,24.39137,1561077
15427,iongchun,2,0.00013,380770,24.39149,1561077
15428,ip2k,2,0.00013,380772,24.39162,1561077
15429,ipereziriarte,2,0.00013,380774,24.39175,1561077
15430,iqwunder,2,0.00013,380776,24.39188,1561077
15431,irfanherfiandana,2,0.00013,380778,24.39201,1561077
15432,IrmantasM,2,0.00013,380780,24.39213,1561077
15433,irom77,2,0.00013,380782,24.39226,1561077
15434,irvingoe,2,0.00013,380784,24.39239,1561077
15435,iryna-nikolaienko,2,0.00013,380786,24.39252,1561077
15436,isaac88,2,0.00013,380788,24.39265,1561077
15437,isabellf,2,0.00013,380790,24.39277,1561077
15438,iscra,2,0.00013,380792,24.39290,1561077
15439,ishaangandhi,2,0.00013,380794,24.39303,1561077
15440,IshaGarg2504,2,0.00013,380796,24.39316,1561077
15441,ishan-jogalekar,2,0.00013,380798,24.39329,1561077
15442,islishude,2,0.00013,380800,24.39342,1561077
15443,iSm1le,2,0.00013,380802,24.39354,1561077
15444,ismyrnow,2,0.00013,380804,24.39367,1561077
15445,isqrd,2,0.00013,380806,24.39380,1561077
15446,istvankovacs,2,0.00013,380808,24.39393,1561077
15447,isuda,2,0.00013,380810,24.39406,1561077
15448,isurugiu,2,0.00013,380812,24.39418,1561077
15449,isutton,2,0.00013,380814,24.39431,1561077
15450,itruivitorino,2,0.00013,380816,24.39444,1561077
15451,itsamenathan,2,0.00013,380818,24.39457,1561077
15452,itsmetambui,2,0.00013,380820,24.39470,1561077
15453,itsSaad,2,0.00013,380822,24.39482,1561077
15454,itstayyabkhan,2,0.00013,380824,24.39495,1561077
15455,iturman,2,0.00013,380826,24.39508,1561077
15456,ityoung,2,0.00013,380828,24.39521,1561077
15457,itzikbekel,2,0.00013,380830,24.39534,1561077
15458,ivan3177,2,0.00013,380832,24.39547,1561077
15459,ivkim,2,0.00013,380834,24.39559,1561077
15460,ivojonker,2,0.00013,380836,24.39572,1561077
15461,iynere,2,0.00013,380838,24.39585,1561077
15462,IzakMarais,2,0.00013,380840,24.39598,1561077
15463,izenk,2,0.00013,380842,24.39611,1561077
15464,j14ncn,2,0.00013,380844,24.39623,1561077
15465,j771,2,0.00013,380846,24.39636,1561077
15466,jabooth,2,0.00013,380848,24.39649,1561077
15467,jacampano,2,0.00013,380850,24.39662,1561077
15468,jacekgajek,2,0.00013,380852,24.39675,1561077
15469,jackalsh,2,0.00013,380854,24.39687,1561077
15470,JackieBinya,2,0.00013,380856,24.39700,1561077
15471,JackMetkus,2,0.00013,380858,24.39713,1561077
15472,JackTiger,2,0.00013,380860,24.39726,1561077
15473,jack-w-shaw,2,0.00013,380862,24.39739,1561077
15474,jackwu-hub,2,0.00013,380864,24.39752,1561077
15475,JacobAMason,2,0.00013,380866,24.39764,1561077
15476,jacobamey,2,0.00013,380868,24.39777,1561077
15477,jacquelinejms95,2,0.00013,380870,24.39790,1561077
15478,jacquesknipper,2,0.00013,380872,24.39803,1561077
15479,jadoro,2,0.00013,380874,24.39816,1561077
15480,jadsalhanisar,2,0.00013,380876,24.39828,1561077
15481,jagadeeswar725863,2,0.00013,380878,24.39841,1561077
15482,jagardaniel,2,0.00013,380880,24.39854,1561077
15483,jagnikam-ox,2,0.00013,380882,24.39867,1561077
15484,jahudgins,2,0.00013,380884,24.39880,1561077
15485,jairov4,2,0.00013,380886,24.39892,1561077
15486,Jake-00,2,0.00013,380888,24.39905,1561077
15487,jakob-grabner,2,0.00013,380890,24.39918,1561077
15488,jakobwenzel,2,0.00013,380892,24.39931,1561077
15489,JakotoGlaslow,2,0.00013,380894,24.39944,1561077
15490,jakozaur,2,0.00013,380896,24.39957,1561077
15491,Jakub-CZ,2,0.00013,380898,24.39969,1561077
15492,JakubPiasekAGH,2,0.00013,380900,24.39982,1561077
15493,jaleela-f,2,0.00013,380902,24.39995,1561077
15494,Jalle19,2,0.00013,380904,24.40008,1561077
15495,james88nguyen,2,0.00013,380906,24.40021,1561077
15496,jamescarr,2,0.00013,380908,24.40033,1561077
15497,jamescmartinez,2,0.00013,380910,24.40046,1561077
15498,jamesmckenzie,2,0.00013,380912,24.40059,1561077
15499,james-mf,2,0.00013,380914,24.40072,1561077
15500,jamesob131,2,0.00013,380916,24.40085,1561077
15501,jamespullar,2,0.00013,380918,24.40097,1561077
15502,JamesRichard,2,0.00013,380920,24.40110,1561077
15503,james-robson,2,0.00013,380922,24.40123,1561077
15504,jamesvanhorn,2,0.00013,380924,24.40136,1561077
15505,jameswragg,2,0.00013,380926,24.40149,1561077
15506,jamielsharief,2,0.00013,380928,24.40162,1561077
15507,jamie-mh,2,0.00013,380930,24.40174,1561077
15508,jamieps,2,0.00013,380932,24.40187,1561077
15509,jamiesprax,2,0.00013,380934,24.40200,1561077
15510,JaminenB,2,0.00013,380936,24.40213,1561077
15511,jammer87,2,0.00013,380938,24.40226,1561077
15512,jamonation,2,0.00013,380940,24.40238,1561077
15513,jampo,2,0.00013,380942,24.40251,1561077
15514,jamyl,2,0.00013,380944,24.40264,1561077
15515,JanC,2,0.00013,380946,24.40277,1561077
15516,janeklb,2,0.00013,380948,24.40290,1561077
15517,JaneSoo,2,0.00013,380950,24.40302,1561077
15518,jangel97,2,0.00013,380952,24.40315,1561077
15519,JaniFuturemark,2,0.00013,380954,24.40328,1561077
15520,janithjeewantha,2,0.00013,380956,24.40341,1561077
15521,janitza-jamu,2,0.00013,380958,24.40354,1561077
15522,Jankyboy,2,0.00013,380960,24.40366,1561077
15523,janmaterne,2,0.00013,380962,24.40379,1561077
15524,jan-mueller-work,2,0.00013,380964,24.40392,1561077
15525,JanoschSchaefer,2,0.00013,380966,24.40405,1561077
15526,janoshvi,2,0.00013,380968,24.40418,1561077
15527,jan-ruzicka-c,2,0.00013,380970,24.40431,1561077
15528,janse180,2,0.00013,380972,24.40443,1561077
15529,jans-jeroen,2,0.00013,380974,24.40456,1561077
15530,jansvajcr,2,0.00013,380976,24.40469,1561077
15531,JaredEgolf,2,0.00013,380978,24.40482,1561077
15532,jaredwy,2,0.00013,380980,24.40495,1561077
15533,jareware,2,0.00013,380982,24.40507,1561077
15534,jaronsummers,2,0.00013,380984,24.40520,1561077
15535,jarspi,2,0.00013,380986,24.40533,1561077
15536,jarvan4dev,2,0.00013,380988,24.40546,1561077
15537,Jas659,2,0.00013,380990,24.40559,1561077
15538,jascao,2,0.00013,380992,24.40571,1561077
15539,jasiura,2,0.00013,380994,24.40584,1561077
15540,Jaskaranbir,2,0.00013,380996,24.40597,1561077
15541,jaskirat8,2,0.00013,380998,24.40610,1561077
15542,jasminen,2,0.00013,381000,24.40623,1561077
15543,jason-azze,2,0.00013,381002,24.40636,1561077
15544,jasonbarnett667,2,0.00013,381004,24.40648,1561077
15545,jasongerard,2,0.00013,381006,24.40661,1561077
15546,jason-koppel-avlino,2,0.00013,381008,24.40674,1561077
15547,JasonLeeFrench,2,0.00013,381010,24.40687,1561077
15548,jasonlll88,2,0.00013,381012,24.40700,1561077
15549,jasonm23,2,0.00013,381014,24.40712,1561077
15550,jasonschroeder-sfdc,2,0.00013,381016,24.40725,1561077
15551,jason-womack,2,0.00013,381018,24.40738,1561077
15552,jatikuma29iv,2,0.00013,381020,24.40751,1561077
15553,jatinbedi,2,0.00013,381022,24.40764,1561077
15554,javidgon,2,0.00013,381024,24.40776,1561077
15555,JavierCVilla,2,0.00013,381026,24.40789,1561077
15556,jaw111,2,0.00013,381028,24.40802,1561077
15557,jay1412008,2,0.00013,381030,24.40815,1561077
15558,jay7x,2,0.00013,381032,24.40828,1561077
15559,JayantGoel001,2,0.00013,381034,24.40841,1561077
15560,jayceekay,2,0.00013,381036,24.40853,1561077
15561,jaydobariya98,2,0.00013,381038,24.40866,1561077
15562,jayeff,2,0.00013,381040,24.40879,1561077
15563,jay-hankins,2,0.00013,381042,24.40892,1561077
15564,JayJay1989,2,0.00013,381044,24.40905,1561077
15565,jayjlawrence,2,0.00013,381046,24.40917,1561077
15566,jaysoffian,2,0.00013,381048,24.40930,1561077
15567,jbauers,2,0.00013,381050,24.40943,1561077
15568,jbennett2091,2,0.00013,381052,24.40956,1561077
15569,jbergstroem,2,0.00013,381054,24.40969,1561077
15570,jberkenbilt,2,0.00013,381056,24.40981,1561077
15571,jbkempf,2,0.00013,381058,24.40994,1561077
15572,jblamotte,2,0.00013,381060,24.41007,1561077
15573,jbmolle,2,0.00013,381062,24.41020,1561077
15574,jbnetfr,2,0.00013,381064,24.41033,1561077
15575,jbnjohnathan,2,0.00013,381066,24.41046,1561077
15576,jbobaggins,2,0.00013,381068,24.41058,1561077
15577,jboehle,2,0.00013,381070,24.41071,1561077
15578,jbresciani,2,0.00013,381072,24.41084,1561077
15579,jbromero12,2,0.00013,381074,24.41097,1561077
15580,jbruce12000,2,0.00013,381076,24.41110,1561077
15581,jburnard9464,2,0.00013,381078,24.41122,1561077
15582,jbylund,2,0.00013,381080,24.41135,1561077
15583,jcalais,2,0.00013,381082,24.41148,1561077
15584,jcalavia,2,0.00013,381084,24.41161,1561077
15585,jcalvilloitrs,2,0.00013,381086,24.41174,1561077
15586,jcastillo-cb,2,0.00013,381088,24.41186,1561077
15587,jc-dgit,2,0.00013,381090,24.41199,1561077
15588,jceresini,2,0.00013,381092,24.41212,1561077
15589,JCFlores93,2,0.00013,381094,24.41225,1561077
15590,jchaef,2,0.00013,381096,24.41238,1561077
15591,jchambers,2,0.00013,381098,24.41250,1561077
15592,jchyip,2,0.00013,381100,24.41263,1561077
15593,jclulow,2,0.00013,381102,24.41276,1561077
15594,Jcmarc1flores,2,0.00013,381104,24.41289,1561077
15595,jcoyne,2,0.00013,381106,24.41302,1561077
15596,jcsou,2,0.00013,381108,24.41315,1561077
15597,jcstorino,2,0.00013,381110,24.41327,1561077
15598,jd8099537,2,0.00013,381112,24.41340,1561077
15599,jdmears2,2,0.00013,381114,24.41353,1561077
15600,jdomag,2,0.00013,381116,24.41366,1561077
15601,jdposthuma,2,0.00013,381118,24.41379,1561077
15602,jdsn,2,0.00013,381120,24.41391,1561077
15603,jeahoonchen,2,0.00013,381122,24.41404,1561077
15604,je-al,2,0.00013,381124,24.41417,1561077
15605,jed-frey,2,0.00013,381126,24.41430,1561077
15606,jeevandev,2,0.00013,381128,24.41443,1561077
15607,jeff1evesque,2,0.00013,381130,24.41455,1561077
15608,jeffery,2,0.00013,381132,24.41468,1561077
15609,jefffiser,2,0.00013,381134,24.41481,1561077
15610,Jefffrey,2,0.00013,381136,24.41494,1561077
15611,jeffj254,2,0.00013,381138,24.41507,1561077
15612,jeffminard-ck,2,0.00013,381140,24.41520,1561077
15613,jeffrey-shen-hs,2,0.00013,381142,24.41532,1561077
15614,jeffreyzhou,2,0.00013,381144,24.41545,1561077
15615,jekader,2,0.00013,381146,24.41558,1561077
15616,jeldert,2,0.00013,381148,24.41571,1561077
15617,jelmd,2,0.00013,381150,24.41584,1561077
15618,jemc,2,0.00013,381152,24.41596,1561077
15619,jenkinscye,2,0.00013,381154,24.41609,1561077
15620,JenkinsDebate,2,0.00013,381156,24.41622,1561077
15621,jenniferhuang,2,0.00013,381158,24.41635,1561077
15622,jenoOvchi,2,0.00013,381160,24.41648,1561077
15623,jeredp,2,0.00013,381162,24.41660,1561077
15624,jeremych1000,2,0.00013,381164,24.41673,1561077
15625,jeremykuhnash,2,0.00013,381166,24.41686,1561077
15626,jeremypope,2,0.00013,381168,24.41699,1561077
15627,jerh616,2,0.00013,381170,24.41712,1561077
15628,jerome-lanneluc,2,0.00013,381172,24.41725,1561077
15629,jerryhouuu,2,0.00013,381174,24.41737,1561077
15630,jessefriedland,2,0.00013,381176,24.41750,1561077
15631,jessegonzalez,2,0.00013,381178,24.41763,1561077
15632,jessica-pixvana,2,0.00013,381180,24.41776,1561077
15633,jessie-ye-hs,2,0.00013,381182,24.41789,1561077
15634,jetune,2,0.00013,381184,24.41801,1561077
15635,jetztgradnet,2,0.00013,381186,24.41814,1561077
15636,jeubank12,2,0.00013,381188,24.41827,1561077
15637,jeunito,2,0.00013,381190,24.41840,1561077
15638,jeusdi,2,0.00013,381192,24.41853,1561077
15639,Jeykey1990,2,0.00013,381194,24.41865,1561077
15640,jezhalford,2,0.00013,381196,24.41878,1561077
15641,jezradek,2,0.00013,381198,24.41891,1561077
15642,Jezza,2,0.00013,381200,24.41904,1561077
15643,jf647,2,0.00013,381202,24.41917,1561077
15644,jfachal,2,0.00013,381204,24.41930,1561077
15645,jfernand21,2,0.00013,381206,24.41942,1561077
15646,jfisbein,2,0.00013,381208,24.41955,1561077
15647,jfstephe,2,0.00013,381210,24.41968,1561077
15648,jftanner,2,0.00013,381212,24.41981,1561077
15649,jftigeras,2,0.00013,381214,24.41994,1561077
15650,jgainey,2,0.00013,381216,24.42006,1561077
15651,jgam,2,0.00013,381218,24.42019,1561077
15652,jgeiger,2,0.00013,381220,24.42032,1561077
15653,jgiovaresco,2,0.00013,381222,24.42045,1561077
15654,jglick-test,2,0.00013,381224,24.42058,1561077
15655,jgmsb,2,0.00013,381226,24.42070,1561077
15656,jgraglia,2,0.00013,381228,24.42083,1561077
15657,jgutierrezglez,2,0.00013,381230,24.42096,1561077
15658,jharveysmith,2,0.00013,381232,24.42109,1561077
15659,jhazelwo,2,0.00013,381234,24.42122,1561077
15660,jhendley25,2,0.00013,381236,24.42135,1561077
15661,jherlitz-r7,2,0.00013,381238,24.42147,1561077
15662,jhf,2,0.00013,381240,24.42160,1561077
15663,jhogarth97,2,0.00013,381242,24.42173,1561077
15664,jhominal,2,0.00013,381244,24.42186,1561077
15665,Jhott420,2,0.00013,381246,24.42199,1561077
15666,jhoval,2,0.00013,381248,24.42211,1561077
15667,jhpierce,2,0.00013,381250,24.42224,1561077
15668,jhsea3do,2,0.00013,381252,24.42237,1561077
15669,jiahut,2,0.00013,381254,24.42250,1561077
15670,jian-feng,2,0.00013,381256,24.42263,1561077
15671,jiantian,2,0.00013,381258,24.42275,1561077
15672,jiaoyiping,2,0.00013,381260,24.42288,1561077
15673,jiayiwang7,2,0.00013,381262,24.42301,1561077
15674,jibinbabu,2,0.00013,381264,24.42314,1561077
15675,jibinjohnbabu,2,0.00013,381266,24.42327,1561077
15676,jibin-tj,2,0.00013,381268,24.42339,1561077
15677,jibsheet,2,0.00013,381270,24.42352,1561077
15678,jicomusic,2,0.00013,381272,24.42365,1561077
15679,jifengzhang-tradedoubler,2,0.00013,381274,24.42378,1561077
15680,JiffsMaverick,2,0.00013,381276,24.42391,1561077
15681,jigar-komodo,2,0.00013,381278,24.42404,1561077
15682,jijopjoy,2,0.00013,381280,24.42416,1561077
15683,jimbasilio,2,0.00013,381282,24.42429,1561077
15684,jimbo8098,2,0.00013,381284,24.42442,1561077
15685,jimbocoder,2,0.00013,381286,24.42455,1561077
15686,jimenezfd,2,0.00013,381288,24.42468,1561077
15687,jimjh,2,0.00013,381290,24.42480,1561077
15688,jimmyh85,2,0.00013,381292,24.42493,1561077
15689,jimmyharris,2,0.00013,381294,24.42506,1561077
15690,jimmykarily,2,0.00013,381296,24.42519,1561077
15691,jimsonyu,2,0.00013,381298,24.42532,1561077
15692,jimwhitelaw,2,0.00013,381300,24.42544,1561077
15693,jin123d,2,0.00013,381302,24.42557,1561077
15694,jincod,2,0.00013,381304,24.42570,1561077
15695,jineshsubedi,2,0.00013,381306,24.42583,1561077
15696,jingliancui,2,0.00013,381308,24.42596,1561077
15697,jingtyagi,2,0.00013,381310,24.42609,1561077
15698,JiriHusak-lab,2,0.00013,381312,24.42621,1561077
15699,jirimacku,2,0.00013,381314,24.42634,1561077
15700,jisenberg,2,0.00013,381316,24.42647,1561077
15701,jishanahmad,2,0.00013,381318,24.42660,1561077
15702,jishwin13,2,0.00013,381320,24.42673,1561077
15703,jitendra9873,2,0.00013,381322,24.42685,1561077
15704,jive-i18n,2,0.00013,381324,24.42698,1561077
15705,jjames967,2,0.00013,381326,24.42711,1561077
15706,jjardina,2,0.00013,381328,24.42724,1561077
15707,jkbszpg,2,0.00013,381330,24.42737,1561077
15708,jkburges,2,0.00013,381332,24.42749,1561077
15709,jkeroes,2,0.00013,381334,24.42762,1561077
15710,jkfernan,2,0.00013,381336,24.42775,1561077
15711,jkimrey,2,0.00013,381338,24.42788,1561077
15712,jkljf,2,0.00013,381340,24.42801,1561077
15713,jkumar-roambee,2,0.00013,381342,24.42814,1561077
15714,jkunjoonju18,2,0.00013,381344,24.42826,1561077
15715,jlabonski,2,0.00013,381346,24.42839,1561077
15716,jlbernal,2,0.00013,381348,24.42852,1561077
15717,jlcontreras,2,0.00013,381350,24.42865,1561077
15718,jldugger,2,0.00013,381352,24.42878,1561077
15719,jlecount-qadium,2,0.00013,381354,24.42890,1561077
15720,jlott,2,0.00013,381356,24.42903,1561077
15721,jlwuleo,2,0.00013,381358,24.42916,1561077
15722,jmack51,2,0.00013,381360,24.42929,1561077
15723,jmarkos,2,0.00013,381362,24.42942,1561077
15724,jmendiara,2,0.00013,381364,24.42954,1561077
15725,jmfulgham,2,0.00013,381366,24.42967,1561077
15726,jmguilla,2,0.00013,381368,24.42980,1561077
15727,jmiettinen,2,0.00013,381370,24.42993,1561077
15728,jmittert,2,0.00013,381372,24.43006,1561077
15729,jmmen1,2,0.00013,381374,24.43019,1561077
15730,jmmk,2,0.00013,381376,24.43031,1561077
15731,jmnavarrol,2,0.00013,381378,24.43044,1561077
15732,jmukhtar,2,0.00013,381380,24.43057,1561077
15733,jmurphyau,2,0.00013,381382,24.43070,1561077
15734,jnutzman,2,0.00013,381384,24.43083,1561077
15735,joashc,2,0.00013,381386,24.43095,1561077
15736,jochen1234,2,0.00013,381388,24.43108,1561077
15737,jochenhebbrecht,2,0.00013,381390,24.43121,1561077
15738,jodli,2,0.00013,381392,24.43134,1561077
15739,joe1chen,2,0.00013,381394,24.43147,1561077
15740,joeabbey,2,0.00013,381396,24.43159,1561077
15741,JoeAnzalone,2,0.00013,381398,24.43172,1561077
15742,Joeb454,2,0.00013,381400,24.43185,1561077
15743,Joe-Downs,2,0.00013,381402,24.43198,1561077
15744,joehoeller,2,0.00013,381404,24.43211,1561077
15745,joelfire,2,0.00013,381406,24.43223,1561077
15746,joelroyer,2,0.00013,381408,24.43236,1561077
15747,joelwilson,2,0.00013,381410,24.43249,1561077
15748,JoepWeijers,2,0.00013,381412,24.43262,1561077
15749,joerayme,2,0.00013,381414,24.43275,1561077
15750,JohannChuCloudMile,2,0.00013,381416,24.43288,1561077
15751,johnbenz13,2,0.00013,381418,24.43300,1561077
15752,Johnbo,2,0.00013,381420,24.43313,1561077
15753,john-ekka,2,0.00013,381422,24.43326,1561077
15754,john-heinnickel,2,0.00013,381424,24.43339,1561077
15755,johnmcase,2,0.00013,381426,24.43352,1561077
15756,johnnymn,2,0.00013,381428,24.43364,1561077
15757,JohnRoach,2,0.00013,381430,24.43377,1561077
15758,johnstonmatt,2,0.00013,381432,24.43390,1561077
15759,johntdyer,2,0.00013,381434,24.43403,1561077
15760,john-tipper,2,0.00013,381436,24.43416,1561077
15761,johnyod,2,0.00013,381438,24.43428,1561077
15762,johnypony3,2,0.00013,381440,24.43441,1561077
15763,joinghel,2,0.00013,381442,24.43454,1561077
15764,jojoldu,2,0.00013,381444,24.43467,1561077
15765,JokerDen,2,0.00013,381446,24.43480,1561077
15766,JokerDevops,2,0.00013,381448,24.43493,1561077
15767,jokurz,2,0.00013,381450,24.43505,1561077
15768,Jonakss,2,0.00013,381452,24.43518,1561077
15769,jonaldomo,2,0.00013,381454,24.43531,1561077
15770,jonas-ms,2,0.00013,381456,24.43544,1561077
15771,JonatanPlesko,2,0.00013,381458,24.43557,1561077
15772,jonatasdemello,2,0.00013,381460,24.43569,1561077
15773,jonathanbaugh,2,0.00013,381462,24.43582,1561077
15774,jonathancole-h1,2,0.00013,381464,24.43595,1561077
15775,JonathanHuot,2,0.00013,381466,24.43608,1561077
15776,jonathanjbutler,2,0.00013,381468,24.43621,1561077
15777,jonathanjtan,2,0.00013,381470,24.43633,1561077
15778,jonathan-mothership,2,0.00013,381472,24.43646,1561077
15779,jonathanpbailey,2,0.00013,381474,24.43659,1561077
15780,joncotedev,2,0.00013,381476,24.43672,1561077
15781,jonefeewang,2,0.00013,381478,24.43685,1561077
15782,jones2026,2,0.00013,381480,24.43698,1561077
15783,jongwooo,2,0.00013,381482,24.43710,1561077
15784,Joni-Lover,2,0.00013,381484,24.43723,1561077
15785,jonmill,2,0.00013,381486,24.43736,1561077
15786,jonpbbc,2,0.00013,381488,24.43749,1561077
15787,jonpugh,2,0.00013,381490,24.43762,1561077
15788,jonstacks,2,0.00013,381492,24.43774,1561077
15789,jonware,2,0.00013,381494,24.43787,1561077
15790,joonasky,2,0.00013,381496,24.43800,1561077
15791,Joozty,2,0.00013,381498,24.43813,1561077
15792,JordanGlassley,2,0.00013,381500,24.43826,1561077
15793,JordanMajd,2,0.00013,381502,24.43838,1561077
15794,jordarlu,2,0.00013,381504,24.43851,1561077
15795,jordimas,2,0.00013,381506,24.43864,1561077
15796,JorgeGuerrero-dev,2,0.00013,381508,24.43877,1561077
15797,jorgenkg,2,0.00013,381510,24.43890,1561077
15798,JorgePenaranda-Incontact,2,0.00013,381512,24.43903,1561077
15799,jorgeuriarte,2,0.00013,381514,24.43915,1561077
15800,jorgonzalez,2,0.00013,381516,24.43928,1561077
15801,JorSanders,2,0.00013,381518,24.43941,1561077
15802,josb-mi,2,0.00013,381520,24.43954,1561077
15803,josemonsalve2,2,0.00013,381522,24.43967,1561077
15804,josephldooley,2,0.00013,381524,24.43979,1561077
15805,josfyorobe,2,0.00013,381526,24.43992,1561077
15806,joshendriks,2,0.00013,381528,24.44005,1561077
15807,JoshuaJamesOng,2,0.00013,381530,24.44018,1561077
15808,josipradic,2,0.00013,381532,24.44031,1561077
15809,josselinchevalay,2,0.00013,381534,24.44043,1561077
15810,jovanshernandez,2,0.00013,381536,24.44056,1561077
15811,joysarkarhub,2,0.00013,381538,24.44069,1561077
15812,jozef-slezak,2,0.00013,381540,24.44082,1561077
15813,jpawlak-sb,2,0.00013,381542,24.44095,1561077
15814,j-p-e,2,0.00013,381544,24.44107,1561077
15815,jpergega2006,2,0.00013,381546,24.44120,1561077
15816,jp-gorman,2,0.00013,381548,24.44133,1561077
15817,jpic,2,0.00013,381550,24.44146,1561077
15818,jpsecher,2,0.00013,381552,24.44159,1561077
15819,jpswade,2,0.00013,381554,24.44172,1561077
15820,jr00n,2,0.00013,381556,24.44184,1561077
15821,jrajax,2,0.00013,381558,24.44197,1561077
15822,jreimone,2,0.00013,381560,24.44210,1561077
15823,jrichmond4,2,0.00013,381562,24.44223,1561077
15824,jsander128,2,0.00013,381564,24.44236,1561077
15825,jschear,2,0.00013,381566,24.44248,1561077
15826,jschultzmn,2,0.00013,381568,24.44261,1561077
15827,jsgoller1,2,0.00013,381570,24.44274,1561077
15828,jshcodes,2,0.00013,381572,24.44287,1561077
15829,jshergill,2,0.00013,381574,24.44300,1561077
15830,jsiei97,2,0.00013,381576,24.44312,1561077
15831,jslay88,2,0.00013,381578,24.44325,1561077
15832,jsmilani,2,0.00013,381580,24.44338,1561077
15833,jsmouret,2,0.00013,381582,24.44351,1561077
15834,jsmwoolf,2,0.00013,381584,24.44364,1561077
15835,jsotuyod,2,0.00013,381586,24.44377,1561077
15836,jstarcher,2,0.00013,381588,24.44389,1561077
15837,jstmlr,2,0.00013,381590,24.44402,1561077
15838,jsu,2,0.00013,381592,24.44415,1561077
15839,jtama-op,2,0.00013,381594,24.44428,1561077
15840,jtheoof,2,0.00013,381596,24.44441,1561077
15841,jtyr,2,0.00013,381598,24.44453,1561077
15842,juancuevas-ops,2,0.00013,381600,24.44466,1561077
15843,Juanlu001,2,0.00013,381602,24.44479,1561077
15844,jubinjose,2,0.00013,381604,24.44492,1561077
15845,JudeaDumont,2,0.00013,381606,24.44505,1561077
15846,juergens73,2,0.00013,381608,24.44517,1561077
15847,jufkes,2,0.00013,381610,24.44530,1561077
15848,juharris,2,0.00013,381612,24.44543,1561077
15849,Juholei,2,0.00013,381614,24.44556,1561077
15850,juju2112,2,0.00013,381616,24.44569,1561077
15851,JulianAlbarellos,2,0.00013,381618,24.44582,1561077
15852,Julian-B90,2,0.00013,381620,24.44594,1561077
15853,julianboehne,2,0.00013,381622,24.44607,1561077
15854,juliancadi,2,0.00013,381624,24.44620,1561077
15855,julianladisch,2,0.00013,381626,24.44633,1561077
15856,JulianSauer,2,0.00013,381628,24.44646,1561077
15857,julienlancelot,2,0.00013,381630,24.44658,1561077
15858,julienlucasFR,2,0.00013,381632,24.44671,1561077
15859,julienteisseire,2,0.00013,381634,24.44684,1561077
15860,julioarmandof,2,0.00013,381636,24.44697,1561077
15861,june07,2,0.00013,381638,24.44710,1561077
15862,junoteam,2,0.00013,381640,24.44722,1561077
15863,junydania,2,0.00013,381642,24.44735,1561077
15864,Jurrie,2,0.00013,381644,24.44748,1561077
15865,justaj,2,0.00013,381646,24.44761,1561077
15866,justcttseng,2,0.00013,381648,24.44774,1561077
15867,justdevops,2,0.00013,381650,24.44787,1561077
15868,justin88079,2,0.00013,381652,24.44799,1561077
15869,justinedelson,2,0.00013,381654,24.44812,1561077
15870,justinjschaub,2,0.00013,381656,24.44825,1561077
15871,JustinLewisNR,2,0.00013,381658,24.44838,1561077
15872,justinwhite,2,0.00013,381660,24.44851,1561077
15873,JustOneMoreBlock,2,0.00013,381662,24.44863,1561077
15874,jvaleo,2,0.00013,381664,24.44876,1561077
15875,jvanbouchaute,2,0.00013,381666,24.44889,1561077
15876,jvexiau,2,0.00013,381668,24.44902,1561077
15877,jvizcarra55,2,0.00013,381670,24.44915,1561077
15878,jwanderson1326,2,0.00013,381672,24.44927,1561077
15879,jwdani,2,0.00013,381674,24.44940,1561077
15880,jweismann-cd,2,0.00013,381676,24.44953,1561077
15881,jwerak,2,0.00013,381678,24.44966,1561077
15882,jwmach1,2,0.00013,381680,24.44979,1561077
15883,jxr98,2,0.00013,381682,24.44992,1561077
15884,jycchoi,2,0.00013,381684,24.45004,1561077
15885,jystephan,2,0.00013,381686,24.45017,1561077
15886,jzhu-2,2,0.00013,381688,24.45030,1561077
15887,jzjzjzj,2,0.00013,381690,24.45043,1561077
15888,jzr1991,2,0.00013,381692,24.45056,1561077
15889,k1nger,2,0.00013,381694,24.45068,1561077
15890,kaankalendr,2,0.00013,381696,24.45081,1561077
15891,Kabangi,2,0.00013,381698,24.45094,1561077
15892,KaiSiMa,2,0.00013,381700,24.45107,1561077
15893,kaisudhe,2,0.00013,381702,24.45120,1561077
15894,kak-bo-che,2,0.00013,381704,24.45132,1561077
15895,KalenWessel,2,0.00013,381706,24.45145,1561077
15896,kalmiz,2,0.00013,381708,24.45158,1561077
15897,kalpana2626,2,0.00013,381710,24.45171,1561077
15898,Kalpesh-18,2,0.00013,381712,24.45184,1561077
15899,kalyantag,2,0.00013,381714,24.45196,1561077
15900,kamaliang,2,0.00013,381716,24.45209,1561077
15901,kamil-baran,2,0.00013,381718,24.45222,1561077
15902,KamilKopaczyk,2,0.00013,381720,24.45235,1561077
15903,kamilzal,2,0.00013,381722,24.45248,1561077
15904,kamorozov,2,0.00013,381724,24.45261,1561077
15905,kamranayub,2,0.00013,381726,24.45273,1561077
15906,kanbekotori,2,0.00013,381728,24.45286,1561077
15907,kanekv,2,0.00013,381730,24.45299,1561077
15908,kangman,2,0.00013,381732,24.45312,1561077
15909,kaniki,2,0.00013,381734,24.45325,1561077
15910,kanivetsi,2,0.00013,381736,24.45337,1561077
15911,kanokwanmaneeon,2,0.00013,381738,24.45350,1561077
15912,kansberry,2,0.00013,381740,24.45363,1561077
15913,Kanti,2,0.00013,381742,24.45376,1561077
15914,kaplin,2,0.00013,381744,24.45389,1561077
15915,kapopken,2,0.00013,381746,24.45401,1561077
15916,karl0ss,2,0.00013,381748,24.45414,1561077
15917,karlhaas,2,0.00013,381750,24.45427,1561077
15918,karlhorky,2,0.00013,381752,24.45440,1561077
15919,karololszacki,2,0.00013,381754,24.45453,1561077
15920,karthikeayan,2,0.00013,381756,24.45466,1561077
15921,karthik-ir,2,0.00013,381758,24.45478,1561077
15922,KarthikRangaraju,2,0.00013,381760,24.45491,1561077
15923,Kasen,2,0.00013,381762,24.45504,1561077
15924,kasuboski,2,0.00013,381764,24.45517,1561077
15925,kasunsewwandika,2,0.00013,381766,24.45530,1561077
15926,katallaxie,2,0.00013,381768,24.45542,1561077
15927,katemarshall96,2,0.00013,381770,24.45555,1561077
15928,kaverkiev,2,0.00013,381772,24.45568,1561077
15929,kawazaki0,2,0.00013,381774,24.45581,1561077
15930,kaylanm,2,0.00013,381776,24.45594,1561077
15931,kazihuo,2,0.00013,381778,24.45606,1561077
15932,k-brooks,2,0.00013,381780,24.45619,1561077
15933,kchaitu4,2,0.00013,381782,24.45632,1561077
15934,kcyeu,2,0.00013,381784,24.45645,1561077
15935,kdeloach,2,0.00013,381786,24.45658,1561077
15936,K-DOT,2,0.00013,381788,24.45671,1561077
15937,kdoustar,2,0.00013,381790,24.45683,1561077
15938,kdufourbe,2,0.00013,381792,24.45696,1561077
15939,kdvy,2,0.00013,381794,24.45709,1561077
15940,kedio,2,0.00013,381796,24.45722,1561077
15941,KeHaohaoke,2,0.00013,381798,24.45735,1561077
15942,keithmarsh,2,0.00013,381800,24.45747,1561077
15943,keithmendozasr,2,0.00013,381802,24.45760,1561077
15944,KeithTt,2,0.00013,381804,24.45773,1561077
15945,keke8273,2,0.00013,381806,24.45786,1561077
15946,KekSfabrik,2,0.00013,381808,24.45799,1561077
15947,ken91,2,0.00013,381810,24.45811,1561077
15948,KenCoreyFirefly,2,0.00013,381812,24.45824,1561077
15949,kengou,2,0.00013,381814,24.45837,1561077
15950,KenLai,2,0.00013,381816,24.45850,1561077
15951,KenneyE,2,0.00013,381818,24.45863,1561077
15952,kennr,2,0.00013,381820,24.45876,1561077
15953,Kenuat,2,0.00013,381822,24.45888,1561077
15954,keoren3,2,0.00013,381824,24.45901,1561077
15955,keqingyuan,2,0.00013,381826,24.45914,1561077
15956,keramiozsoy,2,0.00013,381828,24.45927,1561077
15957,kerika-devops,2,0.00013,381830,24.45940,1561077
15958,Kerlione,2,0.00013,381832,24.45952,1561077
15959,ketiko,2,0.00013,381834,24.45965,1561077
15960,kevincai,2,0.00013,381836,24.45978,1561077
15961,kevinconaway,2,0.00013,381838,24.45991,1561077
15962,kevin-daniels,2,0.00013,381840,24.46004,1561077
15963,KevinM2k,2,0.00013,381842,24.46016,1561077
15964,kevinroisin,2,0.00013,381844,24.46029,1561077
15965,kev-in-shu,2,0.00013,381846,24.46042,1561077
15966,kevinsuwala,2,0.00013,381848,24.46055,1561077
15967,kevinvandervlist,2,0.00013,381850,24.46068,1561077
15968,kevinyu98,2,0.00013,381852,24.46080,1561077
15969,kevit,2,0.00013,381854,24.46093,1561077
15970,kewlvishnu,2,0.00013,381856,24.46106,1561077
15971,keyen999,2,0.00013,381858,24.46119,1561077
15972,keysher,2,0.00013,381860,24.46132,1561077
15973,kflorence,2,0.00013,381862,24.46145,1561077
15974,Kgirthofer,2,0.00013,381864,24.46157,1561077
15975,khaiphan-tiki,2,0.00013,381866,24.46170,1561077
15976,khaleel916,2,0.00013,381868,24.46183,1561077
15977,khasim,2,0.00013,381870,24.46196,1561077
15978,khastation,2,0.00013,381872,24.46209,1561077
15979,khiemips,2,0.00013,381874,24.46221,1561077
15980,khilman,2,0.00013,381876,24.46234,1561077
15981,khitrenovich,2,0.00013,381878,24.46247,1561077
15982,khoatd92,2,0.00013,381880,24.46260,1561077
15983,ki0,2,0.00013,381882,24.46273,1561077
15984,kiesel,2,0.00013,381884,24.46285,1561077
15985,killthemyth,2,0.00013,381886,24.46298,1561077
15986,KimBioInfoStudio,2,0.00013,381888,24.46311,1561077
15987,kimcam,2,0.00013,381890,24.46324,1561077
15988,kimtaeyoon83,2,0.00013,381892,24.46337,1561077
15989,KingCrah,2,0.00013,381894,24.46350,1561077
15990,kinglezhuang,2,0.00013,381896,24.46362,1561077
15991,kingzus,2,0.00013,381898,24.46375,1561077
15992,kino505,2,0.00013,381900,24.46388,1561077
15993,kip9,2,0.00013,381902,24.46401,1561077
15994,kiran1abc,2,0.00013,381904,24.46414,1561077
15995,kirill-a,2,0.00013,381906,24.46426,1561077
15996,KIRY4,2,0.00013,381908,24.46439,1561077
15997,kisa002,2,0.00013,381910,24.46452,1561077
15998,kishore-marramreddy,2,0.00013,381912,24.46465,1561077
15999,kislinsk,2,0.00013,381914,24.46478,1561077
16000,kitty-catt,2,0.00013,381916,24.46490,1561077
16001,kkkotaro,2,0.00013,381918,24.46503,1561077
16002,kklimek,2,0.00013,381920,24.46516,1561077
16003,kknd22,2,0.00013,381922,24.46529,1561077
16004,klaffke,2,0.00013,381924,24.46542,1561077
16005,klajok,2,0.00013,381926,24.46555,1561077
16006,klarantben,2,0.00013,381928,24.46567,1561077
16007,klebercabral,2,0.00013,381930,24.46580,1561077
16008,klercker,2,0.00013,381932,24.46593,1561077
16009,klow68,2,0.00013,381934,24.46606,1561077
16010,kmalhi,2,0.00013,381936,24.46619,1561077
16011,kmoco2am,2,0.00013,381938,24.46631,1561077
16012,kmoorits,2,0.00013,381940,24.46644,1561077
16013,kmott,2,0.00013,381942,24.46657,1561077
16014,kna,2,0.00013,381944,24.46670,1561077
16015,kneirinck,2,0.00013,381946,24.46683,1561077
16016,knightsamar,2,0.00013,381948,24.46695,1561077
16017,knisht,2,0.00013,381950,24.46708,1561077
16018,Knitschi,2,0.00013,381952,24.46721,1561077
16019,knots160,2,0.00013,381954,24.46734,1561077
16020,KnownSubset,2,0.00013,381956,24.46747,1561077
16021,kobehaha,2,0.00013,381958,24.46760,1561077
16022,kochn,2,0.00013,381960,24.46772,1561077
16023,kocomic,2,0.00013,381962,24.46785,1561077
16024,kocoten1992,2,0.00013,381964,24.46798,1561077
16025,KoenVerheyen,2,0.00013,381966,24.46811,1561077
16026,kolencherry,2,0.00013,381968,24.46824,1561077
16027,kolima,2,0.00013,381970,24.46836,1561077
16028,komeiy,2,0.00013,381972,24.46849,1561077
16029,kongdekede,2,0.00013,381974,24.46862,1561077
16030,konrad-a,2,0.00013,381976,24.46875,1561077
16031,konrad-krakowiak,2,0.00013,381978,24.46888,1561077
16032,kookykoder,2,0.00013,381980,24.46900,1561077
16033,kordianbruck,2,0.00013,381982,24.46913,1561077
16034,KorosuYoo,2,0.00013,381984,24.46926,1561077
16035,Korrd,2,0.00013,381986,24.46939,1561077
16036,KostasOneFile,2,0.00013,381988,24.46952,1561077
16037,kotchuprik,2,0.00013,381990,24.46964,1561077
16038,kounoike,2,0.00013,381992,24.46977,1561077
16039,koverly,2,0.00013,381994,24.46990,1561077
16040,kprasadbio,2,0.00013,381996,24.47003,1561077
16041,kpritam,2,0.00013,381998,24.47016,1561077
16042,kramachandran1980,2,0.00013,382000,24.47029,1561077
16043,krdlab,2,0.00013,382002,24.47041,1561077
16044,kreased,2,0.00013,382004,24.47054,1561077
16045,kreditechtill,2,0.00013,382006,24.47067,1561077
16046,kreinloo,2,0.00013,382008,24.47080,1561077
16047,krejcp19,2,0.00013,382010,24.47093,1561077
16048,kremampesamel,2,0.00013,382012,24.47105,1561077
16049,kriegmaster56,2,0.00013,382014,24.47118,1561077
16050,krishnaprasadkv,2,0.00013,382016,24.47131,1561077
16051,KrishnaveniM1017,2,0.00013,382018,24.47144,1561077
16052,krisnik,2,0.00013,382020,24.47157,1561077
16053,kristenoliphant,2,0.00013,382022,24.47169,1561077
16054,KristianOellegaard,2,0.00013,382024,24.47182,1561077
16055,kristine-sl,2,0.00013,382026,24.47195,1561077
16056,kristofkessler,2,0.00013,382028,24.47208,1561077
16057,kriston,2,0.00013,382030,24.47221,1561077
16058,krm1,2,0.00013,382032,24.47234,1561077
16059,kroatoa,2,0.00013,382034,24.47246,1561077
16060,krswin,2,0.00013,382036,24.47259,1561077
16061,krunaladdweb,2,0.00013,382038,24.47272,1561077
16062,krystian-kulgawczuk,2,0.00013,382040,24.47285,1561077
16063,krzsztf,2,0.00013,382042,24.47298,1561077
16064,KrzysiekAgi,2,0.00013,382044,24.47310,1561077
16065,krzysztof-kwiecinski,2,0.00013,382046,24.47323,1561077
16066,kschlesselmann,2,0.00013,382048,24.47336,1561077
16067,kshaa,2,0.00013,382050,24.47349,1561077
16068,kshatskyy,2,0.00013,382052,24.47362,1561077
16069,kshitijcode,2,0.00013,382054,24.47374,1561077
16070,ksprash,2,0.00013,382056,24.47387,1561077
16071,ksrinimba,2,0.00013,382058,24.47400,1561077
16072,kstrijbos,2,0.00013,382060,24.47413,1561077
16073,ksuzu,2,0.00013,382062,24.47426,1561077
16074,ktong,2,0.00013,382064,24.47439,1561077
16075,kubinski,2,0.00013,382066,24.47451,1561077
16076,kuflink-tech,2,0.00013,382068,24.47464,1561077
16077,Kuhtich,2,0.00013,382070,24.47477,1561077
16078,kulp,2,0.00013,382072,24.47490,1561077
16079,kumar-abhishek-quarks,2,0.00013,382074,24.47503,1561077
16080,kuniaki,2,0.00013,382076,24.47515,1561077
16081,kurganec,2,0.00013,382078,24.47528,1561077
16082,Kusold,2,0.00013,382080,24.47541,1561077
16083,KV995,2,0.00013,382082,24.47554,1561077
16084,kweide,2,0.00013,382084,24.47567,1561077
16085,kwilson33,2,0.00013,382086,24.47579,1561077
16086,kycfeel,2,0.00013,382088,24.47592,1561077
16087,kyhavlov,2,0.00013,382090,24.47605,1561077
16088,KyleOrth,2,0.00013,382092,24.47618,1561077
16089,kylewayman,2,0.00013,382094,24.47631,1561077
16090,kyrylos1,2,0.00013,382096,24.47644,1561077
16091,KyWa,2,0.00013,382098,24.47656,1561077
16092,kzusy,2,0.00013,382100,24.47669,1561077
16093,L011535,2,0.00013,382102,24.47682,1561077
16094,l0stmylife,2,0.00013,382104,24.47695,1561077
16095,l0thar,2,0.00013,382106,24.47708,1561077
16096,L2JE,2,0.00013,382108,24.47720,1561077
16097,Labibme,2,0.00013,382110,24.47733,1561077
16098,lacivert,2,0.00013,382112,24.47746,1561077
16099,ladar,2,0.00013,382114,24.47759,1561077
16100,laeubi,2,0.00013,382116,24.47772,1561077
16101,lafraia,2,0.00013,382118,24.47784,1561077
16102,lailaZayani,2,0.00013,382120,24.47797,1561077
16103,laithshadeed,2,0.00013,382122,24.47810,1561077
16104,lajoie,2,0.00013,382124,24.47823,1561077
16105,lakshmineha577,2,0.00013,382126,24.47836,1561077
16106,LakshmiVaishak,2,0.00013,382128,24.47849,1561077
16107,lalitkuhcl,2,0.00013,382130,24.47861,1561077
16108,lalitmadan,2,0.00013,382132,24.47874,1561077
16109,lamperi,2,0.00013,382134,24.47887,1561077
16110,lance513,2,0.00013,382136,24.47900,1561077
16111,lance-luo,2,0.00013,382138,24.47913,1561077
16112,lanceplarsen,2,0.00013,382140,24.47925,1561077
16113,Lance-Uppercut,2,0.00013,382142,24.47938,1561077
16114,langerhans,2,0.00013,382144,24.47951,1561077
16115,lantier,2,0.00013,382146,24.47964,1561077
16116,larisaad,2,0.00013,382148,24.47977,1561077
16117,larruda,2,0.00013,382150,24.47989,1561077
16118,larry-svds,2,0.00013,382152,24.48002,1561077
16119,laserpony,2,0.00013,382154,24.48015,1561077
16120,lashford,2,0.00013,382156,24.48028,1561077
16121,lasote,2,0.00013,382158,24.48041,1561077
16122,lasselindqvist,2,0.00013,382160,24.48053,1561077
16123,lastthyme,2,0.00013,382162,24.48066,1561077
16124,laucapgemini,2,0.00013,382164,24.48079,1561077
16125,laudrup,2,0.00013,382166,24.48092,1561077
16126,laurencefass,2,0.00013,382168,24.48105,1561077
16127,lavor,2,0.00013,382170,24.48118,1561077
16128,lawe94,2,0.00013,382172,24.48130,1561077
16129,lazywhite,2,0.00013,382174,24.48143,1561077
16130,lbergelson,2,0.00013,382176,24.48156,1561077
16131,lcorsini,2,0.00013,382178,24.48169,1561077
16132,lcrespom,2,0.00013,382180,24.48182,1561077
16133,lcyhjx,2,0.00013,382182,24.48194,1561077
16134,ldavin,2,0.00013,382184,24.48207,1561077
16135,LD-Oteemo,2,0.00013,382186,24.48220,1561077
16136,ldtkms,2,0.00013,382188,24.48233,1561077
16137,leandrocmaia,2,0.00013,382190,24.48246,1561077
16138,leandrodamascena,2,0.00013,382192,24.48258,1561077
16139,Leanivets,2,0.00013,382194,24.48271,1561077
16140,Leboudin,2,0.00013,382196,24.48284,1561077
16141,lecogiteur,2,0.00013,382198,24.48297,1561077
16142,LedAlex,2,0.00013,382200,24.48310,1561077
16143,leefaus,2,0.00013,382202,24.48323,1561077
16144,Leenachaudhari25,2,0.00013,382204,24.48335,1561077
16145,leeor,2,0.00013,382206,24.48348,1561077
16146,legatva1,2,0.00013,382208,24.48361,1561077
16147,lehowma,2,0.00013,382210,24.48374,1561077
16148,Leigh-Ola,2,0.00013,382212,24.48387,1561077
16149,Lenerenberg,2,0.00013,382214,24.48399,1561077
16150,lengrongfu,2,0.00013,382216,24.48412,1561077
16151,lengyf,2,0.00013,382218,24.48425,1561077
16152,lennyk,2,0.00013,382220,24.48438,1561077
16153,leo1515416043,2,0.00013,382222,24.48451,1561077
16154,LeoAref,2,0.00013,382224,24.48463,1561077
16155,leomachado73,2,0.00013,382226,24.48476,1561077
16156,leon-gh,2,0.00013,382228,24.48489,1561077
16157,LeonHagenaarsKeus,2,0.00013,382230,24.48502,1561077
16158,Leonidius20,2,0.00013,382232,24.48515,1561077
16159,leonjalfon1,2,0.00013,382234,24.48528,1561077
16160,leozz37,2,0.00013,382236,24.48540,1561077
16161,les2,2,0.00013,382238,24.48553,1561077
16162,lesau,2,0.00013,382240,24.48566,1561077
16163,lesterp33,2,0.00013,382242,24.48579,1561077
16164,letmeseeit,2,0.00013,382244,24.48592,1561077
16165,lettrung99,2,0.00013,382246,24.48604,1561077
16166,Letty-Liang,2,0.00013,382248,24.48617,1561077
16167,levimatheri,2,0.00013,382250,24.48630,1561077
16168,levimm,2,0.00013,382252,24.48643,1561077
16169,lewgordon,2,0.00013,382254,24.48656,1561077
16170,lewifr,2,0.00013,382256,24.48668,1561077
16171,lfeagan,2,0.00013,382258,24.48681,1561077
16172,lfjewett,2,0.00013,382260,24.48694,1561077
16173,lgallard,2,0.00013,382262,24.48707,1561077
16174,lgawel-cayan,2,0.00013,382264,24.48720,1561077
16175,lgf10,2,0.00013,382266,24.48733,1561077
16176,lgjsherond,2,0.00013,382268,24.48745,1561077
16177,lglijo,2,0.00013,382270,24.48758,1561077
16178,lgomesd,2,0.00013,382272,24.48771,1561077
16179,lhqlhqlq,2,0.00013,382274,24.48784,1561077
16180,liamfoneill,2,0.00013,382276,24.48797,1561077
16181,libin0811,2,0.00013,382278,24.48809,1561077
16182,lifespent,2,0.00013,382280,24.48822,1561077
16183,lightcapda,2,0.00013,382282,24.48835,1561077
16184,lightray55,2,0.00013,382284,24.48848,1561077
16185,lijie512917227,2,0.00013,382286,24.48861,1561077
16186,lijingcsu,2,0.00013,382288,24.48873,1561077
16187,lijinsyam,2,0.00013,382290,24.48886,1561077
16188,lijunruan,2,0.00013,382292,24.48899,1561077
16189,lilbobb,2,0.00013,382294,24.48912,1561077
16190,liline,2,0.00013,382296,24.48925,1561077
16191,liluzee,2,0.00013,382298,24.48937,1561077
16192,limitedAtonement,2,0.00013,382300,24.48950,1561077
16193,limnick,2,0.00013,382302,24.48963,1561077
16194,LIMPIX31,2,0.00013,382304,24.48976,1561077
16195,linehammer,2,0.00013,382306,24.48989,1561077
16196,linux4hach,2,0.00013,382308,24.49002,1561077
16197,linwilai918,2,0.00013,382310,24.49014,1561077
16198,littlekelvin,2,0.00013,382312,24.49027,1561077
16199,liu490663834,2,0.00013,382314,24.49040,1561077
16200,liuguanlin,2,0.00013,382316,24.49053,1561077
16201,liutongxing,2,0.00013,382318,24.49066,1561077
16202,liuya00,2,0.00013,382320,24.49078,1561077
16203,livnebar,2,0.00013,382322,24.49091,1561077
16204,liyajieGit,2,0.00013,382324,24.49104,1561077
16205,lkishalmi,2,0.00013,382326,24.49117,1561077
16206,lkrzyzanek,2,0.00013,382328,24.49130,1561077
16207,lksndr,2,0.00013,382330,24.49142,1561077
16208,lleroy,2,0.00013,382332,24.49155,1561077
16209,llinder,2,0.00013,382334,24.49168,1561077
16210,LLlKuIIeP,2,0.00013,382336,24.49181,1561077
16211,lllmaa,2,0.00013,382338,24.49194,1561077
16212,llorllale,2,0.00013,382340,24.49207,1561077
16213,llowder,2,0.00013,382342,24.49219,1561077
16214,lloydoliver,2,0.00013,382344,24.49232,1561077
16215,llsachinll,2,0.00013,382346,24.49245,1561077
16216,lluccia,2,0.00013,382348,24.49258,1561077
16217,lmbai,2,0.00013,382350,24.49271,1561077
16218,lmife,2,0.00013,382352,24.49283,1561077
16219,Lmpessoa,2,0.00013,382354,24.49296,1561077
16220,LnAlex,2,0.00013,382356,24.49309,1561077
16221,loganek,2,0.00013,382358,24.49322,1561077
16222,logbon72,2,0.00013,382360,24.49335,1561077
16223,lohokiller,2,0.00013,382362,24.49347,1561077
16224,lokeshg4github,2,0.00013,382364,24.49360,1561077
16225,lokkeshjaya,2,0.00013,382366,24.49373,1561077
16226,lokling,2,0.00013,382368,24.49386,1561077
16227,loknathbehera,2,0.00013,382370,24.49399,1561077
16228,loman74,2,0.00013,382372,24.49412,1561077
16229,longfei-zhang,2,0.00013,382374,24.49424,1561077
16230,longquan7,2,0.00013,382376,24.49437,1561077
16231,loopping,2,0.00013,382378,24.49450,1561077
16232,losjr,2,0.00013,382380,24.49463,1561077
16233,loskov,2,0.00013,382382,24.49476,1561077
16234,louisukiri,2,0.00013,382384,24.49488,1561077
16235,LouisVN,2,0.00013,382386,24.49501,1561077
16236,loukiana,2,0.00013,382388,24.49514,1561077
16237,lovefromCode,2,0.00013,382390,24.49527,1561077
16238,loyalty-company,2,0.00013,382392,24.49540,1561077
16239,lpandzic,2,0.00013,382394,24.49552,1561077
16240,lpellegr,2,0.00013,382396,24.49565,1561077
16241,LQBing,2,0.00013,382398,24.49578,1561077
16242,lrokman,2,0.00013,382400,24.49591,1561077
16243,lssilva,2,0.00013,382402,24.49604,1561077
16244,ltx97,2,0.00013,382404,24.49617,1561077
16245,LuanaFn,2,0.00013,382406,24.49629,1561077
16246,luantu,2,0.00013,382408,24.49642,1561077
16247,lub0v-parsable,2,0.00013,382410,24.49655,1561077
16248,luca-dichiro,2,0.00013,382412,24.49668,1561077
16249,lucasborin,2,0.00013,382414,24.49681,1561077
16250,LucasG04,2,0.00013,382416,24.49693,1561077
16251,lucassrg,2,0.00013,382418,24.49706,1561077
16252,Luckl,2,0.00013,382420,24.49719,1561077
16253,ludiofines,2,0.00013,382422,24.49732,1561077
16254,ludov04,2,0.00013,382424,24.49745,1561077
16255,lugeng,2,0.00013,382426,24.49757,1561077
16256,luisaesposito,2,0.00013,382428,24.49770,1561077
16257,luisdeltoro,2,0.00013,382430,24.49783,1561077
16258,luis-echegaray,2,0.00013,382432,24.49796,1561077
16259,luisroel91,2,0.00013,382434,24.49809,1561077
16260,LuisVentuzelos,2,0.00013,382436,24.49822,1561077
16261,lukassup,2,0.00013,382438,24.49834,1561077
16262,LukaSvastVolue,2,0.00013,382440,24.49847,1561077
16263,lukaswelte,2,0.00013,382442,24.49860,1561077
16264,lukaszachy,2,0.00013,382444,24.49873,1561077
16265,lukaszciechanowicz,2,0.00013,382446,24.49886,1561077
16266,lukasz-jarocki-sonarsource,2,0.00013,382448,24.49898,1561077
16267,lukaszkostrzewa,2,0.00013,382450,24.49911,1561077
16268,lukaszkubisiak-intel,2,0.00013,382452,24.49924,1561077
16269,LukeHackett,2,0.00013,382454,24.49937,1561077
16270,lukehb,2,0.00013,382456,24.49950,1561077
16271,lukemonahan,2,0.00013,382458,24.49962,1561077
16272,lukiszlak,2,0.00013,382460,24.49975,1561077
16273,Lunar-man,2,0.00013,382462,24.49988,1561077
16274,lunascat,2,0.00013,382464,24.50001,1561077
16275,Lunchtime,2,0.00013,382466,24.50014,1561077
16276,lunim,2,0.00013,382468,24.50026,1561077
16277,luoqii,2,0.00013,382470,24.50039,1561077
16278,Luschgy,2,0.00013,382472,24.50052,1561077
16279,lvincel,2,0.00013,382474,24.50065,1561077
16280,lvlie,2,0.00013,382476,24.50078,1561077
16281,lweller,2,0.00013,382478,24.50091,1561077
16282,lwindolf,2,0.00013,382480,24.50103,1561077
16283,lxkm,2,0.00013,382482,24.50116,1561077
16284,Lyle-Wong,2,0.00013,382484,24.50129,1561077
16285,lymc123,2,0.00013,382486,24.50142,1561077
16286,lystopad,2,0.00013,382488,24.50155,1561077
16287,m0ises2,2,0.00013,382490,24.50167,1561077
16288,m0rv4i,2,0.00013,382492,24.50180,1561077
16289,m1lth14d3s,2,0.00013,382494,24.50193,1561077
16290,m1madness,2,0.00013,382496,24.50206,1561077
16291,m1no,2,0.00013,382498,24.50219,1561077
16292,m1n-q,2,0.00013,382500,24.50231,1561077
16293,m2acgi,2,0.00013,382502,24.50244,1561077
16294,M4rich,2,0.00013,382504,24.50257,1561077
16295,m9abbas,2,0.00013,382506,24.50270,1561077
16296,Mabeple,2,0.00013,382508,24.50283,1561077
16297,mabuze,2,0.00013,382510,24.50296,1561077
16298,macboy012,2,0.00013,382512,24.50308,1561077
16299,MaciejSzewczyszyn,2,0.00013,382514,24.50321,1561077
16300,maclennann,2,0.00013,382516,24.50334,1561077
16301,MacMan314,2,0.00013,382518,24.50347,1561077
16302,macneib,2,0.00013,382520,24.50360,1561077
16303,MacrofonoEstudio,2,0.00013,382522,24.50372,1561077
16304,macroking,2,0.00013,382524,24.50385,1561077
16305,mad8vad,2,0.00013,382526,24.50398,1561077
16306,maddinenisri,2,0.00013,382528,24.50411,1561077
16307,madhawa-gunasekara,2,0.00013,382530,24.50424,1561077
16308,madriga1,2,0.00013,382532,24.50436,1561077
16309,madukan,2,0.00013,382534,24.50449,1561077
16310,madxkk,2,0.00013,382536,24.50462,1561077
16311,maebedico,2,0.00013,382538,24.50475,1561077
16312,Maetis,2,0.00013,382540,24.50488,1561077
16313,magarnicle,2,0.00013,382542,24.50501,1561077
16314,magic7cookie,2,0.00013,382544,24.50513,1561077
16315,magicdude4eva,2,0.00013,382546,24.50526,1561077
16316,magichome,2,0.00013,382548,24.50539,1561077
16317,magick93,2,0.00013,382550,24.50552,1561077
16318,magno32,2,0.00013,382552,24.50565,1561077
16319,magnocosta,2,0.00013,382554,24.50577,1561077
16320,magnusheino,2,0.00013,382556,24.50590,1561077
16321,magpie0511,2,0.00013,382558,24.50603,1561077
16322,mahanhz,2,0.00013,382560,24.50616,1561077
16323,mahdidul,2,0.00013,382562,24.50629,1561077
16324,mahmedk91,2,0.00013,382564,24.50641,1561077
16325,mahmoud-abdelhafez,2,0.00013,382566,24.50654,1561077
16326,mahusanin,2,0.00013,382568,24.50667,1561077
16327,maiconpeixinho,2,0.00013,382570,24.50680,1561077
16328,maieger,2,0.00013,382572,24.50693,1561077
16329,maifujalam,2,0.00013,382574,24.50706,1561077
16330,maikelvdh,2,0.00013,382576,24.50718,1561077
16331,maimas,2,0.00013,382578,24.50731,1561077
16332,main-kun,2,0.00013,382580,24.50744,1561077
16333,majgaard,2,0.00013,382582,24.50757,1561077
16334,majormoses,2,0.00013,382584,24.50770,1561077
16335,major-sam,2,0.00013,382586,24.50782,1561077
16336,maks-rafalko,2,0.00013,382588,24.50795,1561077
16337,malheleco,2,0.00013,382590,24.50808,1561077
16338,malingxin,2,0.00013,382592,24.50821,1561077
16339,malki-akamai,2,0.00013,382594,24.50834,1561077
16340,MalshaUdani,2,0.00013,382596,24.50846,1561077
16341,malte-behrendt-gr,2,0.00013,382598,24.50859,1561077
16342,mamamic,2,0.00013,382600,24.50872,1561077
16343,mamayadi,2,0.00013,382602,24.50885,1561077
16344,mamohr,2,0.00013,382604,24.50898,1561077
16345,mamunozgonzalez,2,0.00013,382606,24.50910,1561077
16346,man-bohara,2,0.00013,382608,24.50923,1561077
16347,mangitkaur,2,0.00013,382610,24.50936,1561077
16348,manhhungk9g,2,0.00013,382612,24.50949,1561077
16349,Manigunner,2,0.00013,382614,24.50962,1561077
16350,manikantasreeram,2,0.00013,382616,24.50975,1561077
16351,manishbgit,2,0.00013,382618,24.50987,1561077
16352,ManjunathMuniyapla,2,0.00013,382620,24.51000,1561077
16353,mannv,2,0.00013,382622,24.51013,1561077
16354,Manny2014,2,0.00013,382624,24.51026,1561077
16355,manojchandrabss,2,0.00013,382626,24.51039,1561077
16356,mansn,2,0.00013,382628,24.51051,1561077
16357,mantenamanoj007,2,0.00013,382630,24.51064,1561077
16358,Manu10744,2,0.00013,382632,24.51077,1561077
16359,manuelbcd,2,0.00013,382634,24.51090,1561077
16360,Maquina07,2,0.00013,382636,24.51103,1561077
16361,maragunde93,2,0.00013,382638,24.51115,1561077
16362,Mararesliu,2,0.00013,382640,24.51128,1561077
16363,Marc-93,2,0.00013,382642,24.51141,1561077
16364,marcdeop,2,0.00013,382644,24.51154,1561077
16365,MarcelCutts,2,0.00013,382646,24.51167,1561077
16366,marcelhuberfoo,2,0.00013,382648,24.51180,1561077
16367,marcelotmelo,2,0.00013,382650,24.51192,1561077
16368,marcinkuzminski,2,0.00013,382652,24.51205,1561077
16369,marcinlesek,2,0.00013,382654,24.51218,1561077
16370,marcinmantke,2,0.00013,382656,24.51231,1561077
16371,marcinswigon,2,0.00013,382658,24.51244,1561077
16372,marcjansen,2,0.00013,382660,24.51256,1561077
16373,marcore,2,0.00013,382662,24.51269,1561077
16374,marcovmun,2,0.00013,382664,24.51282,1561077
16375,MarcSeebold,2,0.00013,382666,24.51295,1561077
16376,marcus-chan,2,0.00013,382668,24.51308,1561077
16377,MarekFort,2,0.00013,382670,24.51320,1561077
16378,Marerc,2,0.00013,382672,24.51333,1561077
16379,Mariano-geko,2,0.00013,382674,24.51346,1561077
16380,mariomazo,2,0.00013,382676,24.51359,1561077
16381,mariomerco,2,0.00013,382678,24.51372,1561077
16382,mariuszpala,2,0.00013,382680,24.51385,1561077
16383,mark00s,2,0.00013,382682,24.51397,1561077
16384,mark2185,2,0.00013,382684,24.51410,1561077
16385,markahon,2,0.00013,382686,24.51423,1561077
16386,markdoliner,2,0.00013,382688,24.51436,1561077
16387,markediez,2,0.00013,382690,24.51449,1561077
16388,markijbema,2,0.00013,382692,24.51461,1561077
16389,markketchum,2,0.00013,382694,24.51474,1561077
16390,markmssd,2,0.00013,382696,24.51487,1561077
16391,markomanboi,2,0.00013,382698,24.51500,1561077
16392,markus512,2,0.00013,382700,24.51513,1561077
16393,markvr,2,0.00013,382702,24.51525,1561077
16394,markxiaotao,2,0.00013,382704,24.51538,1561077
16395,maronesy,2,0.00013,382706,24.51551,1561077
16396,marouim,2,0.00013,382708,24.51564,1561077
16397,MarsDown,2,0.00013,382710,24.51577,1561077
16398,marslo,2,0.00013,382712,24.51590,1561077
16399,marthydavid,2,0.00013,382714,24.51602,1561077
16400,martinbirks,2,0.00013,382716,24.51615,1561077
16401,martinbrook,2,0.00013,382718,24.51628,1561077
16402,Martinez1991,2,0.00013,382720,24.51641,1561077
16403,MartinKoerner,2,0.00013,382722,24.51654,1561077
16404,martinliu,2,0.00013,382724,24.51666,1561077
16405,martinmarsicano,2,0.00013,382726,24.51679,1561077
16406,martinnemec3,2,0.00013,382728,24.51692,1561077
16407,martinnj,2,0.00013,382730,24.51705,1561077
16408,MartinPayne,2,0.00013,382732,24.51718,1561077
16409,martin-s,2,0.00013,382734,24.51730,1561077
16410,MarTiXcz,2,0.00013,382736,24.51743,1561077
16411,martoc,2,0.00013,382738,24.51756,1561077
16412,Martwu,2,0.00013,382740,24.51769,1561077
16413,maruhgar,2,0.00013,382742,24.51782,1561077
16414,masakura,2,0.00013,382744,24.51794,1561077
16415,Masber,2,0.00013,382746,24.51807,1561077
16416,Mashi,2,0.00013,382748,24.51820,1561077
16417,MasonM,2,0.00013,382750,24.51833,1561077
16418,massimeddu-sonic,2,0.00013,382752,24.51846,1561077
16419,master221,2,0.00013,382754,24.51859,1561077
16420,MasterCrake,2,0.00013,382756,24.51871,1561077
16421,MasterSlowPoke,2,0.00013,382758,24.51884,1561077
16422,MastersoftGroup,2,0.00013,382760,24.51897,1561077
16423,masum13,2,0.00013,382762,24.51910,1561077
16424,mataerial,2,0.00013,382764,24.51923,1561077
16425,matakan,2,0.00013,382766,24.51935,1561077
16426,matalaa,2,0.00013,382768,24.51948,1561077
16427,mateothegreat,2,0.00013,382770,24.51961,1561077
16428,matepeter90,2,0.00013,382772,24.51974,1561077
16429,MateuszJajeGP,2,0.00013,382774,24.51987,1561077
16430,matf,2,0.00013,382776,24.51999,1561077
16431,mathsalmi,2,0.00013,382778,24.52012,1561077
16432,matiangul,2,0.00013,382780,24.52025,1561077
16433,maticue,2,0.00013,382782,24.52038,1561077
16434,mativillagra,2,0.00013,382784,24.52051,1561077
16435,matlion,2,0.00013,382786,24.52064,1561077
16436,Mato220,2,0.00013,382788,24.52076,1561077
16437,matsch01,2,0.00013,382790,24.52089,1561077
16438,matsu-chara,2,0.00013,382792,24.52102,1561077
16439,matt2005,2,0.00013,382794,24.52115,1561077
16440,mattddowney,2,0.00013,382796,24.52128,1561077
16441,mattdeckard,2,0.00013,382798,24.52140,1561077
16442,mattesja,2,0.00013,382800,24.52153,1561077
16443,MatthewChiappa,2,0.00013,382802,24.52166,1561077
16444,MatthewFlatt,2,0.00013,382804,24.52179,1561077
16445,MatthiasBechtold,2,0.00013,382806,24.52192,1561077
16446,matthiasfichtner-mms,2,0.00013,382808,24.52204,1561077
16447,MatthiasRoelandts,2,0.00013,382810,24.52217,1561077
16448,Matthis2909,2,0.00013,382812,24.52230,1561077
16449,mattkirby,2,0.00013,382814,24.52243,1561077
16450,mattkrea,2,0.00013,382816,24.52256,1561077
16451,MattLuceen,2,0.00013,382818,24.52269,1561077
16452,mattmauriello,2,0.00013,382820,24.52281,1561077
16453,mattserrano,2,0.00013,382822,24.52294,1561077
16454,matt-spungegames,2,0.00013,382824,24.52307,1561077
16455,mattumotu,2,0.00013,382826,24.52320,1561077
16456,mattva01,2,0.00013,382828,24.52333,1561077
16457,MatvonSki,2,0.00013,382830,24.52345,1561077
16458,Mauli99,2,0.00013,382832,24.52358,1561077
16459,maurerbot,2,0.00013,382834,24.52371,1561077
16460,Mavelous,2,0.00013,382836,24.52384,1561077
16461,mawinston,2,0.00013,382838,24.52397,1561077
16462,max-10001,2,0.00013,382840,24.52409,1561077
16463,MaxCruz,2,0.00013,382842,24.52422,1561077
16464,maxenceledore,2,0.00013,382844,24.52435,1561077
16465,MaximeAnsquer,2,0.00013,382846,24.52448,1561077
16466,maximkulkin,2,0.00013,382848,24.52461,1561077
16467,MaximSidorovRep,2,0.00013,382850,24.52474,1561077
16468,maximusfloydus,2,0.00013,382852,24.52486,1561077
16469,maxkrukov,2,0.00013,382854,24.52499,1561077
16470,MaxReinerFullStack,2,0.00013,382856,24.52512,1561077
16471,maxr-jidol,2,0.00013,382858,24.52525,1561077
16472,maxrydkin,2,0.00013,382860,24.52538,1561077
16473,maxstack,2,0.00013,382862,24.52550,1561077
16474,mayankagarwal900,2,0.00013,382864,24.52563,1561077
16475,maycmlee,2,0.00013,382866,24.52576,1561077
16476,maytasm,2,0.00013,382868,24.52589,1561077
16477,mayur-kumar,2,0.00013,382870,24.52602,1561077
16478,mazika90,2,0.00013,382872,24.52614,1561077
16479,Mazon,2,0.00013,382874,24.52627,1561077
16480,Mazorius,2,0.00013,382876,24.52640,1561077
16481,mb720,2,0.00013,382878,24.52653,1561077
16482,mbarzare,2,0.00013,382880,24.52666,1561077
16483,mbd-dbc-dk,2,0.00013,382882,24.52679,1561077
16484,mbessa,2,0.00013,382884,24.52691,1561077
16485,mblanloeil,2,0.00013,382886,24.52704,1561077
16486,mbossenbroek,2,0.00013,382888,24.52717,1561077
16487,mb-wali,2,0.00013,382890,24.52730,1561077
16488,mbwhelan,2,0.00013,382892,24.52743,1561077
16489,MCANMCAN,2,0.00013,382894,24.52755,1561077
16490,mcavigelli,2,0.00013,382896,24.52768,1561077
16491,mcbethio,2,0.00013,382898,24.52781,1561077
16492,mchaffotte,2,0.00013,382900,24.52794,1561077
16493,mchave,2,0.00013,382902,24.52807,1561077
16494,mcintyre321,2,0.00013,382904,24.52819,1561077
16495,mckaymatt,2,0.00013,382906,24.52832,1561077
16496,mck-ssmithjr,2,0.00013,382908,24.52845,1561077
16497,Mc-Mido,2,0.00013,382910,24.52858,1561077
16498,mconigliaro,2,0.00013,382912,24.52871,1561077
16499,mcote-57,2,0.00013,382914,24.52883,1561077
16500,mcpersiko,2,0.00013,382916,24.52896,1561077
16501,mcummingscb,2,0.00013,382918,24.52909,1561077
16502,mdcorriveau,2,0.00013,382920,24.52922,1561077
16503,mdecock-rep,2,0.00013,382922,24.52935,1561077
16504,mdehoust,2,0.00013,382924,24.52948,1561077
16505,mdevlin821,2,0.00013,382926,24.52960,1561077
16506,mdforbes500,2,0.00013,382928,24.52973,1561077
16507,mdodsworth,2,0.00013,382930,24.52986,1561077
16508,mdorotich-swi,2,0.00013,382932,24.52999,1561077
16509,mdsnassor,2,0.00013,382934,24.53012,1561077
16510,mduca,2,0.00013,382936,24.53024,1561077
16511,meabed,2,0.00013,382938,24.53037,1561077
16512,Med-All,2,0.00013,382940,24.53050,1561077
16513,medington,2,0.00013,382942,24.53063,1561077
16514,medkbadri,2,0.00013,382944,24.53076,1561077
16515,meekrosoft,2,0.00013,382946,24.53088,1561077
16516,mefynn,2,0.00013,382948,24.53101,1561077
16517,mega-destruction-mega-ball-of-darkness,2,0.00013,382950,24.53114,1561077
16518,MegaMech,2,0.00013,382952,24.53127,1561077
16519,megwill4268,2,0.00013,382954,24.53140,1561077
16520,meharban9797,2,0.00013,382956,24.53153,1561077
16521,MehB,2,0.00013,382958,24.53165,1561077
16522,mehmetcantula,2,0.00013,382960,24.53178,1561077
16523,mehulparmariitr,2,0.00013,382962,24.53191,1561077
16524,meisterveda,2,0.00013,382964,24.53204,1561077
16525,mejuhi,2,0.00013,382966,24.53217,1561077
16526,melezov,2,0.00013,382968,24.53229,1561077
16527,memarques,2,0.00013,382970,24.53242,1561077
16528,MemoAlfa,2,0.00013,382972,24.53255,1561077
16529,Mendor,2,0.00013,382974,24.53268,1561077
16530,mengjieli0726,2,0.00013,382976,24.53281,1561077
16531,MensObscura,2,0.00013,382978,24.53293,1561077
16532,menvol3,2,0.00013,382980,24.53306,1561077
16533,merou,2,0.00013,382982,24.53319,1561077
16534,mestebangutierrez,2,0.00013,382984,24.53332,1561077
16535,MesterJoda,2,0.00013,382986,24.53345,1561077
16536,mestudd,2,0.00013,382988,24.53358,1561077
16537,mesudip,2,0.00013,382990,24.53370,1561077
16538,mesutdag,2,0.00013,382992,24.53383,1561077
16539,metalfork,2,0.00013,382994,24.53396,1561077
16540,Metaun,2,0.00013,382996,24.53409,1561077
16541,metint,2,0.00013,382998,24.53422,1561077
16542,mett,2,0.00013,383000,24.53434,1561077
16543,metters,2,0.00013,383002,24.53447,1561077
16544,metyl,2,0.00013,383004,24.53460,1561077
16545,meuter,2,0.00013,383006,24.53473,1561077
16546,mexezero,2,0.00013,383008,24.53486,1561077
16547,meyerandreas,2,0.00013,383010,24.53498,1561077
16548,meyerson,2,0.00013,383012,24.53511,1561077
16549,Mezner,2,0.00013,383014,24.53524,1561077
16550,mfaiz0,2,0.00013,383016,24.53537,1561077
16551,mflanneryii,2,0.00013,383018,24.53550,1561077
16552,mgancarzdsi,2,0.00013,383020,24.53563,1561077
16553,mgawinec,2,0.00013,383022,24.53575,1561077
16554,mgemm1,2,0.00013,383024,24.53588,1561077
16555,mgomersbach,2,0.00013,383026,24.53601,1561077
16556,MGP87,2,0.00013,383028,24.53614,1561077
16557,mgriffin13,2,0.00013,383030,24.53627,1561077
16558,mgrossenbacher,2,0.00013,383032,24.53639,1561077
16559,mgs96,2,0.00013,383034,24.53652,1561077
16560,mgualco-contractor,2,0.00013,383036,24.53665,1561077
16561,mhdsaadk,2,0.00013,383038,24.53678,1561077
16562,mhenrixon,2,0.00013,383040,24.53691,1561077
16563,m-hruby,2,0.00013,383042,24.53703,1561077
16564,mhworth,2,0.00013,383044,24.53716,1561077
16565,miaowukong,2,0.00013,383046,24.53729,1561077
16566,mice33,2,0.00013,383048,24.53742,1561077
16567,michaelakin,2,0.00013,383050,24.53755,1561077
16568,michaelclinch,2,0.00013,383052,24.53767,1561077
16569,michaeldclifford,2,0.00013,383054,24.53780,1561077
16570,MichaelFrommberger,2,0.00013,383056,24.53793,1561077
16571,michaelknigge,2,0.00013,383058,24.53806,1561077
16572,MichaelKueller,2,0.00013,383060,24.53819,1561077
16573,michaellee,2,0.00013,383062,24.53832,1561077
16574,michaelruigrok,2,0.00013,383064,24.53844,1561077
16575,michaelschr,2,0.00013,383066,24.53857,1561077
16576,MichaelSiggelkowRnS,2,0.00013,383068,24.53870,1561077
16577,michaelsorenson,2,0.00013,383070,24.53883,1561077
16578,michailgames,2,0.00013,383072,24.53896,1561077
16579,michalmagun,2,0.00013,383074,24.53908,1561077
16580,michalmarszalek-flyr,2,0.00013,383076,24.53921,1561077
16581,MichalPloski,2,0.00013,383078,24.53934,1561077
16582,michal-sujkowski,2,0.00013,383080,24.53947,1561077
16583,michalszelagsonos,2,0.00013,383082,24.53960,1561077
16584,michee,2,0.00013,383084,24.53972,1561077
16585,michelgasser,2,0.00013,383086,24.53985,1561077
16586,michel-maier,2,0.00013,383088,24.53998,1561077
16587,michelvocks,2,0.00013,383090,24.54011,1561077
16588,mickaelperrin,2,0.00013,383092,24.54024,1561077
16589,mickfeech,2,0.00013,383094,24.54037,1561077
16590,mickog,2,0.00013,383096,24.54049,1561077
16591,micktion,2,0.00013,383098,24.54062,1561077
16592,mig5,2,0.00013,383100,24.54075,1561077
16593,migermain,2,0.00013,383102,24.54088,1561077
16594,mightywomble,2,0.00013,383104,24.54101,1561077
16595,Miguel-Otero-IBM,2,0.00013,383106,24.54113,1561077
16596,miguelruizdev,2,0.00013,383108,24.54126,1561077
16597,miguelslemos,2,0.00013,383110,24.54139,1561077
16598,mihirat,2,0.00013,383112,24.54152,1561077
16599,mihu,2,0.00013,383114,24.54165,1561077
16600,mikaukora,2,0.00013,383116,24.54177,1561077
16601,mike1451,2,0.00013,383118,24.54190,1561077
16602,MikeBerryFR,2,0.00013,383120,24.54203,1561077
16603,miked-rr,2,0.00013,383122,24.54216,1561077
16604,mikegchambers,2,0.00013,383124,24.54229,1561077
16605,mikeitup,2,0.00013,383126,24.54242,1561077
16606,mikejianzhang,2,0.00013,383128,24.54254,1561077
16607,mikekaram,2,0.00013,383130,24.54267,1561077
16608,mikelax,2,0.00013,383132,24.54280,1561077
16609,mikemoate,2,0.00013,383134,24.54293,1561077
16610,mikepenz,2,0.00013,383136,24.54306,1561077
16611,mikeprice99,2,0.00013,383138,24.54318,1561077
16612,mikerwolski,2,0.00013,383140,24.54331,1561077
16613,mikesigs,2,0.00013,383142,24.54344,1561077
16614,mikhalkaivan,2,0.00013,383144,24.54357,1561077
16615,miki1029,2,0.00013,383146,24.54370,1561077
16616,mikjo,2,0.00013,383148,24.54382,1561077
16617,mikkhola,2,0.00013,383150,24.54395,1561077
16618,mikomraz,2,0.00013,383152,24.54408,1561077
16619,miktap,2,0.00013,383154,24.54421,1561077
16620,mil1200,2,0.00013,383156,24.54434,1561077
16621,MilanJansenOGD,2,0.00013,383158,24.54447,1561077
16622,MilanovBorislav,2,0.00013,383160,24.54459,1561077
16623,mildebrandt,2,0.00013,383162,24.54472,1561077
16624,mildis,2,0.00013,383164,24.54485,1561077
16625,millsyman,2,0.00013,383166,24.54498,1561077
16626,milosbackonja,2,0.00013,383168,24.54511,1561077
16627,mimatn,2,0.00013,383170,24.54523,1561077
16628,mindhog,2,0.00013,383172,24.54536,1561077
16629,mine0507,2,0.00013,383174,24.54549,1561077
16630,minefreeman,2,0.00013,383176,24.54562,1561077
16631,minemeraj,2,0.00013,383178,24.54575,1561077
16632,minesskylineGTR,2,0.00013,383180,24.54587,1561077
16633,mingplan,2,0.00013,383182,24.54600,1561077
16634,minijus,2,0.00013,383184,24.54613,1561077
16635,mioyn,2,0.00013,383186,24.54626,1561077
16636,mirceabostan,2,0.00013,383188,24.54639,1561077
16637,mirceaeu,2,0.00013,383190,24.54652,1561077
16638,mirzmaster,2,0.00013,383192,24.54664,1561077
16639,Misdre,2,0.00013,383194,24.54677,1561077
16640,mister2d,2,0.00013,383196,24.54690,1561077
16641,MisterBlueBear,2,0.00013,383198,24.54703,1561077
16642,mistermoper,2,0.00013,383200,24.54716,1561077
16643,Mistu3,2,0.00013,383202,24.54728,1561077
16644,miszterx,2,0.00013,383204,24.54741,1561077
16645,MitanshuGarg009,2,0.00013,383206,24.54754,1561077
16646,mitchel-breachlock,2,0.00013,383208,24.54767,1561077
16647,mitchellsimoens,2,0.00013,383210,24.54780,1561077
16648,mitchfriedman,2,0.00013,383212,24.54792,1561077
16649,mitch-hamburger,2,0.00013,383214,24.54805,1561077
16650,mitfik,2,0.00013,383216,24.54818,1561077
16651,mitni455,2,0.00013,383218,24.54831,1561077
16652,Mitrofanov,2,0.00013,383220,24.54844,1561077
16653,mitto,2,0.00013,383222,24.54856,1561077
16654,Mixermachine,2,0.00013,383224,24.54869,1561077
16655,mixMugz,2,0.00013,383226,24.54882,1561077
16656,mj6363,2,0.00013,383228,24.54895,1561077
16657,mjaggard,2,0.00013,383230,24.54908,1561077
16658,mjedynak,2,0.00013,383232,24.54921,1561077
16659,mjgkaastrupandersen,2,0.00013,383234,24.54933,1561077
16660,mjoe,2,0.00013,383236,24.54946,1561077
16661,mkaja,2,0.00013,383238,24.54959,1561077
16662,mkgl,2,0.00013,383240,24.54972,1561077
16663,mkjasinski,2,0.00013,383242,24.54985,1561077
16664,mklement0,2,0.00013,383244,24.54997,1561077
16665,mkokshoorn,2,0.00013,383246,24.55010,1561077
16666,Mkonovnitsyn,2,0.00013,383248,24.55023,1561077
16667,mkorsar,2,0.00013,383250,24.55036,1561077
16668,mkryva,2,0.00013,383252,24.55049,1561077
16669,mlafaix,2,0.00013,383254,24.55061,1561077
16670,mlaflamm,2,0.00013,383256,24.55074,1561077
16671,mld-ger,2,0.00013,383258,24.55087,1561077
16672,mlechner,2,0.00013,383260,24.55100,1561077
16673,mlilienberg,2,0.00013,383262,24.55113,1561077
16674,mliner,2,0.00013,383264,24.55126,1561077
16675,mlinhard,2,0.00013,383266,24.55138,1561077
16676,mlintonford,2,0.00013,383268,24.55151,1561077
16677,mlizza,2,0.00013,383270,24.55164,1561077
16678,mllrjb,2,0.00013,383272,24.55177,1561077
16679,mloo-sp,2,0.00013,383274,24.55190,1561077
16680,mluckenbill,2,0.00013,383276,24.55202,1561077
16681,mlueders,2,0.00013,383278,24.55215,1561077
16682,mmaryo,2,0.00013,383280,24.55228,1561077
16683,mmbfreitas,2,0.00013,383282,24.55241,1561077
16684,mmcculloh-dms,2,0.00013,383284,24.55254,1561077
16685,mmedojevicbg,2,0.00013,383286,24.55266,1561077
16686,mminot-yseop,2,0.00013,383288,24.55279,1561077
16687,mmttim,2,0.00013,383290,24.55292,1561077
16688,mnacken,2,0.00013,383292,24.55305,1561077
16689,mNantern,2,0.00013,383294,24.55318,1561077
16690,mnaughto,2,0.00013,383296,24.55331,1561077
16691,mnordsletten,2,0.00013,383298,24.55343,1561077
16692,moatazelmasry2,2,0.00013,383300,24.55356,1561077
16693,mob-sakai,2,0.00013,383302,24.55369,1561077
16694,modax,2,0.00013,383304,24.55382,1561077
16695,modi1492,2,0.00013,383306,24.55395,1561077
16696,mohamedazizhorrigue,2,0.00013,383308,24.55407,1561077
16697,mohammadidinani,2,0.00013,383310,24.55420,1561077
16698,Mohandalissa,2,0.00013,383312,24.55433,1561077
16699,mohankumarbm,2,0.00013,383314,24.55446,1561077
16700,moises-delacruz,2,0.00013,383316,24.55459,1561077
16701,m-okeefe,2,0.00013,383318,24.55471,1561077
16702,mokes2020,2,0.00013,383320,24.55484,1561077
16703,moki-daniel,2,0.00013,383322,24.55497,1561077
16704,momocow,2,0.00013,383324,24.55510,1561077
16705,monil536,2,0.00013,383326,24.55523,1561077
16706,monkz,2,0.00013,383328,24.55536,1561077
16707,montells,2,0.00013,383330,24.55548,1561077
16708,mooncat69,2,0.00013,383332,24.55561,1561077
16709,moonkev,2,0.00013,383334,24.55574,1561077
16710,mooreandrew,2,0.00013,383336,24.55587,1561077
16711,moos3,2,0.00013,383338,24.55600,1561077
16712,mor120,2,0.00013,383340,24.55612,1561077
16713,mora123456,2,0.00013,383342,24.55625,1561077
16714,moraxy,2,0.00013,383344,24.55638,1561077
16715,moriarty,2,0.00013,383346,24.55651,1561077
16716,morriell,2,0.00013,383348,24.55664,1561077
16717,morris821028,2,0.00013,383350,24.55676,1561077
16718,mortenv,2,0.00013,383352,24.55689,1561077
16719,MorZaroor,2,0.00013,383354,24.55702,1561077
16720,moshezvi,2,0.00013,383356,24.55715,1561077
16721,mostcool,2,0.00013,383358,24.55728,1561077
16722,motteww,2,0.00013,383360,24.55740,1561077
16723,Moussi,2,0.00013,383362,24.55753,1561077
16724,mow20,2,0.00013,383364,24.55766,1561077
16725,mpasat,2,0.00013,383366,24.55779,1561077
16726,mpcontracting,2,0.00013,383368,24.55792,1561077
16727,mpechner,2,0.00013,383370,24.55805,1561077
16728,mpeddada1,2,0.00013,383372,24.55817,1561077
16729,mphilipps,2,0.00013,383374,24.55830,1561077
16730,mpomm,2,0.00013,383376,24.55843,1561077
16731,mporrato,2,0.00013,383378,24.55856,1561077
16732,mprencipe,2,0.00013,383380,24.55869,1561077
16733,mpv945,2,0.00013,383382,24.55881,1561077
16734,mqtt-fan,2,0.00013,383384,24.55894,1561077
16735,mraditya,2,0.00013,383386,24.55907,1561077
16736,mrcaron,2,0.00013,383388,24.55920,1561077
16737,MrDiba,2,0.00013,383390,24.55933,1561077
16738,mrdima,2,0.00013,383392,24.55945,1561077
16739,mreinbol,2,0.00013,383394,24.55958,1561077
16740,MrEnzyme,2,0.00013,383396,24.55971,1561077
16741,MrFixit96,2,0.00013,383398,24.55984,1561077
16742,Mridul1703,2,0.00013,383400,24.55997,1561077
16743,MrinalSam,2,0.00013,383402,24.56010,1561077
16744,MrIrick,2,0.00013,383404,24.56022,1561077
16745,mrjatinchauhan,2,0.00013,383406,24.56035,1561077
16746,mrk-han,2,0.00013,383408,24.56048,1561077
16747,mrlowe,2,0.00013,383410,24.56061,1561077
16748,mrmaxsteel,2,0.00013,383412,24.56074,1561077
16749,mrnguyen4386,2,0.00013,383414,24.56086,1561077
16750,mroutis,2,0.00013,383416,24.56099,1561077
16751,mrozanc,2,0.00013,383418,24.56112,1561077
16752,mrslavchev,2,0.00013,383420,24.56125,1561077
16753,mrsonicblue,2,0.00013,383422,24.56138,1561077
16754,mrtaxi,2,0.00013,383424,24.56150,1561077
16755,mruhlin,2,0.00013,383426,24.56163,1561077
16756,mrusan,2,0.00013,383428,24.56176,1561077
16757,MSAskew,2,0.00013,383430,24.56189,1561077
16758,mschirbel,2,0.00013,383432,24.56202,1561077
16759,mseebacher,2,0.00013,383434,24.56215,1561077
16760,mseelye,2,0.00013,383436,24.56227,1561077
16761,mshonichev,2,0.00013,383438,24.56240,1561077
16762,msielicki,2,0.00013,383440,24.56253,1561077
16763,msiemczyk,2,0.00013,383442,24.56266,1561077
16764,MSIH,2,0.00013,383444,24.56279,1561077
16765,mskutin,2,0.00013,383446,24.56291,1561077
16766,mslavkov,2,0.00013,383448,24.56304,1561077
16767,msmitty12,2,0.00013,383450,24.56317,1561077
16768,mssbg,2,0.00013,383452,24.56330,1561077
16769,mst-ableton,2,0.00013,383454,24.56343,1561077
16770,mstanleyjones,2,0.00013,383456,24.56355,1561077
16771,mstfacc,2,0.00013,383458,24.56368,1561077
16772,MStoykov,2,0.00013,383460,24.56381,1561077
16773,mstuart2-dxc,2,0.00013,383462,24.56394,1561077
16774,msysji,2,0.00013,383464,24.56407,1561077
16775,mtauraso,2,0.00013,383466,24.56420,1561077
16776,mtmargala,2,0.00013,383468,24.56432,1561077
16777,mtooth,2,0.00013,383470,24.56445,1561077
16778,mtphil,2,0.00013,383472,24.56458,1561077
16779,mtreeman,2,0.00013,383474,24.56471,1561077
16780,mtschneiders,2,0.00013,383476,24.56484,1561077
16781,mturra,2,0.00013,383478,24.56496,1561077
16782,mudex,2,0.00013,383480,24.56509,1561077
16783,mudiobada,2,0.00013,383482,24.56522,1561077
16784,mudshotseu,2,0.00013,383484,24.56535,1561077
16785,mueller-jens,2,0.00013,383486,24.56548,1561077
16786,muirandy,2,0.00013,383488,24.56560,1561077
16787,Muna24,2,0.00013,383490,24.56573,1561077
16788,mundhras,2,0.00013,383492,24.56586,1561077
16789,munjalt,2,0.00013,383494,24.56599,1561077
16790,munkyboy,2,0.00013,383496,24.56612,1561077
16791,muriloht,2,0.00013,383498,24.56624,1561077
16792,Murodese,2,0.00013,383500,24.56637,1561077
16793,Muschasgrazias,2,0.00013,383502,24.56650,1561077
16794,muskoxleader,2,0.00013,383504,24.56663,1561077
16795,mutabletao,2,0.00013,383506,24.56676,1561077
16796,muziyoshiz,2,0.00013,383508,24.56689,1561077
16797,MV32,2,0.00013,383510,24.56701,1561077
16798,mvanini,2,0.00013,383512,24.56714,1561077
16799,mw32,2,0.00013,383514,24.56727,1561077
16800,mwassil,2,0.00013,383516,24.56740,1561077
16801,mwebbelsevier,2,0.00013,383518,24.56753,1561077
16802,my10c,2,0.00013,383520,24.56765,1561077
16803,mycat83,2,0.00013,383522,24.56778,1561077
16804,myhour,2,0.00013,383524,24.56791,1561077
16805,mykhaliev,2,0.00013,383526,24.56804,1561077
16806,myraghavendra,2,0.00013,383528,24.56817,1561077
16807,myronBob,2,0.00013,383530,24.56829,1561077
16808,myu8tbgl,2,0.00013,383532,24.56842,1561077
16809,mzielinski,2,0.00013,383534,24.56855,1561077
16810,mzmuer,2,0.00013,383536,24.56868,1561077
16811,mzying2013,2,0.00013,383538,24.56881,1561077
16812,n0minal,2,0.00013,383540,24.56894,1561077
16813,n0rthernstar,2,0.00013,383542,24.56906,1561077
16814,N3uRo,2,0.00013,383544,24.56919,1561077
16815,nachotisnes,2,0.00013,383546,24.56932,1561077
16816,nadavbuc,2,0.00013,383548,24.56945,1561077
16817,NaffanDroo,2,0.00013,383550,24.56958,1561077
16818,nafiux,2,0.00013,383552,24.56970,1561077
16819,nagarakesh4,2,0.00013,383554,24.56983,1561077
16820,nagelflorian,2,0.00013,383556,24.56996,1561077
16821,nagonzalez,2,0.00013,383558,24.57009,1561077
16822,nair-sumesh,2,0.00013,383560,24.57022,1561077
16823,naisanzaa,2,0.00013,383562,24.57034,1561077
16824,nakulkhargonkar,2,0.00013,383564,24.57047,1561077
16825,nalle,2,0.00013,383566,24.57060,1561077
16826,namcxn,2,0.00013,383568,24.57073,1561077
16827,namnguyen5497,2,0.00013,383570,24.57086,1561077
16828,namyel,2,0.00013,383572,24.57099,1561077
16829,nanliu,2,0.00013,383574,24.57111,1561077
16830,Nannies,2,0.00013,383576,24.57124,1561077
16831,narasimhanukala,2,0.00013,383578,24.57137,1561077
16832,nashpaz123,2,0.00013,383580,24.57150,1561077
16833,nash-s24,2,0.00013,383582,24.57163,1561077
16834,NasrSyncBac,2,0.00013,383584,24.57175,1561077
16835,natalieb07,2,0.00013,383586,24.57188,1561077
16836,natefaerber,2,0.00013,383588,24.57201,1561077
16837,Nathan219,2,0.00013,383590,24.57214,1561077
16838,nathan-K-,2,0.00013,383592,24.57227,1561077
16839,NathanLindshield,2,0.00013,383594,24.57239,1561077
16840,nathan-murphy,2,0.00013,383596,24.57252,1561077
16841,NathanTCz,2,0.00013,383598,24.57265,1561077
16842,natrajms,2,0.00013,383600,24.57278,1561077
16843,natthapolvanasrivilai,2,0.00013,383602,24.57291,1561077
16844,NatWoodson,2,0.00013,383604,24.57304,1561077
16845,naushniki,2,0.00013,383606,24.57316,1561077
16846,navado,2,0.00013,383608,24.57329,1561077
16847,naveednu,2,0.00013,383610,24.57342,1561077
16848,naveen0725,2,0.00013,383612,24.57355,1561077
16849,NavidMansuri5155,2,0.00013,383614,24.57368,1561077
16850,nbalagopal,2,0.00013,383616,24.57380,1561077
16851,nbartels,2,0.00013,383618,24.57393,1561077
16852,nbelisle11,2,0.00013,383620,24.57406,1561077
16853,nberserk,2,0.00013,383622,24.57419,1561077
16854,ncc0706,2,0.00013,383624,24.57432,1561077
16855,ncouture-invue,2,0.00013,383626,24.57444,1561077
16856,ncoyne,2,0.00013,383628,24.57457,1561077
16857,ndonewar,2,0.00013,383630,24.57470,1561077
16858,ndurchx,2,0.00013,383632,24.57483,1561077
16859,necccc,2,0.00013,383634,24.57496,1561077
16860,necromashka,2,0.00013,383636,24.57509,1561077
16861,NedNedyalkov,2,0.00013,383638,24.57521,1561077
16862,needleshaped,2,0.00013,383640,24.57534,1561077
16863,neethualex,2,0.00013,383642,24.57547,1561077
16864,neetiks,2,0.00013,383644,24.57560,1561077
16865,NehalDamania,2,0.00013,383646,24.57573,1561077
16866,NehaMittal3010,2,0.00013,383648,24.57585,1561077
16867,neilhunt1,2,0.00013,383650,24.57598,1561077
16868,nelsonfigueroa,2,0.00013,383652,24.57611,1561077
16869,nemesis13,2,0.00013,383654,24.57624,1561077
16870,nemoo,2,0.00013,383656,24.57637,1561077
16871,Neo-Burner,2,0.00013,383658,24.57649,1561077
16872,neonman63,2,0.00013,383660,24.57662,1561077
16873,nero2000,2,0.00013,383662,24.57675,1561077
16874,nessumo,2,0.00013,383664,24.57688,1561077
16875,nestie,2,0.00013,383666,24.57701,1561077
16876,netbe,2,0.00013,383668,24.57713,1561077
16877,netjunki,2,0.00013,383670,24.57726,1561077
16878,netmajor,2,0.00013,383672,24.57739,1561077
16879,netmikey,2,0.00013,383674,24.57752,1561077
16880,netsurfer8,2,0.00013,383676,24.57765,1561077
16881,netzwerg,2,0.00013,383678,24.57778,1561077
16882,neugebap,2,0.00013,383680,24.57790,1561077
16883,neuro42,2,0.00013,383682,24.57803,1561077
16884,never00rei,2,0.00013,383684,24.57816,1561077
16885,nfantoni,2,0.00013,383686,24.57829,1561077
16886,NfNitLoop,2,0.00013,383688,24.57842,1561077
16887,ngash,2,0.00013,383690,24.57854,1561077
16888,ngeegoh,2,0.00013,383692,24.57867,1561077
16889,ngocnn97,2,0.00013,383694,24.57880,1561077
16890,ngrande,2,0.00013,383696,24.57893,1561077
16891,ngrkajac,2,0.00013,383698,24.57906,1561077
16892,niaiwomattt,2,0.00013,383700,24.57918,1561077
16893,niallcreech,2,0.00013,383702,24.57931,1561077
16894,Nicabus,2,0.00013,383704,24.57944,1561077
16895,nicbou,2,0.00013,383706,24.57957,1561077
16896,nichiporenko,2,0.00013,383708,24.57970,1561077
16897,nicholaswold,2,0.00013,383710,24.57983,1561077
16898,nicklamer,2,0.00013,383712,24.57995,1561077
16899,nickmshelley,2,0.00013,383714,24.58008,1561077
16900,Nicksxs,2,0.00013,383716,24.58021,1561077
16901,nick-wellinghoff,2,0.00013,383718,24.58034,1561077
16902,nicky132,2,0.00013,383720,24.58047,1561077
16903,nicliuqi,2,0.00013,383722,24.58059,1561077
16904,nico839,2,0.00013,383724,24.58072,1561077
16905,nicodmf,2,0.00013,383726,24.58085,1561077
16906,nicodmt,2,0.00013,383728,24.58098,1561077
16907,nicodn,2,0.00013,383730,24.58111,1561077
16908,nicolasbacot,2,0.00013,383732,24.58123,1561077
16909,nicolasbouthors,2,0.00013,383734,24.58136,1561077
16910,nicoloamato,2,0.00013,383736,24.58149,1561077
16911,NicoPrediger,2,0.00013,383738,24.58162,1561077
16912,nicoprida,2,0.00013,383740,24.58175,1561077
16913,nicosmaris,2,0.00013,383742,24.58188,1561077
16914,Nielius,2,0.00013,383744,24.58200,1561077
16915,night-gold,2,0.00013,383746,24.58213,1561077
16916,nightwolfzor,2,0.00013,383748,24.58226,1561077
16917,nijave,2,0.00013,383750,24.58239,1561077
16918,nikhilbhoski,2,0.00013,383752,24.58252,1561077
16919,nikhildarocha,2,0.00013,383754,24.58264,1561077
16920,nikhilninawe,2,0.00013,383756,24.58277,1561077
16921,nikhilo,2,0.00013,383758,24.58290,1561077
16922,NikitaGl,2,0.00013,383760,24.58303,1561077
16923,NikitashP,2,0.00013,383762,24.58316,1561077
16924,nikita-tkachov,2,0.00013,383764,24.58328,1561077
16925,nikkij,2,0.00013,383766,24.58341,1561077
16926,nikolai,2,0.00013,383768,24.58354,1561077
16927,nikolai-derzhak-distillery,2,0.00013,383770,24.58367,1561077
16928,nikonorovi,2,0.00013,383772,24.58380,1561077
16929,nikoooo20,2,0.00013,383774,24.58393,1561077
16930,nikpivkin,2,0.00013,383776,24.58405,1561077
16931,Nilesh159,2,0.00013,383778,24.58418,1561077
16932,nimbals1,2,0.00013,383780,24.58431,1561077
16933,nimishmedatwal,2,0.00013,383782,24.58444,1561077
16934,Nina0408,2,0.00013,383784,24.58457,1561077
16935,nippip,2,0.00013,383786,24.58469,1561077
16936,nirajgup,2,0.00013,383788,24.58482,1561077
16937,nisabek,2,0.00013,383790,24.58495,1561077
16938,nish-,2,0.00013,383792,24.58508,1561077
16939,nishanthp,2,0.00013,383794,24.58521,1561077
16940,nishaprayaga,2,0.00013,383796,24.58533,1561077
16941,NithinKuruba,2,0.00013,383798,24.58546,1561077
16942,nitinpadalia,2,0.00013,383800,24.58559,1561077
16943,nitschSB,2,0.00013,383802,24.58572,1561077
16944,NiuZhuang,2,0.00013,383804,24.58585,1561077
16945,niwei2008,2,0.00013,383806,24.58597,1561077
16946,nixilla,2,0.00013,383808,24.58610,1561077
16947,njam,2,0.00013,383810,24.58623,1561077
16948,njflowers,2,0.00013,383812,24.58636,1561077
16949,nkazarian-spokeo,2,0.00013,383814,24.58649,1561077
16950,nkhanal0,2,0.00013,383816,24.58662,1561077
16951,nkishore518,2,0.00013,383818,24.58674,1561077
16952,nkolchenko,2,0.00013,383820,24.58687,1561077
16953,nktks,2,0.00013,383822,24.58700,1561077
16954,nkuttler,2,0.00013,383824,24.58713,1561077
16955,nlucero,2,0.00013,383826,24.58726,1561077
16956,nmishkin,2,0.00013,383828,24.58738,1561077
16957,nnaydenov052018,2,0.00013,383830,24.58751,1561077
16958,noahi,2,0.00013,383832,24.58764,1561077
16959,Noam-greenberrg,2,0.00013,383834,24.58777,1561077
16960,NoamRodrik,2,0.00013,383836,24.58790,1561077
16961,nobrassring,2,0.00013,383838,24.58802,1561077
16962,nobusugi246,2,0.00013,383840,24.58815,1561077
16963,noelcapule,2,0.00013,383842,24.58828,1561077
16964,Noham1412,2,0.00013,383844,24.58841,1561077
16965,nohyunho,2,0.00013,383846,24.58854,1561077
16966,noidi,2,0.00013,383848,24.58867,1561077
16967,Nols1000,2,0.00013,383850,24.58879,1561077
16968,Noodle05,2,0.00013,383852,24.58892,1561077
16969,noodles101,2,0.00013,383854,24.58905,1561077
16970,nopainsnogains11,2,0.00013,383856,24.58918,1561077
16971,Noraldeno,2,0.00013,383858,24.58931,1561077
16972,norberteder,2,0.00013,383860,24.58943,1561077
16973,nostachio,2,0.00013,383862,24.58956,1561077
16974,nota-ja,2,0.00013,383864,24.58969,1561077
16975,notdryft,2,0.00013,383866,24.58982,1561077
16976,notmeta,2,0.00013,383868,24.58995,1561077
16977,notoriousUdo,2,0.00013,383870,24.59007,1561077
16978,notrix,2,0.00013,383872,24.59020,1561077
16979,NotTheEconomist,2,0.00013,383874,24.59033,1561077
16980,NouemanKHAL,2,0.00013,383876,24.59046,1561077
16981,noullet,2,0.00013,383878,24.59059,1561077
16982,NovaFox161,2,0.00013,383880,24.59072,1561077
16983,npeters,2,0.00013,383882,24.59084,1561077
16984,npwolf,2,0.00013,383884,24.59097,1561077
16985,Nr18,2,0.00013,383886,24.59110,1561077
16986,nremond,2,0.00013,383888,24.59123,1561077
16987,nricklin,2,0.00013,383890,24.59136,1561077
16988,nrs87,2,0.00013,383892,24.59148,1561077
16989,nsaadi,2,0.00013,383894,24.59161,1561077
16990,nsakovich,2,0.00013,383896,24.59174,1561077
16991,nsharma-git,2,0.00013,383898,24.59187,1561077
16992,nsidhaye,2,0.00013,383900,24.59200,1561077
16993,nsleigh,2,0.00013,383902,24.59212,1561077
16994,nslowell,2,0.00013,383904,24.59225,1561077
16995,nterray,2,0.00013,383906,24.59238,1561077
16996,ntindall,2,0.00013,383908,24.59251,1561077
16997,ntkme,2,0.00013,383910,24.59264,1561077
16998,nttoan26,2,0.00013,383912,24.59277,1561077
16999,ntulele,2,0.00013,383914,24.59289,1561077
17000,Nuc7ear,2,0.00013,383916,24.59302,1561077
17001,NudeNULL,2,0.00013,383918,24.59315,1561077
17002,nuessgens,2,0.00013,383920,24.59328,1561077
17003,nuth,2,0.00013,383922,24.59341,1561077
17004,NVolcz,2,0.00013,383924,24.59353,1561077
17005,nvuillam,2,0.00013,383926,24.59366,1561077
17006,nvx,2,0.00013,383928,24.59379,1561077
17007,nwinkler,2,0.00013,383930,24.59392,1561077
17008,nwsparks,2,0.00013,383932,24.59405,1561077
17009,NyQuilXT,2,0.00013,383934,24.59417,1561077
17010,nzdjb,2,0.00013,383936,24.59430,1561077
17011,o0st,2,0.00013,383938,24.59443,1561077
17012,oalagtash,2,0.00013,383940,24.59456,1561077
17013,oarevalol,2,0.00013,383942,24.59469,1561077
17014,obaranov,2,0.00013,383944,24.59481,1561077
17015,obaroikoh,2,0.00013,383946,24.59494,1561077
17016,obazoud,2,0.00013,383948,24.59507,1561077
17017,OBreitenbach,2,0.00013,383950,24.59520,1561077
17018,obstiger,2,0.00013,383952,24.59533,1561077
17019,obv-mikhail,2,0.00013,383954,24.59546,1561077
17020,ochedru,2,0.00013,383956,24.59558,1561077
17021,ochristi,2,0.00013,383958,24.59571,1561077
17022,octalmage,2,0.00013,383960,24.59584,1561077
17023,octplane,2,0.00013,383962,24.59597,1561077
17024,oDevArc,2,0.00013,383964,24.59610,1561077
17025,Odilhao,2,0.00013,383966,24.59622,1561077
17026,odinxux,2,0.00013,383968,24.59635,1561077
17027,odravison,2,0.00013,383970,24.59648,1561077
17028,OEI-Cgray,2,0.00013,383972,24.59661,1561077
17029,oers,2,0.00013,383974,24.59674,1561077
17030,ofir-elementor,2,0.00013,383976,24.59686,1561077
17031,ofri-7chairs,2,0.00013,383978,24.59699,1561077
17032,ogal555,2,0.00013,383980,24.59712,1561077
17033,ogmueller,2,0.00013,383982,24.59725,1561077
17034,ogreface,2,0.00013,383984,24.59738,1561077
17035,OgreTransporter,2,0.00013,383986,24.59751,1561077
17036,oguzy,2,0.00013,383988,24.59763,1561077
17037,ohanetz,2,0.00013,383990,24.59776,1561077
17038,ohoeltke,2,0.00013,383992,24.59789,1561077
17039,ojbMMXV,2,0.00013,383994,24.59802,1561077
17040,okakarpa,2,0.00013,383996,24.59815,1561077
17041,okovpashko,2,0.00013,383998,24.59827,1561077
17042,oksanamekh,2,0.00013,384000,24.59840,1561077
17043,okynos,2,0.00013,384002,24.59853,1561077
17044,olbrichj,2,0.00013,384004,24.59866,1561077
17045,Olcod,2,0.00013,384006,24.59879,1561077
17046,old5yao,2,0.00013,384008,24.59891,1561077
17047,oldcow54,2,0.00013,384010,24.59904,1561077
17048,oldfabre,2,0.00013,384012,24.59917,1561077
17049,Olegwitcher,2,0.00013,384014,24.59930,1561077
17050,Oleksandr-Vodotiiets,2,0.00013,384016,24.59943,1561077
17051,olekuz,2,0.00013,384018,24.59956,1561077
17052,OLibutzki,2,0.00013,384020,24.59968,1561077
17053,olisun,2,0.00013,384022,24.59981,1561077
17054,oli-unreal,2,0.00013,384024,24.59994,1561077
17055,olivervidovic,2,0.00013,384026,24.60007,1561077
17056,olivielpeau,2,0.00013,384028,24.60020,1561077
17057,olivierGATSNCF,2,0.00013,384030,24.60032,1561077
17058,OlivierJaquemet,2,0.00013,384032,24.60045,1561077
17059,ollytheninja,2,0.00013,384034,24.60058,1561077
17060,oloc,2,0.00013,384036,24.60071,1561077
17061,ololologist,2,0.00013,384038,24.60084,1561077
17062,omaribm,2,0.00013,384040,24.60096,1561077
17063,omazilov,2,0.00013,384042,24.60109,1561077
17064,omermizrahi,2,0.00013,384044,24.60122,1561077
17065,omjsr,2,0.00013,384046,24.60135,1561077
17066,omusavi,2,0.00013,384048,24.60148,1561077
17067,oncletom,2,0.00013,384050,24.60161,1561077
17068,ondrejmichlicekips,2,0.00013,384052,24.60173,1561077
17069,oneautomate,2,0.00013,384054,24.60186,1561077
17070,oneslideicywater,2,0.00013,384056,24.60199,1561077
17071,onewsch,2,0.00013,384058,24.60212,1561077
17072,onion-soup,2,0.00013,384060,24.60225,1561077
17073,Onlinedispatcher,2,0.00013,384062,24.60237,1561077
17074,onyxhat,2,0.00013,384064,24.60250,1561077
17075,oonyeje-bside,2,0.00013,384066,24.60263,1561077
17076,opomuc,2,0.00013,384068,24.60276,1561077
17077,OpsMx,2,0.00013,384070,24.60289,1561077
17078,optimistAk,2,0.00013,384072,24.60301,1561077
17079,or,2,0.00013,384074,24.60314,1561077
17080,OrangeTimes,2,0.00013,384076,24.60327,1561077
17081,Ordiel,2,0.00013,384078,24.60340,1561077
17082,organicit,2,0.00013,384080,24.60353,1561077
17083,oripliner-demo,2,0.00013,384082,24.60366,1561077
17084,ortzabary,2,0.00013,384084,24.60378,1561077
17085,Orxcle-xx,2,0.00013,384086,24.60391,1561077
17086,orzaida87,2,0.00013,384088,24.60404,1561077
17087,osadalakmal,2,0.00013,384090,24.60417,1561077
17088,osaf96,2,0.00013,384092,24.60430,1561077
17089,osakiy,2,0.00013,384094,24.60442,1561077
17090,osdomin,2,0.00013,384096,24.60455,1561077
17091,Osslack,2,0.00013,384098,24.60468,1561077
17092,ostash,2,0.00013,384100,24.60481,1561077
17093,ostov,2,0.00013,384102,24.60494,1561077
17094,otec-petr,2,0.00013,384104,24.60506,1561077
17095,ottochiu,2,0.00013,384106,24.60519,1561077
17096,otuji,2,0.00013,384108,24.60532,1561077
17097,oukooveu,2,0.00013,384110,24.60545,1561077
17098,outconn1,2,0.00013,384112,24.60558,1561077
17099,overstre,2,0.00013,384114,24.60570,1561077
17100,ovsyannikovviva64,2,0.00013,384116,24.60583,1561077
17101,owaranaidobby,2,0.00013,384118,24.60596,1561077
17102,owenfarrell,2,0.00013,384120,24.60609,1561077
17103,owenhaynes,2,0.00013,384122,24.60622,1561077
17104,oxcafedead,2,0.00013,384124,24.60635,1561077
17105,oysols,2,0.00013,384126,24.60647,1561077
17106,ozkuran,2,0.00013,384128,24.60660,1561077
17107,ozonni,2,0.00013,384130,24.60673,1561077
17108,p10trk,2,0.00013,384132,24.60686,1561077
17109,P1119r1m,2,0.00013,384134,24.60699,1561077
17110,p14n,2,0.00013,384136,24.60711,1561077
17111,p2105,2,0.00013,384138,24.60724,1561077
17112,p33t,2,0.00013,384140,24.60737,1561077
17113,P4Cu,2,0.00013,384142,24.60750,1561077
17114,P4uline,2,0.00013,384144,24.60763,1561077
17115,pablocaceresz,2,0.00013,384146,24.60775,1561077
17116,pablodgonzalez,2,0.00013,384148,24.60788,1561077
17117,pablorcum,2,0.00013,384150,24.60801,1561077
17118,PabloThiele,2,0.00013,384152,24.60814,1561077
17119,paderka,2,0.00013,384154,24.60827,1561077
17120,paintingStyle,2,0.00013,384156,24.60840,1561077
17121,palfrey,2,0.00013,384158,24.60852,1561077
17122,palvarado38,2,0.00013,384160,24.60865,1561077
17123,panda7168,2,0.00013,384162,24.60878,1561077
17124,pandidan,2,0.00013,384164,24.60891,1561077
17125,PangQingcheng,2,0.00013,384166,24.60904,1561077
17126,pangratz,2,0.00013,384168,24.60916,1561077
17127,pangyikhei,2,0.00013,384170,24.60929,1561077
17128,pankajagarwal,2,0.00013,384172,24.60942,1561077
17129,panos-partheniadis,2,0.00013,384174,24.60955,1561077
17130,panostzemis,2,0.00013,384176,24.60968,1561077
17131,papazogler,2,0.00013,384178,24.60980,1561077
17132,paperclip,2,0.00013,384180,24.60993,1561077
17133,parentgabriel,2,0.00013,384182,24.61006,1561077
17134,pari-,2,0.00013,384184,24.61019,1561077
17135,parikatladeloitte,2,0.00013,384186,24.61032,1561077
17136,parkercameron,2,0.00013,384188,24.61045,1561077
17137,parrotrueper,2,0.00013,384190,24.61057,1561077
17138,ParthibanSG,2,0.00013,384192,24.61070,1561077
17139,parxier,2,0.00013,384194,24.61083,1561077
17140,pashok2398,2,0.00013,384196,24.61096,1561077
17141,pastryTeam,2,0.00013,384198,24.61109,1561077
17142,pasuder,2,0.00013,384200,24.61121,1561077
17143,PatchRanger,2,0.00013,384202,24.61134,1561077
17144,patil16nit,2,0.00013,384204,24.61147,1561077
17145,patoi,2,0.00013,384206,24.61160,1561077
17146,patrick800711,2,0.00013,384208,24.61173,1561077
17147,PatrickGhezali,2,0.00013,384210,24.61185,1561077
17148,patrickpaul-crew,2,0.00013,384212,24.61198,1561077
17149,patrickpierson,2,0.00013,384214,24.61211,1561077
17150,PatrickRiegler,2,0.00013,384216,24.61224,1561077
17151,patzi,2,0.00013,384218,24.61237,1561077
17152,paukul,2,0.00013,384220,24.61250,1561077
17153,paula810,2,0.00013,384222,24.61262,1561077
17154,paul-g1,2,0.00013,384224,24.61275,1561077
17155,PaulienVa,2,0.00013,384226,24.61288,1561077
17156,paulkwa,2,0.00013,384228,24.61301,1561077
17157,paullewisn,2,0.00013,384230,24.61314,1561077
17158,Paullo612,2,0.00013,384232,24.61326,1561077
17159,paulmccrady-dan,2,0.00013,384234,24.61339,1561077
17160,PauloFerreira25,2,0.00013,384236,24.61352,1561077
17161,paulpv,2,0.00013,384238,24.61365,1561077
17162,paulsteele,2,0.00013,384240,24.61378,1561077
17163,paul-symphony,2,0.00013,384242,24.61390,1561077
17164,pavel-machyniak,2,0.00013,384244,24.61403,1561077
17165,pavelpp,2,0.00013,384246,24.61416,1561077
17166,pavsaund,2,0.00013,384248,24.61429,1561077
17167,pawan-1999,2,0.00013,384250,24.61442,1561077
17168,pawan22sfdl,2,0.00013,384252,24.61454,1561077
17169,PawanPandey1911,2,0.00013,384254,24.61467,1561077
17170,Pawel-Cieslak,2,0.00013,384256,24.61480,1561077
17171,pax2k,2,0.00013,384258,24.61493,1561077
17172,PazerOP,2,0.00013,384260,24.61506,1561077
17173,pazone,2,0.00013,384262,24.61519,1561077
17174,pazt,2,0.00013,384264,24.61531,1561077
17175,pbe-axelor,2,0.00013,384266,24.61544,1561077
17176,pbelskiy,2,0.00013,384268,24.61557,1561077
17177,pbielicki,2,0.00013,384270,24.61570,1561077
17178,pbudzon,2,0.00013,384272,24.61583,1561077
17179,pcarles,2,0.00013,384274,24.61595,1561077
17180,pcostesi,2,0.00013,384276,24.61608,1561077
17181,pcoulso1,2,0.00013,384278,24.61621,1561077
17182,pctcls,2,0.00013,384280,24.61634,1561077
17183,pdesantis,2,0.00013,384282,24.61647,1561077
17184,pdmcgurk,2,0.00013,384284,24.61659,1561077
17185,pdorval,2,0.00013,384286,24.61672,1561077
17186,pduchnovsky,2,0.00013,384288,24.61685,1561077
17187,peevees,2,0.00013,384290,24.61698,1561077
17188,pegasus17,2,0.00013,384292,24.61711,1561077
17189,pegrau,2,0.00013,384294,24.61724,1561077
17190,pekkaan,2,0.00013,384296,24.61736,1561077
17191,pemcconnell,2,0.00013,384298,24.61749,1561077
17192,peneksglazami,2,0.00013,384300,24.61762,1561077
17193,pengliaoye,2,0.00013,384302,24.61775,1561077
17194,pensionarchitects-ben,2,0.00013,384304,24.61788,1561077
17195,Penson122,2,0.00013,384306,24.61800,1561077
17196,peppe1977,2,0.00013,384308,24.61813,1561077
17197,Perdjesk,2,0.00013,384310,24.61826,1561077
17198,pere3,2,0.00013,384312,24.61839,1561077
17199,PereBal,2,0.00013,384314,24.61852,1561077
17200,PerilousApricot,2,0.00013,384316,24.61864,1561077
17201,perimori,2,0.00013,384318,24.61877,1561077
17202,perostman,2,0.00013,384320,24.61890,1561077
17203,persus,2,0.00013,384322,24.61903,1561077
17204,pertrai1,2,0.00013,384324,24.61916,1561077
17205,perxadmin,2,0.00013,384326,24.61929,1561077
17206,perzizzle,2,0.00013,384328,24.61941,1561077
17207,Pe-te,2,0.00013,384330,24.61954,1561077
17208,pete312,2,0.00013,384332,24.61967,1561077
17209,Petelin,2,0.00013,384334,24.61980,1561077
17210,peterg79,2,0.00013,384336,24.61993,1561077
17211,peter-janssen,2,0.00013,384338,24.62005,1561077
17212,peterjenkins1,2,0.00013,384340,24.62018,1561077
17213,peterklijn,2,0.00013,384342,24.62031,1561077
17214,PeterLappo,2,0.00013,384344,24.62044,1561077
17215,PeterNgTr,2,0.00013,384346,24.62057,1561077
17216,peters95,2,0.00013,384348,24.62069,1561077
17217,petr-motejlek,2,0.00013,384350,24.62082,1561077
17218,pfandie,2,0.00013,384352,24.62095,1561077
17219,pfhjgd0,2,0.00013,384354,24.62108,1561077
17220,pgassmann,2,0.00013,384356,24.62121,1561077
17221,pgdad,2,0.00013,384358,24.62134,1561077
17222,pgokul,2,0.00013,384360,24.62146,1561077
17223,phaldan,2,0.00013,384362,24.62159,1561077
17224,phallamen,2,0.00013,384364,24.62172,1561077
17225,pHallstedt,2,0.00013,384366,24.62185,1561077
17226,Phanatic,2,0.00013,384368,24.62198,1561077
17227,phene,2,0.00013,384370,24.62210,1561077
17228,phiche,2,0.00013,384372,24.62223,1561077
17229,philapplephil,2,0.00013,384374,24.62236,1561077
17230,philchiu-envision,2,0.00013,384376,24.62249,1561077
17231,philhug,2,0.00013,384378,24.62262,1561077
17232,philipjscott,2,0.00013,384380,24.62274,1561077
17233,phillandrade,2,0.00013,384382,24.62287,1561077
17234,phillipjohnson,2,0.00013,384384,24.62300,1561077
17235,phillycheeze,2,0.00013,384386,24.62313,1561077
17236,phnahes,2,0.00013,384388,24.62326,1561077
17237,phoenikz,2,0.00013,384390,24.62339,1561077
17238,phosei,2,0.00013,384392,24.62351,1561077
17239,photoni-137,2,0.00013,384394,24.62364,1561077
17240,php50350,2,0.00013,384396,24.62377,1561077
17241,PhRX,2,0.00013,384398,24.62390,1561077
17242,phspies,2,0.00013,384400,24.62403,1561077
17243,phu-mai,2,0.00013,384402,24.62415,1561077
17244,phuonghau98,2,0.00013,384404,24.62428,1561077
17245,piclez,2,0.00013,384406,24.62441,1561077
17246,PierreKiwi,2,0.00013,384408,24.62454,1561077
17247,PierreReliquet,2,0.00013,384410,24.62467,1561077
17248,PiersRBME,2,0.00013,384412,24.62479,1561077
17249,pieter-vanisacker,2,0.00013,384414,24.62492,1561077
17250,pietrangelo,2,0.00013,384416,24.62505,1561077
17251,piglowskilukasz,2,0.00013,384418,24.62518,1561077
17252,PikaChokeMe,2,0.00013,384420,24.62531,1561077
17253,pilisig,2,0.00013,384422,24.62543,1561077
17254,pilou-,2,0.00013,384424,24.62556,1561077
17255,Pinio31,2,0.00013,384426,24.62569,1561077
17256,pintomic,2,0.00013,384428,24.62582,1561077
17257,PinZhang,2,0.00013,384430,24.62595,1561077
17258,piotrdytkowski,2,0.00013,384432,24.62608,1561077
17259,piotrekfilip,2,0.00013,384434,24.62620,1561077
17260,piotrlg,2,0.00013,384436,24.62633,1561077
17261,pirluq,2,0.00013,384438,24.62646,1561077
17262,PirminTapken,2,0.00013,384440,24.62659,1561077
17263,PirxDanford,2,0.00013,384442,24.62672,1561077
17264,pitaylor,2,0.00013,384444,24.62684,1561077
17265,piwai,2,0.00013,384446,24.62697,1561077
17266,PixnBits,2,0.00013,384448,24.62710,1561077
17267,piyush5566,2,0.00013,384450,24.62723,1561077
17268,piyushjain18,2,0.00013,384452,24.62736,1561077
17269,pjagielski,2,0.00013,384454,24.62748,1561077
17270,pjangam,2,0.00013,384456,24.62761,1561077
17271,pjflux2001,2,0.00013,384458,24.62774,1561077
17272,pjona,2,0.00013,384460,24.62787,1561077
17273,pjonnlagadda,2,0.00013,384462,24.62800,1561077
17274,pk1057,2,0.00013,384464,24.62813,1561077
17275,pk185235,2,0.00013,384466,24.62825,1561077
17276,pke,2,0.00013,384468,24.62838,1561077
17277,pkeshab,2,0.00013,384470,24.62851,1561077
17278,pkesseli,2,0.00013,384472,24.62864,1561077
17279,pkgo,2,0.00013,384474,24.62877,1561077
17280,pkittenis,2,0.00013,384476,24.62889,1561077
17281,pkleanthous,2,0.00013,384478,24.62902,1561077
17282,pklumar,2,0.00013,384480,24.62915,1561077
17283,pksdemo,2,0.00013,384482,24.62928,1561077
17284,placaze,2,0.00013,384484,24.62941,1561077
17285,PLeS207,2,0.00013,384486,24.62953,1561077
17286,plu,2,0.00013,384488,24.62966,1561077
17287,plumbuma,2,0.00013,384490,24.62979,1561077
17288,pnathan,2,0.00013,384492,24.62992,1561077
17289,Poeschl,2,0.00013,384494,24.63005,1561077
17290,poison,2,0.00013,384496,24.63018,1561077
17291,pojacque,2,0.00013,384498,24.63030,1561077
17292,pokerface3,2,0.00013,384500,24.63043,1561077
17293,PoliM,2,0.00013,384502,24.63056,1561077
17294,pollard93,2,0.00013,384504,24.63069,1561077
17295,PollosD,2,0.00013,384506,24.63082,1561077
17296,ponceps,2,0.00013,384508,24.63094,1561077
17297,poohpeer,2,0.00013,384510,24.63107,1561077
17298,PopescuMarius,2,0.00013,384512,24.63120,1561077
17299,Porkepix,2,0.00013,384514,24.63133,1561077
17300,porwat,2,0.00013,384516,24.63146,1561077
17301,posilva,2,0.00013,384518,24.63158,1561077
17302,pospome,2,0.00013,384520,24.63171,1561077
17303,potter-cmd,2,0.00013,384522,24.63184,1561077
17304,ppadial,2,0.00013,384524,24.63197,1561077
17305,ppinto2016,2,0.00013,384526,24.63210,1561077
17306,ppodbielski,2,0.00013,384528,24.63223,1561077
17307,pporada-gl,2,0.00013,384530,24.63235,1561077
17308,prabhakar1990,2,0.00013,384532,24.63248,1561077
17309,Prabhu088,2,0.00013,384534,24.63261,1561077
17310,pradheba-rangarajan,2,0.00013,384536,24.63274,1561077
17311,pradyhk,2,0.00013,384538,24.63287,1561077
17312,pragnesh-is,2,0.00013,384540,24.63299,1561077
17313,PrajwalBorkar,2,0.00013,384542,24.63312,1561077
17314,prakashemeascm,2,0.00013,384544,24.63325,1561077
17315,prakashriti,2,0.00013,384546,24.63338,1561077
17316,prakharjoshi,2,0.00013,384548,24.63351,1561077
17317,prantaa,2,0.00013,384550,24.63363,1561077
17318,prasad0405,2,0.00013,384552,24.63376,1561077
17319,prasadlvi,2,0.00013,384554,24.63389,1561077
17320,PrasadTelasula,2,0.00013,384556,24.63402,1561077
17321,prasannadesai,2,0.00013,384558,24.63415,1561077
17322,prashanth-sams,2,0.00013,384560,24.63427,1561077
17323,prashant-juluri,2,0.00013,384562,24.63440,1561077
17324,Prashasti07,2,0.00013,384564,24.63453,1561077
17325,prashu-upadhyay,2,0.00013,384566,24.63466,1561077
17326,prateekkhera,2,0.00013,384568,24.63479,1561077
17327,prathameshd9,2,0.00013,384570,24.63492,1561077
17328,PrathmeshAdsod,2,0.00013,384572,24.63504,1561077
17329,PravallikaDindukurthi,2,0.00013,384574,24.63517,1561077
17330,PraveenJaikumar,2,0.00013,384576,24.63530,1561077
17331,praveenprasadn,2,0.00013,384578,24.63543,1561077
17332,pravinzee,2,0.00013,384580,24.63556,1561077
17333,prbinu,2,0.00013,384582,24.63568,1561077
17334,prbldeb,2,0.00013,384584,24.63581,1561077
17335,preddy-hub,2,0.00013,384586,24.63594,1561077
17336,predmijat,2,0.00013,384588,24.63607,1561077
17337,President,2,0.00013,384590,24.63620,1561077
17338,primeos-work,2,0.00013,384592,24.63632,1561077
17339,printinfo,2,0.00013,384594,24.63645,1561077
17340,priteshpatil,2,0.00013,384596,24.63658,1561077
17341,Prithivi-Rajan,2,0.00013,384598,24.63671,1561077
17342,priyankavunnam224,2,0.00013,384600,24.63684,1561077
17343,priyanshu0405,2,0.00013,384602,24.63697,1561077
17344,proj21,2,0.00013,384604,24.63709,1561077
17345,project25o1,2,0.00013,384606,24.63722,1561077
17346,prom3theu5,2,0.00013,384608,24.63735,1561077
17347,promix17,2,0.00013,384610,24.63748,1561077
17348,proskehy,2,0.00013,384612,24.63761,1561077
17349,pruiz,2,0.00013,384614,24.63773,1561077
17350,przecze,2,0.00013,384616,24.63786,1561077
17351,ps895r,2,0.00013,384618,24.63799,1561077
17352,pskopek,2,0.00013,384620,24.63812,1561077
17353,PSRCode,2,0.00013,384622,24.63825,1561077
17354,psujeethkumar,2,0.00013,384624,24.63837,1561077
17355,PSWielath,2,0.00013,384626,24.63850,1561077
17356,psyked,2,0.00013,384628,24.63863,1561077
17357,psykocat,2,0.00013,384630,24.63876,1561077
17358,psyonix-luis,2,0.00013,384632,24.63889,1561077
17359,psytale,2,0.00013,384634,24.63902,1561077
17360,PT400C,2,0.00013,384636,24.63914,1561077
17361,ptroff,2,0.00013,384638,24.63927,1561077
17362,puetzk,2,0.00013,384640,24.63940,1561077
17363,purefan,2,0.00013,384642,24.63953,1561077
17364,pure-zero,2,0.00013,384644,24.63966,1561077
17365,puri15dayanand,2,0.00013,384646,24.63978,1561077
17366,pvvarfalameev,2,0.00013,384648,24.63991,1561077
17367,pwaweru-mdsol,2,0.00013,384650,24.64004,1561077
17368,pweaver,2,0.00013,384652,24.64017,1561077
17369,PXzzzpython,2,0.00013,384654,24.64030,1561077
17370,pyatizbyantsevia,2,0.00013,384656,24.64042,1561077
17371,pyToshka,2,0.00013,384658,24.64055,1561077
17372,pznamensky,2,0.00013,384660,24.64068,1561077
17373,qburst-jineesh,2,0.00013,384662,24.64081,1561077
17374,q-bytes,2,0.00013,384664,24.64094,1561077
17375,qerub,2,0.00013,384666,24.64107,1561077
17376,qhh0205,2,0.00013,384668,24.64119,1561077
17377,qiangdavidliu,2,0.00013,384670,24.64132,1561077
17378,qianmuxi,2,0.00013,384672,24.64145,1561077
17379,QincaiLiu,2,0.00013,384674,24.64158,1561077
17380,Qinusty,2,0.00013,384676,24.64171,1561077
17381,qiwang-ixl,2,0.00013,384678,24.64183,1561077
17382,qiyi,2,0.00013,384680,24.64196,1561077
17383,qjqqwerty,2,0.00013,384682,24.64209,1561077
17384,qq253498229,2,0.00013,384684,24.64222,1561077
17385,q-sotoole,2,0.00013,384686,24.64235,1561077
17386,qtm4jstag,2,0.00013,384688,24.64247,1561077
17387,quaiky01,2,0.00013,384690,24.64260,1561077
17388,quangthe,2,0.00013,384692,24.64273,1561077
17389,queil,2,0.00013,384694,24.64286,1561077
17390,quite,2,0.00013,384696,24.64299,1561077
17391,quosa,2,0.00013,384698,24.64311,1561077
17392,rachitshrivastava-opstree,2,0.00013,384700,24.64324,1561077
17393,rachmatowicz,2,0.00013,384702,24.64337,1561077
17394,RadoslavCap,2,0.00013,384704,24.64350,1561077
17395,radoslawc,2,0.00013,384706,24.64363,1561077
17396,RafaelaMachado,2,0.00013,384708,24.64376,1561077
17397,rafaeldalsenter,2,0.00013,384710,24.64388,1561077
17398,rafaeleyng,2,0.00013,384712,24.64401,1561077
17399,RafaelloLoliop,2,0.00013,384714,24.64414,1561077
17400,rafalborczuch,2,0.00013,384716,24.64427,1561077
17401,rafaljanicki,2,0.00013,384718,24.64440,1561077
17402,rafelbev,2,0.00013,384720,24.64452,1561077
17403,raghanag,2,0.00013,384722,24.64465,1561077
17404,RaghavendraP,2,0.00013,384724,24.64478,1561077
17405,raghavendrapj,2,0.00013,384726,24.64491,1561077
17406,raghu999,2,0.00013,384728,24.64504,1561077
17407,Ragr2018,2,0.00013,384730,24.64516,1561077
17408,RahulAnita,2,0.00013,384732,24.64529,1561077
17409,RAHULDAS6009,2,0.00013,384734,24.64542,1561077
17410,rahullodha85,2,0.00013,384736,24.64555,1561077
17411,rahuln-bs,2,0.00013,384738,24.64568,1561077
17412,raintean,2,0.00013,384740,24.64581,1561077
17413,rajanrai2198,2,0.00013,384742,24.64593,1561077
17414,rajaps369,2,0.00013,384744,24.64606,1561077
17415,rajatjindal,2,0.00013,384746,24.64619,1561077
17416,rajeeshdf,2,0.00013,384748,24.64632,1561077
17417,RajeshAjjarapu,2,0.00013,384750,24.64645,1561077
17418,Rajh,2,0.00013,384752,24.64657,1561077
17419,rajovictor,2,0.00013,384754,24.64670,1561077
17420,rakesh-roshan,2,0.00013,384756,24.64683,1561077
17421,rakgenius,2,0.00013,384758,24.64696,1561077
17422,ralfclaassens,2,0.00013,384760,24.64709,1561077
17423,ralfe-software,2,0.00013,384762,24.64721,1561077
17424,rall,2,0.00013,384764,24.64734,1561077
17425,ralphct,2,0.00013,384766,24.64747,1561077
17426,ralsu091,2,0.00013,384768,24.64760,1561077
17427,RAM237,2,0.00013,384770,24.64773,1561077
17428,ram-bo-arm,2,0.00013,384772,24.64786,1561077
17429,rameshd99,2,0.00013,384774,24.64798,1561077
17430,rameshnatesan,2,0.00013,384776,24.64811,1561077
17431,RameshThangamuthu,2,0.00013,384778,24.64824,1561077
17432,ranford,2,0.00013,384780,24.64837,1561077
17433,ranjeeth-ap,2,0.00013,384782,24.64850,1561077
17434,ranjithkumar-glean,2,0.00013,384784,24.64862,1561077
17435,rapaliwal,2,0.00013,384786,24.64875,1561077
17436,raphael1021,2,0.00013,384788,24.64888,1561077
17437,raphaeleidus,2,0.00013,384790,24.64901,1561077
17438,RaphaelPinheiroS,2,0.00013,384792,24.64914,1561077
17439,raphaelsamyknewin,2,0.00013,384794,24.64926,1561077
17440,raphperrin,2,0.00013,384796,24.64939,1561077
17441,raptorsin6,2,0.00013,384798,24.64952,1561077
17442,rarruda,2,0.00013,384800,24.64965,1561077
17443,rathboma,2,0.00013,384802,24.64978,1561077
17444,ratherDashing,2,0.00013,384804,24.64991,1561077
17445,ratishkr,2,0.00013,384806,24.65003,1561077
17446,ratoaq2,2,0.00013,384808,24.65016,1561077
17447,ratroncoso,2,0.00013,384810,24.65029,1561077
17448,RaulKite,2,0.00013,384812,24.65042,1561077
17449,raunakpandya,2,0.00013,384814,24.65055,1561077
17450,ravee-rachakonda-jdas,2,0.00013,384816,24.65067,1561077
17451,ravi-dubey,2,0.00013,384818,24.65080,1561077
17452,ravikrddy,2,0.00013,384820,24.65093,1561077
17453,ravindrabhandarkar007,2,0.00013,384822,24.65106,1561077
17454,raviraipuria,2,0.00013,384824,24.65119,1561077
17455,RavisMsk,2,0.00013,384826,24.65131,1561077
17456,ravivedula,2,0.00013,384828,24.65144,1561077
17457,rayanebel,2,0.00013,384830,24.65157,1561077
17458,rayitopy,2,0.00013,384832,24.65170,1561077
17459,raymondsarmiento-ubidy,2,0.00013,384834,24.65183,1561077
17460,RayOei,2,0.00013,384836,24.65196,1561077
17461,rayom81,2,0.00013,384838,24.65208,1561077
17462,Razawalla,2,0.00013,384840,24.65221,1561077
17463,razem-io,2,0.00013,384842,24.65234,1561077
17464,Razikus,2,0.00013,384844,24.65247,1561077
17465,RazvanGeorgescu,2,0.00013,384846,24.65260,1561077
17466,rbaradari,2,0.00013,384848,24.65272,1561077
17467,rbu,2,0.00013,384850,24.65285,1561077
17468,rbuck-som,2,0.00013,384852,24.65298,1561077
17469,rcarson,2,0.00013,384854,24.65311,1561077
17470,rc-ck,2,0.00013,384856,24.65324,1561077
17471,rcclemente,2,0.00013,384858,24.65336,1561077
17472,rcerven,2,0.00013,384860,24.65349,1561077
17473,rcooo,2,0.00013,384862,24.65362,1561077
17474,rcsilva83,2,0.00013,384864,24.65375,1561077
17475,rdemachkovych,2,0.00013,384866,24.65388,1561077
17476,rdickey-r7,2,0.00013,384868,24.65400,1561077
17477,rdougla3,2,0.00013,384870,24.65413,1561077
17478,rdsol,2,0.00013,384872,24.65426,1561077
17479,realdadfish,2,0.00013,384874,24.65439,1561077
17480,realies,2,0.00013,384876,24.65452,1561077
17481,realrill,2,0.00013,384878,24.65465,1561077
17482,realrolfje,2,0.00013,384880,24.65477,1561077
17483,realsby,2,0.00013,384882,24.65490,1561077
17484,reb197,2,0.00013,384884,24.65503,1561077
17485,rebelok,2,0.00013,384886,24.65516,1561077
17486,recotone,2,0.00013,384888,24.65529,1561077
17487,rectalogic,2,0.00013,384890,24.65541,1561077
17488,red1,2,0.00013,384892,24.65554,1561077
17489,RedBullInsomnia,2,0.00013,384894,24.65567,1561077
17490,Red-Folder,2,0.00013,384896,24.65580,1561077
17491,redliu312,2,0.00013,384898,24.65593,1561077
17492,redsoft7,2,0.00013,384900,24.65605,1561077
17493,redsolo,2,0.00013,384902,24.65618,1561077
17494,redwyre,2,0.00013,384904,24.65631,1561077
17495,ReeSilva,2,0.00013,384906,24.65644,1561077
17496,refactorsaurusrex,2,0.00013,384908,24.65657,1561077
17497,refextu,2,0.00013,384910,24.65670,1561077
17498,regentov,2,0.00013,384912,24.65682,1561077
17499,regetskcob,2,0.00013,384914,24.65695,1561077
17500,reggiev,2,0.00013,384916,24.65708,1561077
17501,rehseboy,2,0.00013,384918,24.65721,1561077
17502,reidblomquist,2,0.00013,384920,24.65734,1561077
17503,reijasal,2,0.00013,384922,24.65746,1561077
17504,reikjarloekl,2,0.00013,384924,24.65759,1561077
17505,reikoshea,2,0.00013,384926,24.65772,1561077
17506,rekahsoft,2,0.00013,384928,24.65785,1561077
17507,relentless-pursuit,2,0.00013,384930,24.65798,1561077
17508,relief-melone,2,0.00013,384932,24.65810,1561077
17509,RemcoTukker,2,0.00013,384934,24.65823,1561077
17510,remi-monnot,2,0.00013,384936,24.65836,1561077
17511,remingtron,2,0.00013,384938,24.65849,1561077
17512,remitaffin,2,0.00013,384940,24.65862,1561077
17513,renanqts,2,0.00013,384942,24.65875,1561077
17514,renat1sakenov,2,0.00013,384944,24.65887,1561077
17515,RenatIsin,2,0.00013,384946,24.65900,1561077
17516,rene-leanix,2,0.00013,384948,24.65913,1561077
17517,renfeng,2,0.00013,384950,24.65926,1561077
17518,Reonaydo,2,0.00013,384952,24.65939,1561077
17519,restfulhead,2,0.00013,384954,24.65951,1561077
17520,RestlessHeart,2,0.00013,384956,24.65964,1561077
17521,rettenbs,2,0.00013,384958,24.65977,1561077
17522,reubenavery,2,0.00013,384960,24.65990,1561077
17523,revansiddappapanchal,2,0.00013,384962,24.66003,1561077
17524,revathi-murali,2,0.00013,384964,24.66015,1561077
17525,reynn,2,0.00013,384966,24.66028,1561077
17526,rfagen,2,0.00013,384968,24.66041,1561077
17527,rg13567,2,0.00013,384970,24.66054,1561077
17528,rga-madhu,2,0.00013,384972,24.66067,1561077
17529,rgauss,2,0.00013,384974,24.66080,1561077
17530,rglow,2,0.00013,384976,24.66092,1561077
17531,rgopalan1,2,0.00013,384978,24.66105,1561077
17532,rguenthe,2,0.00013,384980,24.66118,1561077
17533,rhduwe,2,0.00013,384982,24.66131,1561077
17534,rheaditi,2,0.00013,384984,24.66144,1561077
17535,rhjensen79,2,0.00013,384986,24.66156,1561077
17536,rhodgkins,2,0.00013,384988,24.66169,1561077
17537,Ri5ux,2,0.00013,384990,24.66182,1561077
17538,riansanderson,2,0.00013,384992,24.66195,1561077
17539,RicardoArgg,2,0.00013,384994,24.66208,1561077
17540,RiccardoBoettcher,2,0.00013,384996,24.66220,1561077
17541,ricfeatherstone,2,0.00013,384998,24.66233,1561077
17542,RichardBradley,2,0.00013,385000,24.66246,1561077
17543,richardg867,2,0.00013,385002,24.66259,1561077
17544,richchenjenkins,2,0.00013,385004,24.66272,1561077
17545,ricktrintech,2,0.00013,385006,24.66284,1561077
17546,rifkyalikiki,2,0.00013,385008,24.66297,1561077
17547,righettod,2,0.00013,385010,24.66310,1561077
17548,rigrassm,2,0.00013,385012,24.66323,1561077
17549,rigsbyt,2,0.00013,385014,24.66336,1561077
17550,rikardfalkeborn,2,0.00013,385016,24.66349,1561077
17551,rikercd,2,0.00013,385018,24.66361,1561077
17552,rikycaldeira,2,0.00013,385020,24.66374,1561077
17553,rishabhsingh29,2,0.00013,385022,24.66387,1561077
17554,RishabhTayal,2,0.00013,385024,24.66400,1561077
17555,Rizal-I,2,0.00013,385026,24.66413,1561077
17556,rizzob456,2,0.00013,385028,24.66425,1561077
17557,rji,2,0.00013,385030,24.66438,1561077
17558,r-kok,2,0.00013,385032,24.66451,1561077
17559,rkrgarlapati,2,0.00013,385034,24.66464,1561077
17560,rlagutinhub,2,0.00013,385036,24.66477,1561077
17561,rlewicki,2,0.00013,385038,24.66489,1561077
17562,rlibby,2,0.00013,385040,24.66502,1561077
17563,rlouis-r7,2,0.00013,385042,24.66515,1561077
17564,rlundy,2,0.00013,385044,24.66528,1561077
17565,rluta,2,0.00013,385046,24.66541,1561077
17566,rmacd,2,0.00013,385048,24.66554,1561077
17567,rmeneely,2,0.00013,385050,24.66566,1561077
17568,rmmacala,2,0.00013,385052,24.66579,1561077
17569,rnb1984,2,0.00013,385054,24.66592,1561077
17570,RNiveau,2,0.00013,385056,24.66605,1561077
17571,RoahNo,2,0.00013,385058,24.66618,1561077
17572,Rob159,2,0.00013,385060,24.66630,1561077
17573,robbinhan,2,0.00013,385062,24.66643,1561077
17574,robbinvandamme,2,0.00013,385064,24.66656,1561077
17575,robbyb67,2,0.00013,385066,24.66669,1561077
17576,robeferre,2,0.00013,385068,24.66682,1561077
17577,robert-gleis,2,0.00013,385070,24.66694,1561077
17578,robertoaloi,2,0.00013,385072,24.66707,1561077
17579,robertschulze,2,0.00013,385074,24.66720,1561077
17580,robertwedd,2,0.00013,385076,24.66733,1561077
17581,robichaud,2,0.00013,385078,24.66746,1561077
17582,RobinFauvel,2,0.00013,385080,24.66759,1561077
17583,robin-maxxton,2,0.00013,385082,24.66771,1561077
17584,robinryden,2,0.00013,385084,24.66784,1561077
17585,roblg,2,0.00013,385086,24.66797,1561077
17586,robmccready,2,0.00013,385088,24.66810,1561077
17587,robomon1,2,0.00013,385090,24.66823,1561077
17588,robotmay,2,0.00013,385092,24.66835,1561077
17589,robslabarbera,2,0.00013,385094,24.66848,1561077
17590,robsonhermes,2,0.00013,385096,24.66861,1561077
17591,robw42,2,0.00013,385098,24.66874,1561077
17592,roccatgaming,2,0.00013,385100,24.66887,1561077
17593,rocio27jul,2,0.00013,385102,24.66899,1561077
17594,rockpanda,2,0.00013,385104,24.66912,1561077
17595,rodfrancisco,2,0.00013,385106,24.66925,1561077
17596,rodrigopavezi,2,0.00013,385108,24.66938,1561077
17597,rodripv,2,0.00013,385110,24.66951,1561077
17598,Rod-Sychev,2,0.00013,385112,24.66964,1561077
17599,rofirrim,2,0.00013,385114,24.66976,1561077
17600,rogerkok,2,0.00013,385116,24.66989,1561077
17601,roger-link,2,0.00013,385118,24.67002,1561077
17602,rogerluan,2,0.00013,385120,24.67015,1561077
17603,rogthefrog,2,0.00013,385122,24.67028,1561077
17604,RohitMazumder,2,0.00013,385124,24.67040,1561077
17605,rokeyyan,2,0.00013,385126,24.67053,1561077
17606,rokoroku,2,0.00013,385128,24.67066,1561077
17607,roleyfoley,2,0.00013,385130,24.67079,1561077
17608,rollingstones62,2,0.00013,385132,24.67092,1561077
17609,rolsdorph,2,0.00013,385134,24.67104,1561077
17610,roma-d,2,0.00013,385136,24.67117,1561077
17611,roman-khazanskii,2,0.00013,385138,24.67130,1561077
17612,roman-mibex-2,2,0.00013,385140,24.67143,1561077
17613,RomanSaveljev,2,0.00013,385142,24.67156,1561077
17614,Romchela,2,0.00013,385144,24.67168,1561077
17615,romilpunetha,2,0.00013,385146,24.67181,1561077
17616,Roming22,2,0.00013,385148,24.67194,1561077
17617,rommy1204,2,0.00013,385150,24.67207,1561077
17618,romogo17,2,0.00013,385152,24.67220,1561077
17619,ronaldvanrij,2,0.00013,385154,24.67233,1561077
17620,ronanbrowne,2,0.00013,385156,24.67245,1561077
17621,RonanMacFhlan,2,0.00013,385158,24.67258,1561077
17622,RonGokhale,2,0.00013,385160,24.67271,1561077
17623,roppa,2,0.00013,385162,24.67284,1561077
17624,rosdiablatiff01,2,0.00013,385164,24.67297,1561077
17625,roshi619,2,0.00013,385166,24.67309,1561077
17626,rosiecki,2,0.00013,385168,24.67322,1561077
17627,rounak-codiant,2,0.00013,385170,24.67335,1561077
17628,rowong,2,0.00013,385172,24.67348,1561077
17629,Roysten,2,0.00013,385174,24.67361,1561077
17630,rpavlik,2,0.00013,385176,24.67373,1561077
17631,RPCMoritz,2,0.00013,385178,24.67386,1561077
17632,rpiper,2,0.00013,385180,24.67399,1561077
17633,RPitt,2,0.00013,385182,24.67412,1561077
17634,rpkbajaj,2,0.00013,385184,24.67425,1561077
17635,rremer,2,0.00013,385186,24.67438,1561077
17636,rr-nick-tan,2,0.00013,385188,24.67450,1561077
17637,rroblik,2,0.00013,385190,24.67463,1561077
17638,rrondeau,2,0.00013,385192,24.67476,1561077
17639,rsam70,2,0.00013,385194,24.67489,1561077
17640,rsayn,2,0.00013,385196,24.67502,1561077
17641,rsbeckerca,2,0.00013,385198,24.67514,1561077
17642,rsenden,2,0.00013,385200,24.67527,1561077
17643,rsfez,2,0.00013,385202,24.67540,1561077
17644,rsimpson2,2,0.00013,385204,24.67553,1561077
17645,rslobojan-saucelabs,2,0.00013,385206,24.67566,1561077
17646,rsommerard,2,0.00013,385208,24.67578,1561077
17647,rsov,2,0.00013,385210,24.67591,1561077
17648,rstamgh,2,0.00013,385212,24.67604,1561077
17649,rstanevich,2,0.00013,385214,24.67617,1561077
17650,rsz2040,2,0.00013,385216,24.67630,1561077
17651,RTechSoft,2,0.00013,385218,24.67643,1561077
17652,rtkkroland,2,0.00013,385220,24.67655,1561077
17653,rtonde-nv,2,0.00013,385222,24.67668,1561077
17654,rubbercable,2,0.00013,385224,24.67681,1561077
17655,Rubix982,2,0.00013,385226,24.67694,1561077
17656,rucindrea,2,0.00013,385228,24.67707,1561077
17657,ruckserve,2,0.00013,385230,24.67719,1561077
17658,rugosi,2,0.00013,385232,24.67732,1561077
17659,runswithd6s,2,0.00013,385234,24.67745,1561077
17660,rupertohpen,2,0.00013,385236,24.67758,1561077
17661,ruppertus,2,0.00013,385238,24.67771,1561077
17662,ruruiye,2,0.00013,385240,24.67783,1561077
17663,rus364,2,0.00013,385242,24.67796,1561077
17664,russellrc-keebo,2,0.00013,385244,24.67809,1561077
17665,russellrobinson,2,0.00013,385246,24.67822,1561077
17666,russinholi,2,0.00013,385248,24.67835,1561077
17667,RustyChain,2,0.00013,385250,24.67848,1561077
17668,ruzin,2,0.00013,385252,24.67860,1561077
17669,ruZZil,2,0.00013,385254,24.67873,1561077
17670,rvarma-godaddy,2,0.00013,385256,24.67886,1561077
17671,rvdven123,2,0.00013,385258,24.67899,1561077
17672,rveede,2,0.00013,385260,24.67912,1561077
17673,rvelzeboerebay,2,0.00013,385262,24.67924,1561077
17674,RX14,2,0.00013,385264,24.67937,1561077
17675,rxsheng,2,0.00013,385266,24.67950,1561077
17676,ryanbelair-mfj,2,0.00013,385268,24.67963,1561077
17677,ryandanthony,2,0.00013,385270,24.67976,1561077
17678,ryandell24,2,0.00013,385272,24.67988,1561077
17679,ryanerato,2,0.00013,385274,24.68001,1561077
17680,ryanewtaylor,2,0.00013,385276,24.68014,1561077
17681,RyanFromQA,2,0.00013,385278,24.68027,1561077
17682,ryang1428,2,0.00013,385280,24.68040,1561077
17683,ryankav,2,0.00013,385282,24.68053,1561077
17684,ryankillory,2,0.00013,385284,24.68065,1561077
17685,ryanmrodriguez,2,0.00013,385286,24.68078,1561077
17686,ryanschwartz,2,0.00013,385288,24.68091,1561077
17687,ryanvanoss,2,0.00013,385290,24.68104,1561077
17688,RyanYans,2,0.00013,385292,24.68117,1561077
17689,ryanym,2,0.00013,385294,24.68129,1561077
17690,rymai,2,0.00013,385296,24.68142,1561077
17691,rypcarr,2,0.00013,385298,24.68155,1561077
17692,ryrydundun,2,0.00013,385300,24.68168,1561077
17693,ryubato,2,0.00013,385302,24.68181,1561077
17694,s0s-app,2,0.00013,385304,24.68193,1561077
17695,s332401890,2,0.00013,385306,24.68206,1561077
17696,s390xlinux,2,0.00013,385308,24.68219,1561077
17697,s3r3n3-1,2,0.00013,385310,24.68232,1561077
17698,s3xy4ngyc,2,0.00013,385312,24.68245,1561077
17699,SabinoWS,2,0.00013,385314,24.68257,1561077
17700,sachindast,2,0.00013,385316,24.68270,1561077
17701,sackdan,2,0.00013,385318,24.68283,1561077
17702,sadaiyer,2,0.00013,385320,24.68296,1561077
17703,sadatnfs,2,0.00013,385322,24.68309,1561077
17704,safeYYY,2,0.00013,385324,24.68322,1561077
17705,SageBerg,2,0.00013,385326,24.68334,1561077
17706,sahilshah6196,2,0.00013,385328,24.68347,1561077
17707,saik330,2,0.00013,385330,24.68360,1561077
17708,saikirandusari,2,0.00013,385332,24.68373,1561077
17709,saikrishnamylaram,2,0.00013,385334,24.68386,1561077
17710,saikumarsinguluri,2,0.00013,385336,24.68398,1561077
17711,saimak,2,0.00013,385338,24.68411,1561077
17712,SaimonL,2,0.00013,385340,24.68424,1561077
17713,Saim-Safdar,2,0.00013,385342,24.68437,1561077
17714,sainouche,2,0.00013,385344,24.68450,1561077
17715,saipradeep434,2,0.00013,385346,24.68462,1561077
17716,saitama-dh,2,0.00013,385348,24.68475,1561077
17717,saivenkat999,2,0.00013,385350,24.68488,1561077
17718,Sajfer,2,0.00013,385352,24.68501,1561077
17719,sajid-moinuddin,2,0.00013,385354,24.68514,1561077
17720,sajimon,2,0.00013,385356,24.68527,1561077
17721,sak52jp,2,0.00013,385358,24.68539,1561077
17722,sako0938,2,0.00013,385360,24.68552,1561077
17723,sakoyaespana,2,0.00013,385362,24.68565,1561077
17724,SakshamGarg16,2,0.00013,385364,24.68578,1561077
17725,salashnik,2,0.00013,385366,24.68591,1561077
17726,Saltari,2,0.00013,385368,24.68603,1561077
17727,salt-mountain,2,0.00013,385370,24.68616,1561077
17728,Saluev,2,0.00013,385372,24.68629,1561077
17729,sam0delkin,2,0.00013,385374,24.68642,1561077
17730,sam1el,2,0.00013,385376,24.68655,1561077
17731,samdmarshall,2,0.00013,385378,24.68667,1561077
17732,samedguener,2,0.00013,385380,24.68680,1561077
17733,sameetn,2,0.00013,385382,24.68693,1561077
17734,sameg14,2,0.00013,385384,24.68706,1561077
17735,Samiatrix,2,0.00013,385386,24.68719,1561077
17736,sammyxx,2,0.00013,385388,24.68732,1561077
17737,SamNelson,2,0.00013,385390,24.68744,1561077
17738,samodadela,2,0.00013,385392,24.68757,1561077
17739,sampsonye,2,0.00013,385394,24.68770,1561077
17740,samsiu2014,2,0.00013,385396,24.68783,1561077
17741,SamSpiri,2,0.00013,385398,24.68796,1561077
17742,samuelbernardolip,2,0.00013,385400,24.68808,1561077
17743,samuel-phan,2,0.00013,385402,24.68821,1561077
17744,samuv,2,0.00013,385404,24.68834,1561077
17745,samveljanvelyan,2,0.00013,385406,24.68847,1561077
17746,sandhya-2000,2,0.00013,385408,24.68860,1561077
17747,sandoxas,2,0.00013,385410,24.68872,1561077
17748,sandraantunes-cicd,2,0.00013,385412,24.68885,1561077
17749,sandrom,2,0.00013,385414,24.68898,1561077
17750,sanganabasavap,2,0.00013,385416,24.68911,1561077
17751,sangmanla,2,0.00013,385418,24.68924,1561077
17752,SanjayThomas,2,0.00013,385420,24.68937,1561077
17753,sanjucvrce,2,0.00013,385422,24.68949,1561077
17754,SankarMittapally,2,0.00013,385424,24.68962,1561077
17755,Sanne,2,0.00013,385426,24.68975,1561077
17756,sanniassin,2,0.00013,385428,24.68988,1561077
17757,Santhoshreddy3,2,0.00013,385430,24.69001,1561077
17758,santi8ago8,2,0.00013,385432,24.69013,1561077
17759,sanyatuning,2,0.00013,385434,24.69026,1561077
17760,sapedevops,2,0.00013,385436,24.69039,1561077
17761,saqibmubarak,2,0.00013,385438,24.69052,1561077
17762,sarab2009,2,0.00013,385440,24.69065,1561077
17763,saranchand,2,0.00013,385442,24.69077,1561077
17764,sarasantos96,2,0.00013,385444,24.69090,1561077
17765,sarg,2,0.00013,385446,24.69103,1561077
17766,sasah,2,0.00013,385448,24.69116,1561077
17767,sash-kan,2,0.00013,385450,24.69129,1561077
17768,sasiarivukalanjiam,2,0.00013,385452,24.69141,1561077
17769,sathish97625,2,0.00013,385454,24.69154,1561077
17770,satng,2,0.00013,385456,24.69167,1561077
17771,satunnainen,2,0.00013,385458,24.69180,1561077
17772,Saurabhj87ST,2,0.00013,385460,24.69193,1561077
17773,savvykms,2,0.00013,385462,24.69206,1561077
17774,sawatts,2,0.00013,385464,24.69218,1561077
17775,saytik,2,0.00013,385466,24.69231,1561077
17776,sazulo,2,0.00013,385468,24.69244,1561077
17777,sbabno,2,0.00013,385470,24.69257,1561077
17778,sbarthelemy,2,0.00013,385472,24.69270,1561077
17779,sbehrens,2,0.00013,385474,24.69282,1561077
17780,sbenas1,2,0.00013,385476,24.69295,1561077
17781,sbesson,2,0.00013,385478,24.69308,1561077
17782,sbienkow,2,0.00013,385480,24.69321,1561077
17783,sbouchex,2,0.00013,385482,24.69334,1561077
17784,sbrinkerhoff,2,0.00013,385484,24.69346,1561077
17785,sbshri,2,0.00013,385486,24.69359,1561077
17786,sbtest,2,0.00013,385488,24.69372,1561077
17787,sburky32,2,0.00013,385490,24.69385,1561077
17788,sbyrne13,2,0.00013,385492,24.69398,1561077
17789,scarbonell-ibm,2,0.00013,385494,24.69411,1561077
17790,scarby,2,0.00013,385496,24.69423,1561077
17791,scarlac,2,0.00013,385498,24.69436,1561077
17792,scenaristeur,2,0.00013,385500,24.69449,1561077
17793,scepticulous,2,0.00013,385502,24.69462,1561077
17794,schakko,2,0.00013,385504,24.69475,1561077
17795,schaumb,2,0.00013,385506,24.69487,1561077
17796,schezfaz,2,0.00013,385508,24.69500,1561077
17797,schildwaechter,2,0.00013,385510,24.69513,1561077
17798,schmave,2,0.00013,385512,24.69526,1561077
17799,schneeheld,2,0.00013,385514,24.69539,1561077
17800,schnipseljagd,2,0.00013,385516,24.69551,1561077
17801,scholtzm,2,0.00013,385518,24.69564,1561077
17802,schreibe72,2,0.00013,385520,24.69577,1561077
17803,schue,2,0.00013,385522,24.69590,1561077
17804,schwing,2,0.00013,385524,24.69603,1561077
17805,sciyako,2,0.00013,385526,24.69616,1561077
17806,scoopex,2,0.00013,385528,24.69628,1561077
17807,scostello-paanalytics,2,0.00013,385530,24.69641,1561077
17808,Scotchester,2,0.00013,385532,24.69654,1561077
17809,scott-compsource,2,0.00013,385534,24.69667,1561077
17810,ScottyVG,2,0.00013,385536,24.69680,1561077
17811,scott-zhong,2,0.00013,385538,24.69692,1561077
17812,scramboy,2,0.00013,385540,24.69705,1561077
17813,scthunderbolt,2,0.00013,385542,24.69718,1561077
17814,scttdavs,2,0.00013,385544,24.69731,1561077
17815,scubadam,2,0.00013,385546,24.69744,1561077
17816,sdaconceicao,2,0.00013,385548,24.69756,1561077
17817,sDaniel,2,0.00013,385550,24.69769,1561077
17818,sdatko,2,0.00013,385552,24.69782,1561077
17819,sdenel,2,0.00013,385554,24.69795,1561077
17820,sdevineau,2,0.00013,385556,24.69808,1561077
17821,sealcaptain,2,0.00013,385558,24.69821,1561077
17822,seanennis,2,0.00013,385560,24.69833,1561077
17823,seangal2,2,0.00013,385562,24.69846,1561077
17824,seanleblancicdtech,2,0.00013,385564,24.69859,1561077
17825,seanmmills,2,0.00013,385566,24.69872,1561077
17826,seanpianka,2,0.00013,385568,24.69885,1561077
17827,SeanZhu20,2,0.00013,385570,24.69897,1561077
17828,sean-zou,2,0.00013,385572,24.69910,1561077
17829,Sebasti1492,2,0.00013,385574,24.69923,1561077
17830,sebastian301082-KAM,2,0.00013,385576,24.69936,1561077
17831,sebastianrakel,2,0.00013,385578,24.69949,1561077
17832,SebastianUA,2,0.00013,385580,24.69961,1561077
17833,sebbi08,2,0.00013,385582,24.69974,1561077
17834,sebek64,2,0.00013,385584,24.69987,1561077
17835,seetharam757,2,0.00013,385586,24.70000,1561077
17836,segaura,2,0.00013,385588,24.70013,1561077
17837,Seguret,2,0.00013,385590,24.70026,1561077
17838,seikichi,2,0.00013,385592,24.70038,1561077
17839,seldane,2,0.00013,385594,24.70051,1561077
17840,selmanozturk,2,0.00013,385596,24.70064,1561077
17841,selvaM7,2,0.00013,385598,24.70077,1561077
17842,selvarajmit,2,0.00013,385600,24.70090,1561077
17843,senips1001,2,0.00013,385602,24.70102,1561077
17844,senorsmile,2,0.00013,385604,24.70115,1561077
17845,sentinel09,2,0.00013,385606,24.70128,1561077
17846,senzzzi,2,0.00013,385608,24.70141,1561077
17847,sepe81,2,0.00013,385610,24.70154,1561077
17848,sepulvedablanco-inditex,2,0.00013,385612,24.70166,1561077
17849,serafeimgr,2,0.00013,385614,24.70179,1561077
17850,serge2016,2,0.00013,385616,24.70192,1561077
17851,sergebeauchampGoogle,2,0.00013,385618,24.70205,1561077
17852,sergemat,2,0.00013,385620,24.70218,1561077
17853,SergeyVolynkin,2,0.00013,385622,24.70230,1561077
17854,SergiiTrybushnyi,2,0.00013,385624,24.70243,1561077
17855,sergiomhmh,2,0.00013,385626,24.70256,1561077
17856,SergioTeco,2,0.00013,385628,24.70269,1561077
17857,sergiu-svinarciuc,2,0.00013,385630,24.70282,1561077
17858,sergw,2,0.00013,385632,24.70295,1561077
17859,serhermar-stratio,2,0.00013,385634,24.70307,1561077
17860,serj-lotutovici,2,0.00013,385636,24.70320,1561077
17861,serut,2,0.00013,385638,24.70333,1561077
17862,seternate,2,0.00013,385640,24.70346,1561077
17863,SeungHyeonShin,2,0.00013,385642,24.70359,1561077
17864,severino42,2,0.00013,385644,24.70371,1561077
17865,sfc-gh-tvidyasankar,2,0.00013,385646,24.70384,1561077
17866,s-fedcijenkins-bronga,2,0.00013,385648,24.70397,1561077
17867,sfenu,2,0.00013,385650,24.70410,1561077
17868,sfresnel,2,0.00013,385652,24.70423,1561077
17869,sgcsekar,2,0.00013,385654,24.70435,1561077
17870,sgogolev,2,0.00013,385656,24.70448,1561077
17871,sgoudelis,2,0.00013,385658,24.70461,1561077
17872,sgrmgj777,2,0.00013,385660,24.70474,1561077
17873,sgronblo,2,0.00013,385662,24.70487,1561077
17874,sh0wl1ght,2,0.00013,385664,24.70500,1561077
17875,shad0356jc,2,0.00013,385666,24.70512,1561077
17876,ShadyStego,2,0.00013,385668,24.70525,1561077
17877,shahar-h,2,0.00013,385670,24.70538,1561077
17878,shahharsh,2,0.00013,385672,24.70551,1561077
17879,shahmit,2,0.00013,385674,24.70564,1561077
17880,shahprincea,2,0.00013,385676,24.70576,1561077
17881,shahrooqgunnu,2,0.00013,385678,24.70589,1561077
17882,shaishap,2,0.00013,385680,24.70602,1561077
17883,shakuzen,2,0.00013,385682,24.70615,1561077
17884,shamiwillms,2,0.00013,385684,24.70628,1561077
17885,shanesavoie,2,0.00013,385686,24.70640,1561077
17886,shanewalton,2,0.00013,385688,24.70653,1561077
17887,Shanjohn,2,0.00013,385690,24.70666,1561077
17888,ShanmukhaGajula,2,0.00013,385692,24.70679,1561077
17889,shapiroj,2,0.00013,385694,24.70692,1561077
17890,SharikSaigal,2,0.00013,385696,24.70705,1561077
17891,sharpedavid,2,0.00013,385698,24.70717,1561077
17892,Sharpek,2,0.00013,385700,24.70730,1561077
17893,shasiksc,2,0.00013,385702,24.70743,1561077
17894,shaunsmiley-rms,2,0.00013,385704,24.70756,1561077
17895,shay-bracha,2,0.00013,385706,24.70769,1561077
17896,shaygalon,2,0.00013,385708,24.70781,1561077
17897,sheldonfernandes,2,0.00013,385710,24.70794,1561077
17898,shellshock1953,2,0.00013,385712,24.70807,1561077
17899,shengbinwu-houzz,2,0.00013,385714,24.70820,1561077
17900,shenghui555,2,0.00013,385716,24.70833,1561077
17901,shenqinb-star,2,0.00013,385718,24.70845,1561077
17902,sheona-harry,2,0.00013,385720,24.70858,1561077
17903,shermanericts,2,0.00013,385722,24.70871,1561077
17904,Sherpard,2,0.00013,385724,24.70884,1561077
17905,Sh-Ho,2,0.00013,385726,24.70897,1561077
17906,shihalv,2,0.00013,385728,24.70910,1561077
17907,shijinupc,2,0.00013,385730,24.70922,1561077
17908,shinstudio,2,0.00013,385732,24.70935,1561077
17909,shintasmith,2,0.00013,385734,24.70948,1561077
17910,shinyvince,2,0.00013,385736,24.70961,1561077
17911,shipilovds,2,0.00013,385738,24.70974,1561077
17912,shirelvaiman,2,0.00013,385740,24.70986,1561077
17913,shirish87,2,0.00013,385742,24.70999,1561077
17914,shishkin,2,0.00013,385744,24.71012,1561077
17915,shiv8080,2,0.00013,385746,24.71025,1561077
17916,shivakirankonduru,2,0.00013,385748,24.71038,1561077
17917,shivam221201,2,0.00013,385750,24.71050,1561077
17918,shivamconan,2,0.00013,385752,24.71063,1561077
17919,ShivamGoyal1899,2,0.00013,385754,24.71076,1561077
17920,shivanand-yarnal,2,0.00013,385756,24.71089,1561077
17921,shivang-r,2,0.00013,385758,24.71102,1561077
17922,Shivanshu-lambdatest,2,0.00013,385760,24.71114,1561077
17923,shlomodaari,2,0.00013,385762,24.71127,1561077
17924,Shnitselon,2,0.00013,385764,24.71140,1561077
17925,shodachi,2,0.00013,385766,24.71153,1561077
17926,shohilbagdai,2,0.00013,385768,24.71166,1561077
17927,shopeonarope,2,0.00013,385770,24.71179,1561077
17928,shraddha761,2,0.00013,385772,24.71191,1561077
17929,shravyakasturi,2,0.00013,385774,24.71204,1561077
17930,shridhar-at-droit,2,0.00013,385776,24.71217,1561077
17931,ShriramSuryaAws,2,0.00013,385778,24.71230,1561077
17932,shris-github,2,0.00013,385780,24.71243,1561077
17933,shthe,2,0.00013,385782,24.71255,1561077
17934,shubhamj-cuelogic,2,0.00013,385784,24.71268,1561077
17935,shubhamunthinkable,2,0.00013,385786,24.71281,1561077
17936,Shubzz-02,2,0.00013,385788,24.71294,1561077
17937,shumn,2,0.00013,385790,24.71307,1561077
17938,ShurikuS57,2,0.00013,385792,24.71319,1561077
17939,shurkanTwo,2,0.00013,385794,24.71332,1561077
17940,shushry,2,0.00013,385796,24.71345,1561077
17941,shushu2017,2,0.00013,385798,24.71358,1561077
17942,shweta9651,2,0.00013,385800,24.71371,1561077
17943,sidd-1,2,0.00013,385802,24.71384,1561077
17944,siddhant-28,2,0.00013,385804,24.71396,1561077
17945,siddhanthrathod,2,0.00013,385806,24.71409,1561077
17946,siddharthgrd,2,0.00013,385808,24.71422,1561077
17947,SiegfriedEhret,2,0.00013,385810,24.71435,1561077
17948,siggimoo,2,0.00013,385812,24.71448,1561077
17949,sigtrap,2,0.00013,385814,24.71460,1561077
17950,Silox,2,0.00013,385816,24.71473,1561077
17951,Silron88,2,0.00013,385818,24.71486,1561077
17952,silvermy,2,0.00013,385820,24.71499,1561077
17953,simjeet,2,0.00013,385822,24.71512,1561077
17954,simone201,2,0.00013,385824,24.71524,1561077
17955,simonlsk,2,0.00013,385826,24.71537,1561077
17956,simon-michaud,2,0.00013,385828,24.71550,1561077
17957,simonpahl,2,0.00013,385830,24.71563,1561077
17958,SimonSDA,2,0.00013,385832,24.71576,1561077
17959,simple-elf,2,0.00013,385834,24.71589,1561077
17960,simplyira,2,0.00013,385836,24.71601,1561077
17961,singh-abhijeet,2,0.00013,385838,24.71614,1561077
17962,SinhaAshish,2,0.00013,385840,24.71627,1561077
17963,sinharitika07,2,0.00013,385842,24.71640,1561077
17964,SinisterLight,2,0.00013,385844,24.71653,1561077
17965,sir997,2,0.00013,385846,24.71665,1561077
17966,sirago,2,0.00013,385848,24.71678,1561077
17967,sirde,2,0.00013,385850,24.71691,1561077
17968,siriak,2,0.00013,385852,24.71704,1561077
17969,sirsavary,2,0.00013,385854,24.71717,1561077
17970,SiRumCz,2,0.00013,385856,24.71729,1561077
17971,siteshwar,2,0.00013,385858,24.71742,1561077
17972,sitzm,2,0.00013,385860,24.71755,1561077
17973,sivabaisani,2,0.00013,385862,24.71768,1561077
17974,sivakspt,2,0.00013,385864,24.71781,1561077
17975,sivaramsk,2,0.00013,385866,24.71794,1561077
17976,sjoss,2,0.00013,385868,24.71806,1561077
17977,sjr,2,0.00013,385870,24.71819,1561077
17978,skamenetskiy,2,0.00013,385872,24.71832,1561077
17979,skashyap7,2,0.00013,385874,24.71845,1561077
17980,s-kelvin,2,0.00013,385876,24.71858,1561077
17981,skhadka-securus,2,0.00013,385878,24.71870,1561077
17982,skitaz777,2,0.00013,385880,24.71883,1561077
17983,skord,2,0.00013,385882,24.71896,1561077
17984,skornehl,2,0.00013,385884,24.71909,1561077
17985,skparkes,2,0.00013,385886,24.71922,1561077
17986,skrishna375,2,0.00013,385888,24.71934,1561077
17987,sky-daiji,2,0.00013,385890,24.71947,1561077
17988,skyhirider,2,0.00013,385892,24.71960,1561077
17989,skymeyer,2,0.00013,385894,24.71973,1561077
17990,Skyridr,2,0.00013,385896,24.71986,1561077
17991,SkySonR,2,0.00013,385898,24.71998,1561077
17992,Skysper,2,0.00013,385900,24.72011,1561077
17993,slallemand,2,0.00013,385902,24.72024,1561077
17994,slanglois,2,0.00013,385904,24.72037,1561077
17995,slaribi,2,0.00013,385906,24.72050,1561077
17996,sledz,2,0.00013,385908,24.72063,1561077
17997,Sleekbobby1011,2,0.00013,385910,24.72075,1561077
17998,sleicht,2,0.00013,385912,24.72088,1561077
17999,slewiskelly,2,0.00013,385914,24.72101,1561077
18000,Slezhuk,2,0.00013,385916,24.72114,1561077
18001,slfletch,2,0.00013,385918,24.72127,1561077
18002,slietzau,2,0.00013,385920,24.72139,1561077
18003,Sliuza,2,0.00013,385922,24.72152,1561077
18004,slnowak,2,0.00013,385924,24.72165,1561077
18005,slomo,2,0.00013,385926,24.72178,1561077
18006,slPerryRhodan,2,0.00013,385928,24.72191,1561077
18007,slushpupie,2,0.00013,385930,24.72203,1561077
18008,slw07g,2,0.00013,385932,24.72216,1561077
18009,slxiao,2,0.00013,385934,24.72229,1561077
18010,slynTEN,2,0.00013,385936,24.72242,1561077
18011,smarie,2,0.00013,385938,24.72255,1561077
18012,smarlowe-cisco,2,0.00013,385940,24.72268,1561077
18013,smartin-qb,2,0.00013,385942,24.72280,1561077
18014,smcquay,2,0.00013,385944,24.72293,1561077
18015,smecsia,2,0.00013,385946,24.72306,1561077
18016,Smedzlatko,2,0.00013,385948,24.72319,1561077
18017,smena,2,0.00013,385950,24.72332,1561077
18018,smennetrier,2,0.00013,385952,24.72344,1561077
18019,smipi1,2,0.00013,385954,24.72357,1561077
18020,smolin,2,0.00013,385956,24.72370,1561077
18021,smon,2,0.00013,385958,24.72383,1561077
18022,smonfort-cacd2,2,0.00013,385960,24.72396,1561077
18023,smoreau95,2,0.00013,385962,24.72408,1561077
18024,Smotko,2,0.00013,385964,24.72421,1561077
18025,smoya,2,0.00013,385966,24.72434,1561077
18026,smoyer,2,0.00013,385968,24.72447,1561077
18027,smreichling,2,0.00013,385970,24.72460,1561077
18028,smruti-sahoo,2,0.00013,385972,24.72473,1561077
18029,smuppala01,2,0.00013,385974,24.72485,1561077
18030,sn00p,2,0.00013,385976,24.72498,1561077
18031,snago,2,0.00013,385978,24.72511,1561077
18032,snahider,2,0.00013,385980,24.72524,1561077
18033,snahmad,2,0.00013,385982,24.72537,1561077
18034,sne11ius,2,0.00013,385984,24.72549,1561077
18035,snevs,2,0.00013,385986,24.72562,1561077
18036,snicks92,2,0.00013,385988,24.72575,1561077
18037,sniedetzki,2,0.00013,385990,24.72588,1561077
18038,snkshukla,2,0.00013,385992,24.72601,1561077
18039,snowblink,2,0.00013,385994,24.72613,1561077
18040,snupy,2,0.00013,385996,24.72626,1561077
18041,soar,2,0.00013,385998,24.72639,1561077
18042,soczkers,2,0.00013,386000,24.72652,1561077
18043,sodero,2,0.00013,386002,24.72665,1561077
18044,sojiadvanced,2,0.00013,386004,24.72678,1561077
18045,Solksjaer,2,0.00013,386006,24.72690,1561077
18046,sollecitom,2,0.00013,386008,24.72703,1561077
18047,soloman1124,2,0.00013,386010,24.72716,1561077
18048,solomenvAbhishek,2,0.00013,386012,24.72729,1561077
18049,somashekar10,2,0.00013,386014,24.72742,1561077
18050,sonalsinghai,2,0.00013,386016,24.72754,1561077
18051,sonhuynhpham,2,0.00013,386018,24.72767,1561077
18052,SonOfBowser,2,0.00013,386020,24.72780,1561077
18053,sonrics11,2,0.00013,386022,24.72793,1561077
18054,soprano8086,2,0.00013,386024,24.72806,1561077
18055,SosoTughushi,2,0.00013,386026,24.72818,1561077
18056,sotiabhishek,2,0.00013,386028,24.72831,1561077
18057,soukainakhalkhouli,2,0.00013,386030,24.72844,1561077
18058,soukron,2,0.00013,386032,24.72857,1561077
18059,soundstep,2,0.00013,386034,24.72870,1561077
18060,sourabhg,2,0.00013,386036,24.72883,1561077
18061,sourabhsharma-devsecops-specialist,2,0.00013,386038,24.72895,1561077
18062,sowmyadass,2,0.00013,386040,24.72908,1561077
18063,sowmya-parsi,2,0.00013,386042,24.72921,1561077
18064,sownaRajkumar,2,0.00013,386044,24.72934,1561077
18065,spa-87,2,0.00013,386046,24.72947,1561077
18066,spac3hit,2,0.00013,386048,24.72959,1561077
18067,spacehorst,2,0.00013,386050,24.72972,1561077
18068,sparkiegeek,2,0.00013,386052,24.72985,1561077
18069,sparrowt,2,0.00013,386054,24.72998,1561077
18070,spasam,2,0.00013,386056,24.73011,1561077
18071,Spea,2,0.00013,386058,24.73023,1561077
18072,spelcaster,2,0.00013,386060,24.73036,1561077
18073,spencerrung,2,0.00013,386062,24.73049,1561077
18074,spender0,2,0.00013,386064,24.73062,1561077
18075,spidervamsi,2,0.00013,386066,24.73075,1561077
18076,spinnaker-ro,2,0.00013,386068,24.73087,1561077
18077,spiralfuzet,2,0.00013,386070,24.73100,1561077
18078,splatteredbits,2,0.00013,386072,24.73113,1561077
18079,sponte,2,0.00013,386074,24.73126,1561077
18080,sporkm,2,0.00013,386076,24.73139,1561077
18081,sprnza,2,0.00013,386078,24.73152,1561077
18082,spudmux,2,0.00013,386080,24.73164,1561077
18083,squestc,2,0.00013,386082,24.73177,1561077
18084,squfrans,2,0.00013,386084,24.73190,1561077
18085,sr75,2,0.00013,386086,24.73203,1561077
18086,srafiqa,2,0.00013,386088,24.73216,1561077
18087,Sravanthi9999,2,0.00013,386090,24.73228,1561077
18088,sravanthy09,2,0.00013,386092,24.73241,1561077
18089,sreddy9676,2,0.00013,386094,24.73254,1561077
18090,sreejesh-radhakrishnan-db,2,0.00013,386096,24.73267,1561077
18091,sreepamulapati,2,0.00013,386098,24.73280,1561077
18092,sreyan-ghosh,2,0.00013,386100,24.73292,1561077
18093,sriharshakancharla,2,0.00013,386102,24.73305,1561077
18094,srikanthopsmx,2,0.00013,386104,24.73318,1561077
18095,srikanthrk1020,2,0.00013,386106,24.73331,1561077
18096,Srikanthshetty,2,0.00013,386108,24.73344,1561077
18097,srimanoj,2,0.00013,386110,24.73357,1561077
18098,srinivasvadla,2,0.00013,386112,24.73369,1561077
18099,sriramspin,2,0.00013,386114,24.73382,1561077
18100,srisaravananwt,2,0.00013,386116,24.73395,1561077
18101,srolsson,2,0.00013,386118,24.73408,1561077
18102,sroth80021,2,0.00013,386120,24.73421,1561077
18103,srudolph-credera,2,0.00013,386122,24.73433,1561077
18104,SRuland,2,0.00013,386124,24.73446,1561077
18105,ssaarinen,2,0.00013,386126,24.73459,1561077
18106,ssfinney,2,0.00013,386128,24.73472,1561077
18107,ssinghalu,2,0.00013,386130,24.73485,1561077
18108,sskjames,2,0.00013,386132,24.73497,1561077
18109,ssotangkur,2,0.00013,386134,24.73510,1561077
18110,ssoto2,2,0.00013,386136,24.73523,1561077
18111,s-sr,2,0.00013,386138,24.73536,1561077
18112,s-sr1,2,0.00013,386140,24.73549,1561077
18113,sstafford,2,0.00013,386142,24.73562,1561077
18114,sstephenson-r7,2,0.00013,386144,24.73574,1561077
18115,sstriano,2,0.00013,386146,24.73587,1561077
18116,ssunitaa,2,0.00013,386148,24.73600,1561077
18117,s-sutherland,2,0.00013,386150,24.73613,1561077
18118,St1gven,2,0.00013,386152,24.73626,1561077
18119,sT331h0rs3,2,0.00013,386154,24.73638,1561077
18120,stacywile,2,0.00013,386156,24.73651,1561077
18121,stadia,2,0.00013,386158,24.73664,1561077
18122,staffanselander,2,0.00013,386160,24.73677,1561077
18123,stainboy,2,0.00013,386162,24.73690,1561077
18124,stancorbin99,2,0.00013,386164,24.73702,1561077
18125,stanislaw,2,0.00013,386166,24.73715,1561077
18126,Star-and-Buck,2,0.00013,386168,24.73728,1561077
18127,starcaptor,2,0.00013,386170,24.73741,1561077
18128,Starch,2,0.00013,386172,24.73754,1561077
18129,starthal,2,0.00013,386174,24.73767,1561077
18130,stayen,2,0.00013,386176,24.73779,1561077
18131,st-cyrill,2,0.00013,386178,24.73792,1561077
18132,Steed9,2,0.00013,386180,24.73805,1561077
18133,steeevieee,2,0.00013,386182,24.73818,1561077
18134,steephan-s1,2,0.00013,386184,24.73831,1561077
18135,stefanbaur-neugelb,2,0.00013,386186,24.73843,1561077
18136,stefansiegl,2,0.00013,386188,24.73856,1561077
18137,SteffenSeckler,2,0.00013,386190,24.73869,1561077
18138,steffensol,2,0.00013,386192,24.73882,1561077
18139,steinko,2,0.00013,386194,24.73895,1561077
18140,StephenDrewLDS,2,0.00013,386196,24.73907,1561077
18141,stephenmenton,2,0.00013,386198,24.73920,1561077
18142,stephenyeargin,2,0.00013,386200,24.73933,1561077
18143,stephnr,2,0.00013,386202,24.73946,1561077
18144,stevefranks,2,0.00013,386204,24.73959,1561077
18145,stevejulich,2,0.00013,386206,24.73971,1561077
18146,steve-kansa,2,0.00013,386208,24.73984,1561077
18147,stevelowery,2,0.00013,386210,24.73997,1561077
18148,stevemac007,2,0.00013,386212,24.74010,1561077
18149,stevematyas,2,0.00013,386214,24.74023,1561077
18150,stevemccann,2,0.00013,386216,24.74036,1561077
18151,stevenbill,2,0.00013,386218,24.74048,1561077
18152,stevenolen,2,0.00013,386220,24.74061,1561077
18153,StevenPZChan,2,0.00013,386222,24.74074,1561077
18154,StevenStreib,2,0.00013,386224,24.74087,1561077
18155,steveparkerSG,2,0.00013,386226,24.74100,1561077
18156,SteveStrongBAH,2,0.00013,386228,24.74112,1561077
18157,stevethedoug,2,0.00013,386230,24.74125,1561077
18158,stevewallone,2,0.00013,386232,24.74138,1561077
18159,stfp,2,0.00013,386234,24.74151,1561077
18160,stillgado,2,0.00013,386236,24.74164,1561077
18161,StillLearnin,2,0.00013,386238,24.74176,1561077
18162,stilren,2,0.00013,386240,24.74189,1561077
18163,stohrendorf,2,0.00013,386242,24.74202,1561077
18164,stolfi,2,0.00013,386244,24.74215,1561077
18165,stoned7,2,0.00013,386246,24.74228,1561077
18166,ST-o-RM,2,0.00013,386248,24.74241,1561077
18167,stowns,2,0.00013,386250,24.74253,1561077
18168,streeter,2,0.00013,386252,24.74266,1561077
18169,Strilanc,2,0.00013,386254,24.74279,1561077
18170,strowk,2,0.00013,386256,24.74292,1561077
18171,stszap,2,0.00013,386258,24.74305,1561077
18172,stth1998,2,0.00013,386260,24.74317,1561077
18173,sttodorov,2,0.00013,386262,24.74330,1561077
18174,stuartstevenson,2,0.00013,386264,24.74343,1561077
18175,stuartwill,2,0.00013,386266,24.74356,1561077
18176,studypyth,2,0.00013,386268,24.74369,1561077
18177,stuffandthings,2,0.00013,386270,24.74381,1561077
18178,stujapa,2,0.00013,386272,24.74394,1561077
18179,stunney,2,0.00013,386274,24.74407,1561077
18180,SubatomicHero,2,0.00013,386276,24.74420,1561077
18181,Subhasis180689,2,0.00013,386278,24.74433,1561077
18182,SubrataM3,2,0.00013,386280,24.74446,1561077
18183,substars,2,0.00013,386282,24.74458,1561077
18184,subsy,2,0.00013,386284,24.74471,1561077
18185,suchisubhra,2,0.00013,386286,24.74484,1561077
18186,sudarshanababu,2,0.00013,386288,24.74497,1561077
18187,SudevYaswanth,2,0.00013,386290,24.74510,1561077
18188,SudhiHathwar,2,0.00013,386292,24.74522,1561077
18189,sudhir6199,2,0.00013,386294,24.74535,1561077
18190,sufleu,2,0.00013,386296,24.74548,1561077
18191,suganyaravikumar,2,0.00013,386298,24.74561,1561077
18192,suhancz,2,0.00013,386300,24.74574,1561077
18193,suifengcnn,2,0.00013,386302,24.74586,1561077
18194,suityou01,2,0.00013,386304,24.74599,1561077
18195,sujaydevops1,2,0.00013,386306,24.74612,1561077
18196,sujithjoseph,2,0.00013,386308,24.74625,1561077
18197,sujithwarier,2,0.00013,386310,24.74638,1561077
18198,sulfasTor,2,0.00013,386312,24.74651,1561077
18199,sullivac,2,0.00013,386314,24.74663,1561077
18200,Sumit31,2,0.00013,386316,24.74676,1561077
18201,sumitg1,2,0.00013,386318,24.74689,1561077
18202,sumit-global,2,0.00013,386320,24.74702,1561077
18203,sundarseswaran,2,0.00013,386322,24.74715,1561077
18204,sunhao1256,2,0.00013,386324,24.74727,1561077
18205,sunishsurendrank,2,0.00013,386326,24.74740,1561077
18206,sunlove123,2,0.00013,386328,24.74753,1561077
18207,sunshineo,2,0.00013,386330,24.74766,1561077
18208,Sunstreaker,2,0.00013,386332,24.74779,1561077
18209,sunzhuo0211,2,0.00013,386334,24.74791,1561077
18210,SuperBarracuda,2,0.00013,386336,24.74804,1561077
18211,superlazyname,2,0.00013,386338,24.74817,1561077
18212,supersundar,2,0.00013,386340,24.74830,1561077
18213,surajrrao,2,0.00013,386342,24.74843,1561077
18214,suranc,2,0.00013,386344,24.74856,1561077
18215,surculus12,2,0.00013,386346,24.74868,1561077
18216,SureshGedela,2,0.00013,386348,24.74881,1561077
18217,sureshoao,2,0.00013,386350,24.74894,1561077
18218,sureshreddygithub,2,0.00013,386352,24.74907,1561077
18219,surj-bains,2,0.00013,386354,24.74920,1561077
18220,sushantlokhande,2,0.00013,386356,24.74932,1561077
18221,suttermichael,2,0.00013,386358,24.74945,1561077
18222,suzukieng,2,0.00013,386360,24.74958,1561077
18223,svalchinov,2,0.00013,386362,24.74971,1561077
18224,svanacker,2,0.00013,386364,24.74984,1561077
18225,svaranasi-traderev,2,0.00013,386366,24.74996,1561077
18226,svc-Jenkins-CH,2,0.00013,386368,24.75009,1561077
18227,Sveder,2,0.00013,386370,24.75022,1561077
18228,sven-ke,2,0.00013,386372,24.75035,1561077
18229,SvenRtbg,2,0.00013,386374,24.75048,1561077
18230,SVMK1009,2,0.00013,386376,24.75060,1561077
18231,svvitale,2,0.00013,386378,24.75073,1561077
18232,swamygoud18,2,0.00013,386380,24.75086,1561077
18233,swaragade,2,0.00013,386382,24.75099,1561077
18234,sweavo,2,0.00013,386384,24.75112,1561077
18235,swerenfl,2,0.00013,386386,24.75125,1561077
18236,swigley-TISTA,2,0.00013,386388,24.75137,1561077
18237,swilliz,2,0.00013,386390,24.75150,1561077
18238,swisspol,2,0.00013,386392,24.75163,1561077
18239,swqmaven,2,0.00013,386394,24.75176,1561077
18240,SyCode7,2,0.00013,386396,24.75189,1561077
18241,syedraqib,2,0.00013,386398,24.75201,1561077
18242,sylvain-brun-neotys,2,0.00013,386400,24.75214,1561077
18243,Sylviaxxx,2,0.00013,386402,24.75227,1561077
18244,syncdk,2,0.00013,386404,24.75240,1561077
18245,syouka,2,0.00013,386406,24.75253,1561077
18246,SysEngDan,2,0.00013,386408,24.75265,1561077
18247,syskiller86,2,0.00013,386410,24.75278,1561077
18248,Szasza,2,0.00013,386412,24.75291,1561077
18249,szczepix,2,0.00013,386414,24.75304,1561077
18250,szy54,2,0.00013,386416,24.75317,1561077
18251,T00595,2,0.00013,386418,24.75330,1561077
18252,t0kieu,2,0.00013,386420,24.75342,1561077
18253,T3rm1,2,0.00013,386422,24.75355,1561077
18254,Tabish1991,2,0.00013,386424,24.75368,1561077
18255,ta-Bruce,2,0.00013,386426,24.75381,1561077
18256,tafypz,2,0.00013,386428,24.75394,1561077
18257,tahb,2,0.00013,386430,24.75406,1561077
18258,TalalChaudhry,2,0.00013,386432,24.75419,1561077
18259,talalUcef,2,0.00013,386434,24.75432,1561077
18260,talk2jk,2,0.00013,386436,24.75445,1561077
18261,talkdirty,2,0.00013,386438,24.75458,1561077
18262,tallandtree,2,0.00013,386440,24.75470,1561077
18263,tallaxes,2,0.00013,386442,24.75483,1561077
18264,tallen1983,2,0.00013,386444,24.75496,1561077
18265,tam116,2,0.00013,386446,24.75509,1561077
18266,tamar-moses,2,0.00013,386448,24.75522,1561077
18267,tamasmucs,2,0.00013,386450,24.75535,1561077
18268,tamer-hassan,2,0.00013,386452,24.75547,1561077
18269,tamirble,2,0.00013,386454,24.75560,1561077
18270,Tamoghnasen9,2,0.00013,386456,24.75573,1561077
18271,tandibar,2,0.00013,386458,24.75586,1561077
18272,TangiNokia,2,0.00013,386460,24.75599,1561077
18273,tanishasethii,2,0.00013,386462,24.75611,1561077
18274,tanveer-ali,2,0.00013,386464,24.75624,1561077
18275,tanwald,2,0.00013,386466,24.75637,1561077
18276,tao-zhang,2,0.00013,386468,24.75650,1561077
18277,TaraWij,2,0.00013,386470,24.75663,1561077
18278,tarchan,2,0.00013,386472,24.75675,1561077
18279,Taree7734,2,0.00013,386474,24.75688,1561077
18280,tarekch,2,0.00013,386476,24.75701,1561077
18281,tarree,2,0.00013,386478,24.75714,1561077
18282,Tavisca-Ashish-Vaswani,2,0.00013,386480,24.75727,1561077
18283,tayfunyasar,2,0.00013,386482,24.75740,1561077
18284,taylorbasso,2,0.00013,386484,24.75752,1561077
18285,tayyab23,2,0.00013,386486,24.75765,1561077
18286,Tazminia,2,0.00013,386488,24.75778,1561077
18287,tb3088,2,0.00013,386490,24.75791,1561077
18288,tbekas,2,0.00013,386492,24.75804,1561077
18289,TBFreaq,2,0.00013,386494,24.75816,1561077
18290,tbhi,2,0.00013,386496,24.75829,1561077
18291,TBragi,2,0.00013,386498,24.75842,1561077
18292,tchdp,2,0.00013,386500,24.75855,1561077
18293,tcsabina,2,0.00013,386502,24.75868,1561077
18294,tcuthbert,2,0.00013,386504,24.75880,1561077
18295,techgnosis,2,0.00013,386506,24.75893,1561077
18296,techguane,2,0.00013,386508,24.75906,1561077
18297,techman83,2,0.00013,386510,24.75919,1561077
18298,technocoreai,2,0.00013,386512,24.75932,1561077
18299,TechnoRoss,2,0.00013,386514,24.75944,1561077
18300,techsavvyash,2,0.00013,386516,24.75957,1561077
18301,tech-vsilva,2,0.00013,386518,24.75970,1561077
18302,teeks99,2,0.00013,386520,24.75983,1561077
18303,teewhey,2,0.00013,386522,24.75996,1561077
18304,tehmaspc,2,0.00013,386524,24.76009,1561077
18305,teikitel,2,0.00013,386526,24.76021,1561077
18306,tejesh-unbxd,2,0.00013,386528,24.76034,1561077
18307,tellisnz,2,0.00013,386530,24.76047,1561077
18308,temorfeouz,2,0.00013,386532,24.76060,1561077
18309,ten0s,2,0.00013,386534,24.76073,1561077
18310,tenerd,2,0.00013,386536,24.76085,1561077
18311,tenwit,2,0.00013,386538,24.76098,1561077
18312,tenyo,2,0.00013,386540,24.76111,1561077
18313,teragoon,2,0.00013,386542,24.76124,1561077
18314,Terentio,2,0.00013,386544,24.76137,1561077
18315,terryyin,2,0.00013,386546,24.76149,1561077
18316,testfixer,2,0.00013,386548,24.76162,1561077
18317,testtest1234test,2,0.00013,386550,24.76175,1561077
18318,Tetnacious,2,0.00013,386552,24.76188,1561077
18319,tettaji,2,0.00013,386554,24.76201,1561077
18320,teyamagu,2,0.00013,386556,24.76214,1561077
18321,tflprogrammer,2,0.00013,386558,24.76226,1561077
18322,tfoote,2,0.00013,386560,24.76239,1561077
18323,tgandrews,2,0.00013,386562,24.76252,1561077
18324,tgjonestx,2,0.00013,386564,24.76265,1561077
18325,tg-m,2,0.00013,386566,24.76278,1561077
18326,tgravestijn,2,0.00013,386568,24.76290,1561077
18327,tgray-hrg,2,0.00013,386570,24.76303,1561077
18328,tguelck,2,0.00013,386572,24.76316,1561077
18329,th3br0,2,0.00013,386574,24.76329,1561077
18330,thadguidry,2,0.00013,386576,24.76342,1561077
18331,Thadir,2,0.00013,386578,24.76354,1561077
18332,thaentzler,2,0.00013,386580,24.76367,1561077
18333,thaitzer,2,0.00013,386582,24.76380,1561077
18334,thajith,2,0.00013,386584,24.76393,1561077
18335,thanatgo123,2,0.00013,386586,24.76406,1561077
18336,thatguyjono94,2,0.00013,386588,24.76419,1561077
18337,Thearas,2,0.00013,386590,24.76431,1561077
18338,thebeanogamer,2,0.00013,386592,24.76444,1561077
18339,TheBrunoLopes,2,0.00013,386594,24.76457,1561077
18340,theCampbell,2,0.00013,386596,24.76470,1561077
18341,thecere,2,0.00013,386598,24.76483,1561077
18342,ThedaChi,2,0.00013,386600,24.76495,1561077
18343,thedonvaughn,2,0.00013,386602,24.76508,1561077
18344,thefron,2,0.00013,386604,24.76521,1561077
18345,thefueley,2,0.00013,386606,24.76534,1561077
18346,thegalah,2,0.00013,386608,24.76547,1561077
18347,thegolabek,2,0.00013,386610,24.76559,1561077
18348,theHackPot,2,0.00013,386612,24.76572,1561077
18349,theiamdude,2,0.00013,386614,24.76585,1561077
18350,thejasonfunderburker,2,0.00013,386616,24.76598,1561077
18351,TheKangaroo,2,0.00013,386618,24.76611,1561077
18352,TheKrush,2,0.00013,386620,24.76624,1561077
18353,TheLeftHandOfGod,2,0.00013,386622,24.76636,1561077
18354,the-little-red,2,0.00013,386624,24.76649,1561077
18355,thellef,2,0.00013,386626,24.76662,1561077
18356,TheLonelyGhost,2,0.00013,386628,24.76675,1561077
18357,Themesaul,2,0.00013,386630,24.76688,1561077
18358,theminecoder,2,0.00013,386632,24.76700,1561077
18359,TheodorAtBud,2,0.00013,386634,24.76713,1561077
18360,theomathieubhvr,2,0.00013,386636,24.76726,1561077
18361,theosotr,2,0.00013,386638,24.76739,1561077
18362,TheRaspyDev,2,0.00013,386640,24.76752,1561077
18363,TheSlowGrowth,2,0.00013,386642,24.76764,1561077
18364,TheStrix,2,0.00013,386644,24.76777,1561077
18365,thewtex,2,0.00013,386646,24.76790,1561077
18366,theycallmeninx,2,0.00013,386648,24.76803,1561077
18367,thiago-destro,2,0.00013,386650,24.76816,1561077
18368,Thilagakumar,2,0.00013,386652,24.76828,1561077
18369,Thirtymonday,2,0.00013,386654,24.76841,1561077
18370,thisismana,2,0.00013,386656,24.76854,1561077
18371,ThomasBower,2,0.00013,386658,24.76867,1561077
18372,thomasjyoung,2,0.00013,386660,24.76880,1561077
18373,thomasmatzke,2,0.00013,386662,24.76893,1561077
18374,ThomasPatzig,2,0.00013,386664,24.76905,1561077
18375,thomastruongsb,2,0.00013,386666,24.76918,1561077
18376,ThrashAbaddon,2,0.00013,386668,24.76931,1561077
18377,thsmi,2,0.00013,386670,24.76944,1561077
18378,thycotic-rd,2,0.00013,386672,24.76957,1561077
18379,ThyRex,2,0.00013,386674,24.76969,1561077
18380,tiagolo,2,0.00013,386676,24.76982,1561077
18381,tianbao666,2,0.00013,386678,24.76995,1561077
18382,tiandong19860806,2,0.00013,386680,24.77008,1561077
18383,tianmaofu,2,0.00013,386682,24.77021,1561077
18384,tianya2010,2,0.00013,386684,24.77033,1561077
18385,TiberiusSoanea,2,0.00013,386686,24.77046,1561077
18386,Tibingeo,2,0.00013,386688,24.77059,1561077
18387,tienju,2,0.00013,386690,24.77072,1561077
18388,tifhorn,2,0.00013,386692,24.77085,1561077
18389,tijuj,2,0.00013,386694,24.77098,1561077
18390,tilosp,2,0.00013,386696,24.77110,1561077
18391,time4tea,2,0.00013,386698,24.77123,1561077
18392,timesking,2,0.00013,386700,24.77136,1561077
18393,timlevett,2,0.00013,386702,24.77149,1561077
18394,timmy8526,2,0.00013,386704,24.77162,1561077
18395,timoa,2,0.00013,386706,24.77174,1561077
18396,TimoFrye,2,0.00013,386708,24.77187,1561077
18397,timogroeger,2,0.00013,386710,24.77200,1561077
18398,timosmit,2,0.00013,386712,24.77213,1561077
18399,TimothyChilvers,2,0.00013,386714,24.77226,1561077
18400,tim-pl-m,2,0.00013,386716,24.77238,1561077
18401,tim-reslv,2,0.00013,386718,24.77251,1561077
18402,timReynolds,2,0.00013,386720,24.77264,1561077
18403,timvahlbrock,2,0.00013,386722,24.77277,1561077
18404,tingstad,2,0.00013,386724,24.77290,1561077
18405,tinmarino,2,0.00013,386726,24.77303,1561077
18406,Tin-Nguyen,2,0.00013,386728,24.77315,1561077
18407,tinypulse-juanma,2,0.00013,386730,24.77328,1561077
18408,tinyRatP,2,0.00013,386732,24.77341,1561077
18409,tiqbal2,2,0.00013,386734,24.77354,1561077
18410,Tirex,2,0.00013,386736,24.77367,1561077
18411,tito1982,2,0.00013,386738,24.77379,1561077
18412,titogeorge,2,0.00013,386740,24.77392,1561077
18413,tiwari85aman,2,0.00013,386742,24.77405,1561077
18414,tjaartvdwalt,2,0.00013,386744,24.77418,1561077
18415,tjallingran,2,0.00013,386746,24.77431,1561077
18416,tjanez,2,0.00013,386748,24.77443,1561077
18417,tjeske,2,0.00013,386750,24.77456,1561077
18418,t-j-f,2,0.00013,386752,24.77469,1561077
18419,tjramos,2,0.00013,386754,24.77482,1561077
18420,tjsail33,2,0.00013,386756,24.77495,1561077
18421,tkemperSonatype,2,0.00013,386758,24.77508,1561077
18422,TKhardekar,2,0.00013,386760,24.77520,1561077
18423,Tkilleiro,2,0.00013,386762,24.77533,1561077
18424,tkluza,2,0.00013,386764,24.77546,1561077
18425,tlbueno,2,0.00013,386766,24.77559,1561077
18426,tlkamp,2,0.00013,386768,24.77572,1561077
18427,tlvu,2,0.00013,386770,24.77584,1561077
18428,tmaas22,2,0.00013,386772,24.77597,1561077
18429,tmarcuzz,2,0.00013,386774,24.77610,1561077
18430,tmhall99,2,0.00013,386776,24.77623,1561077
18431,tmiseikis,2,0.00013,386778,24.77636,1561077
18432,tmons,2,0.00013,386780,24.77648,1561077
18433,tmuldoon,2,0.00013,386782,24.77661,1561077
18434,tnguyen1,2,0.00013,386784,24.77674,1561077
18435,tngwoerleij,2,0.00013,386786,24.77687,1561077
18436,tnunes,2,0.00013,386788,24.77700,1561077
18437,toanlakaplan,2,0.00013,386790,24.77713,1561077
18438,tobiasbaum,2,0.00013,386792,24.77725,1561077
18439,tobiasrodestock,2,0.00013,386794,24.77738,1561077
18440,tobiasstraub,2,0.00013,386796,24.77751,1561077
18441,tobias-trabelsi-sonarsource,2,0.00013,386798,24.77764,1561077
18442,tobyjoe,2,0.00013,386800,24.77777,1561077
18443,tobyw4n,2,0.00013,386802,24.77789,1561077
18444,toericliou,2,0.00013,386804,24.77802,1561077
18445,tojatos,2,0.00013,386806,24.77815,1561077
18446,to-kra,2,0.00013,386808,24.77828,1561077
18447,tolivia,2,0.00013,386810,24.77841,1561077
18448,TomAndrews,2,0.00013,386812,24.77853,1561077
18449,tomasbrod,2,0.00013,386814,24.77866,1561077
18450,tomascassidy,2,0.00013,386816,24.77879,1561077
18451,tomascea,2,0.00013,386818,24.77892,1561077
18452,tomaskra,2,0.00013,386820,24.77905,1561077
18453,tomasyany,2,0.00013,386822,24.77917,1561077
18454,tomb50,2,0.00013,386824,24.77930,1561077
18455,tombarber,2,0.00013,386826,24.77943,1561077
18456,tomcsmith1990,2,0.00013,386828,24.77956,1561077
18457,tomdev,2,0.00013,386830,24.77969,1561077
18458,tomek-d,2,0.00013,386832,24.77982,1561077
18459,tomekjarosik,2,0.00013,386834,24.77994,1561077
18460,tomfun,2,0.00013,386836,24.78007,1561077
18461,tomgonzo,2,0.00013,386838,24.78020,1561077
18462,TomH54321,2,0.00013,386840,24.78033,1561077
18463,tomrj,2,0.00013,386842,24.78046,1561077
18464,Tomschi,2,0.00013,386844,24.78058,1561077
18465,tomstockton,2,0.00013,386846,24.78071,1561077
18466,tomvin6,2,0.00013,386848,24.78084,1561077
18467,Tomy2e,2,0.00013,386850,24.78097,1561077
18468,tomzeller,2,0.00013,386852,24.78110,1561077
18469,tonmoy1996,2,0.00013,386854,24.78122,1561077
18470,TonyApuzzo,2,0.00013,386856,24.78135,1561077
18471,tonymadbrain,2,0.00013,386858,24.78148,1561077
18472,tonyppe,2,0.00013,386860,24.78161,1561077
18473,toomasveromann,2,0.00013,386862,24.78174,1561077
18474,topia,2,0.00013,386864,24.78187,1561077
18475,topijag,2,0.00013,386866,24.78199,1561077
18476,topproto,2,0.00013,386868,24.78212,1561077
18477,torbjoernk,2,0.00013,386870,24.78225,1561077
18478,torblerone,2,0.00013,386872,24.78238,1561077
18479,TorstenKruse,2,0.00013,386874,24.78251,1561077
18480,tortila,2,0.00013,386876,24.78263,1561077
18481,ToShared,2,0.00013,386878,24.78276,1561077
18482,totterfree,2,0.00013,386880,24.78289,1561077
18483,touseefspeaks,2,0.00013,386882,24.78302,1561077
18484,Touseefyousuf,2,0.00013,386884,24.78315,1561077
18485,touting15,2,0.00013,386886,24.78327,1561077
18486,towithyou,2,0.00013,386888,24.78340,1561077
18487,toxsick,2,0.00013,386890,24.78353,1561077
18488,tozzil,2,0.00013,386892,24.78366,1561077
18489,t-persson,2,0.00013,386894,24.78379,1561077
18490,tpl-eugenerebong,2,0.00013,386896,24.78392,1561077
18491,tpulmano,2,0.00013,386898,24.78404,1561077
18492,tr00st,2,0.00013,386900,24.78417,1561077
18493,trajano,2,0.00013,386902,24.78430,1561077
18494,trantuyen,2,0.00013,386904,24.78443,1561077
18495,traviseret,2,0.00013,386906,24.78456,1561077
18496,travisofthenorth,2,0.00013,386908,24.78468,1561077
18497,travisreed-wf,2,0.00013,386910,24.78481,1561077
18498,traviswalker26,2,0.00013,386912,24.78494,1561077
18499,travisyeh,2,0.00013,386914,24.78507,1561077
18500,treaves,2,0.00013,386916,24.78520,1561077
18501,TreeKat71,2,0.00013,386918,24.78532,1561077
18502,trenchm,2,0.00013,386920,24.78545,1561077
18503,trent-abc,2,0.00013,386922,24.78558,1561077
18504,trevcor,2,0.00013,386924,24.78571,1561077
18505,Trey-O,2,0.00013,386926,24.78584,1561077
18506,trgill,2,0.00013,386928,24.78597,1561077
18507,Tri0L,2,0.00013,386930,24.78609,1561077
18508,Tridacnid,2,0.00013,386932,24.78622,1561077
18509,trident-job,2,0.00013,386934,24.78635,1561077
18510,triesz,2,0.00013,386936,24.78648,1561077
18511,Trinadh4269,2,0.00013,386938,24.78661,1561077
18512,tristanmcpherson,2,0.00013,386940,24.78673,1561077
18513,TrojIhor,2,0.00013,386942,24.78686,1561077
18514,trollcodelord,2,0.00013,386944,24.78699,1561077
18515,trombik,2,0.00013,386946,24.78712,1561077
18516,trose67,2,0.00013,386948,24.78725,1561077
18517,trotro,2,0.00013,386950,24.78737,1561077
18518,troy2troy,2,0.00013,386952,24.78750,1561077
18519,TroyLi96,2,0.00013,386954,24.78763,1561077
18520,trungnguyenv,2,0.00013,386956,24.78776,1561077
18521,truumaa,2,0.00013,386958,24.78789,1561077
18522,trwicks,2,0.00013,386960,24.78801,1561077
18523,trydydd,2,0.00013,386962,24.78814,1561077
18524,tsantos,2,0.00013,386964,24.78827,1561077
18525,tschechniker,2,0.00013,386966,24.78840,1561077
18526,tschutte,2,0.00013,386968,24.78853,1561077
18527,ts-dang,2,0.00013,386970,24.78866,1561077
18528,ts-huyao,2,0.00013,386972,24.78878,1561077
18529,Tsingshen,2,0.00013,386974,24.78891,1561077
18530,tstmrk,2,0.00013,386976,24.78904,1561077
18531,tstrul1,2,0.00013,386978,24.78917,1561077
18532,tsunamaru,2,0.00013,386980,24.78930,1561077
18533,tsutsarin,2,0.00013,386982,24.78942,1561077
18534,ttat,2,0.00013,386984,24.78955,1561077
18535,ttoso,2,0.00013,386986,24.78968,1561077
18536,ttyniwa,2,0.00013,386988,24.78981,1561077
18537,tucha1992,2,0.00013,386990,24.78994,1561077
18538,tuct,2,0.00013,386992,24.79006,1561077
18539,tudortimi,2,0.00013,386994,24.79019,1561077
18540,tueksta,2,0.00013,386996,24.79032,1561077
18541,tukak,2,0.00013,386998,24.79045,1561077
18542,Tumerskiy,2,0.00013,387000,24.79058,1561077
18543,TurboLuke,2,0.00013,387002,24.79071,1561077
18544,turekg,2,0.00013,387004,24.79083,1561077
18545,tushabe,2,0.00013,387006,24.79096,1561077
18546,tuvoksg1,2,0.00013,387008,24.79109,1561077
18547,tuxknight,2,0.00013,387010,24.79122,1561077
18548,tvk-works,2,0.00013,387012,24.79135,1561077
18549,Twiknight,2,0.00013,387014,24.79147,1561077
18550,tworec,2,0.00013,387016,24.79160,1561077
18551,TwoSlick,2,0.00013,387018,24.79173,1561077
18552,twu8,2,0.00013,387020,24.79186,1561077
18553,typeness,2,0.00013,387022,24.79199,1561077
18554,TyPetrochko,2,0.00013,387024,24.79211,1561077
18555,tyrius02,2,0.00013,387026,24.79224,1561077
18556,tyroneleyland,2,0.00013,387028,24.79237,1561077
18557,Tyson1986,2,0.00013,387030,24.79250,1561077
18558,tzender2,2,0.00013,387032,24.79263,1561077
18559,tzkoshi,2,0.00013,387034,24.79276,1561077
18560,u6f6o,2,0.00013,387036,24.79288,1561077
18561,ubellavance,2,0.00013,387038,24.79301,1561077
18562,ucemyuksel,2,0.00013,387040,24.79314,1561077
18563,uded,2,0.00013,387042,24.79327,1561077
18564,udev,2,0.00013,387044,24.79340,1561077
18565,udigot,2,0.00013,387046,24.79352,1561077
18566,udit04,2,0.00013,387048,24.79365,1561077
18567,udit249,2,0.00013,387050,24.79378,1561077
18568,ujjwalkhare11,2,0.00013,387052,24.79391,1561077
18569,ujwalparker,2,0.00013,387054,24.79404,1561077
18570,UladzimirSemiankou,2,0.00013,387056,24.79416,1561077
18571,ulope,2,0.00013,387058,24.79429,1561077
18572,umarbhatti1,2,0.00013,387060,24.79442,1561077
18573,unalterable,2,0.00013,387062,24.79455,1561077
18574,undron,2,0.00013,387064,24.79468,1561077
18575,Unit2MBailey,2,0.00013,387066,24.79481,1561077
18576,unixhat,2,0.00013,387068,24.79493,1561077
18577,updong,2,0.00013,387070,24.79506,1561077
18578,urdangarin,2,0.00013,387072,24.79519,1561077
18579,UrosGligovic,2,0.00013,387074,24.79532,1561077
18580,urosorolicki,2,0.00013,387076,24.79545,1561077
18581,username12,2,0.00013,387078,24.79557,1561077
18582,ushachar,2,0.00013,387080,24.79570,1561077
18583,ushasm,2,0.00013,387082,24.79583,1561077
18584,usinelogicielle-cnes,2,0.00013,387084,24.79596,1561077
18585,usmichael,2,0.00013,387086,24.79609,1561077
18586,USSX-Hares,2,0.00013,387088,24.79621,1561077
18587,usvgmani,2,0.00013,387090,24.79634,1561077
18588,UtkarshChaurasia,2,0.00013,387092,24.79647,1561077
18589,utkarshsaxena93,2,0.00013,387094,24.79660,1561077
18590,uttamk,2,0.00013,387096,24.79673,1561077
18591,Uva-Vj,2,0.00013,387098,24.79685,1561077
18592,uwolfer,2,0.00013,387100,24.79698,1561077
18593,UzK98fYoE,2,0.00013,387102,24.79711,1561077
18594,V1Ct0RHMz,2,0.00013,387104,24.79724,1561077
18595,vad1m,2,0.00013,387106,24.79737,1561077
18596,vadimiv,2,0.00013,387108,24.79750,1561077
18597,valemany,2,0.00013,387110,24.79762,1561077
18598,Valeronlol,2,0.00013,387112,24.79775,1561077
18599,valerypiotukh,2,0.00013,387114,24.79788,1561077
18600,valeryq,2,0.00013,387116,24.79801,1561077
18601,VamsiKrishna178925,2,0.00013,387118,24.79814,1561077
18602,vankhoa011,2,0.00013,387120,24.79826,1561077
18603,vanniktech,2,0.00013,387122,24.79839,1561077
18604,vanpt1114,2,0.00013,387124,24.79852,1561077
18605,var23rav,2,0.00013,387126,24.79865,1561077
18606,varyumin,2,0.00013,387128,24.79878,1561077
18607,vasi-grigo,2,0.00013,387130,24.79890,1561077
18608,vasilievip,2,0.00013,387132,24.79903,1561077
18609,vasiliyb,2,0.00013,387134,24.79916,1561077
18610,vastenly,2,0.00013,387136,24.79929,1561077
18611,Vatsaldhar26,2,0.00013,387138,24.79942,1561077
18612,vbaidak,2,0.00013,387140,24.79955,1561077
18613,vbansal22,2,0.00013,387142,24.79967,1561077
18614,vbarba,2,0.00013,387144,24.79980,1561077
18615,vbricard,2,0.00013,387146,24.79993,1561077
18616,vbronfman,2,0.00013,387148,24.80006,1561077
18617,vbskruger,2,0.00013,387150,24.80019,1561077
18618,vcargats,2,0.00013,387152,24.80031,1561077
18619,vchrisb,2,0.00013,387154,24.80044,1561077
18620,vctvg,2,0.00013,387156,24.80057,1561077
18621,vectorcatch,2,0.00013,387158,24.80070,1561077
18622,Veena-C,2,0.00013,387160,24.80083,1561077
18623,VeerendraY,2,0.00013,387162,24.80095,1561077
18624,velith,2,0.00013,387164,24.80108,1561077
18625,veniciobsb,2,0.00013,387166,24.80121,1561077
18626,venkatd4u,2,0.00013,387168,24.80134,1561077
18627,venkatprasad33,2,0.00013,387170,24.80147,1561077
18628,venkatreddyjanga,2,0.00013,387172,24.80160,1561077
18629,verath,2,0.00013,387174,24.80172,1561077
18630,verbitan,2,0.00013,387176,24.80185,1561077
18631,verbruggenalex,2,0.00013,387178,24.80198,1561077
18632,verokarhu,2,0.00013,387180,24.80211,1561077
18633,vevoVT,2,0.00013,387182,24.80224,1561077
18634,vgunda,2,0.00013,387184,24.80236,1561077
18635,vhag9524,2,0.00013,387186,24.80249,1561077
18636,vickleford,2,0.00013,387188,24.80262,1561077
18637,vicluy,2,0.00013,387190,24.80275,1561077
18638,vicpadilla,2,0.00013,387192,24.80288,1561077
18639,VictorBjelkholm,2,0.00013,387194,24.80300,1561077
18640,VictorCabello,2,0.00013,387196,24.80313,1561077
18641,victor-homedepot,2,0.00013,387198,24.80326,1561077
18642,vidhya03,2,0.00013,387200,24.80339,1561077
18643,vidplace7,2,0.00013,387202,24.80352,1561077
18644,vietnguyen1254,2,0.00013,387204,24.80365,1561077
18645,vijaymateti,2,0.00013,387206,24.80377,1561077
18646,vikaskoppineedi,2,0.00013,387208,24.80390,1561077
18647,vikram-amnic,2,0.00013,387210,24.80403,1561077
18648,vikramarsid,2,0.00013,387212,24.80416,1561077
18649,vimallearnz,2,0.00013,387214,24.80429,1561077
18650,vinayan3,2,0.00013,387216,24.80441,1561077
18651,vinaygowda3,2,0.00013,387218,24.80454,1561077
18652,vincentballet,2,0.00013,387220,24.80467,1561077
18653,vincentdaniel,2,0.00013,387222,24.80480,1561077
18654,VincentDeHaen,2,0.00013,387224,24.80493,1561077
18655,vincentgerris,2,0.00013,387226,24.80505,1561077
18656,vincentkok,2,0.00013,387228,24.80518,1561077
18657,vincentkwok2021,2,0.00013,387230,24.80531,1561077
18658,vincent-r-kennedy,2,0.00013,387232,24.80544,1561077
18659,Vincevrp,2,0.00013,387234,24.80557,1561077
18660,vineetmittal83,2,0.00013,387236,24.80570,1561077
18661,vinhtvu2,2,0.00013,387238,24.80582,1561077
18662,viniagostini,2,0.00013,387240,24.80595,1561077
18663,vinicius-solon-silva,2,0.00013,387242,24.80608,1561077
18664,vinnyvinny1989,2,0.00013,387244,24.80621,1561077
18665,VinothBalakrish,2,0.00013,387246,24.80634,1561077
18666,vinsgithub,2,0.00013,387248,24.80646,1561077
18667,viola827,2,0.00013,387250,24.80659,1561077
18668,violinner,2,0.00013,387252,24.80672,1561077
18669,vipinnambiar,2,0.00013,387254,24.80685,1561077
18670,VirginiaMesa,2,0.00013,387256,24.80698,1561077
18671,Virtlink,2,0.00013,387258,24.80710,1561077
18672,Vishal5960,2,0.00013,387260,24.80723,1561077
18673,vishalcloudyuga,2,0.00013,387262,24.80736,1561077
18674,vishalraina,2,0.00013,387264,24.80749,1561077
18675,vishnuvardhan26,2,0.00013,387266,24.80762,1561077
18676,vishwasbabhare,2,0.00013,387268,24.80774,1561077
18677,visteras,2,0.00013,387270,24.80787,1561077
18678,visual901,2,0.00013,387272,24.80800,1561077
18679,vital4ik,2,0.00013,387274,24.80813,1561077
18680,vitalyvoronovmf,2,0.00013,387276,24.80826,1561077
18681,vitjok27,2,0.00013,387278,24.80839,1561077
18682,VitorVRS,2,0.00013,387280,24.80851,1561077
18683,vitvitvit,2,0.00013,387282,24.80864,1561077
18684,Vity01,2,0.00013,387284,24.80877,1561077
18685,vivekburman,2,0.00013,387286,24.80890,1561077
18686,vivekkurhe05,2,0.00013,387288,24.80903,1561077
18687,vividly789,2,0.00013,387290,24.80915,1561077
18688,v-karbovnichy,2,0.00013,387292,24.80928,1561077
18689,vkvamsiopsmx,2,0.00013,387294,24.80941,1561077
18690,vladdu,2,0.00013,387296,24.80954,1561077
18691,vladi14,2,0.00013,387298,24.80967,1561077
18692,vladimirf7,2,0.00013,387300,24.80979,1561077
18693,VladimirKovac-FS,2,0.00013,387302,24.80992,1561077
18694,vladrolandomihai,2,0.00013,387304,24.81005,1561077
18695,vl-shopback,2,0.00013,387306,24.81018,1561077
18696,vlukash,2,0.00013,387308,24.81031,1561077
18697,vmicrodev,2,0.00013,387310,24.81044,1561077
18698,vnicolev,2,0.00013,387312,24.81056,1561077
18699,vnonchev-mentormate,2,0.00013,387314,24.81069,1561077
18700,vogelinho10,2,0.00013,387316,24.81082,1561077
18701,voidfiles,2,0.00013,387318,24.81095,1561077
18702,volbobvol,2,0.00013,387320,24.81108,1561077
18703,voloxastik,2,0.00013,387322,24.81120,1561077
18704,VonNaturAustreVe,2,0.00013,387324,24.81133,1561077
18705,vorian,2,0.00013,387326,24.81146,1561077
18706,Vormillion,2,0.00013,387328,24.81159,1561077
18707,Voskov,2,0.00013,387330,24.81172,1561077
18708,vovad,2,0.00013,387332,24.81184,1561077
18709,vpertj,2,0.00013,387334,24.81197,1561077
18710,vpolisetti,2,0.00013,387336,24.81210,1561077
18711,vrnsky,2,0.00013,387338,24.81223,1561077
18712,vrosca,2,0.00013,387340,24.81236,1561077
18713,vrozkovec,2,0.00013,387342,24.81249,1561077
18714,vshih,2,0.00013,387344,24.81261,1561077
18715,vunguyenhung,2,0.00013,387346,24.81274,1561077
18716,vuthanhhai2904,2,0.00013,387348,24.81287,1561077
18717,Vv123456789,2,0.00013,387350,24.81300,1561077
18718,vvchistyakov,2,0.00013,387352,24.81313,1561077
18719,vx-github,2,0.00013,387354,24.81325,1561077
18720,vyas-n,2,0.00013,387356,24.81338,1561077
18721,w2a,2,0.00013,387358,24.81351,1561077
18722,wadexu007,2,0.00013,387360,24.81364,1561077
18723,wagnjun,2,0.00013,387362,24.81377,1561077
18724,walcomel199,2,0.00013,387364,24.81389,1561077
18725,walker0921,2,0.00013,387366,24.81402,1561077
18726,walkingpendulum,2,0.00013,387368,24.81415,1561077
18727,Walther,2,0.00013,387370,24.81428,1561077
18728,wanare-2017,2,0.00013,387372,24.81441,1561077
18729,wanderleyteixeira,2,0.00013,387374,24.81454,1561077
18730,wangbing35,2,0.00013,387376,24.81466,1561077
18731,Wang-ha0,2,0.00013,387378,24.81479,1561077
18732,wangm23456,2,0.00013,387380,24.81492,1561077
18733,wangold5,2,0.00013,387382,24.81505,1561077
18734,WangShuangQuan-A,2,0.00013,387384,24.81518,1561077
18735,wangwj,2,0.00013,387386,24.81530,1561077
18736,wangyf2010,2,0.00013,387388,24.81543,1561077
18737,WaqarTabish2807,2,0.00013,387390,24.81556,1561077
18738,warandpeace,2,0.00013,387392,24.81569,1561077
18739,wardAndrew,2,0.00013,387394,24.81582,1561077
18740,wardviaene,2,0.00013,387396,24.81594,1561077
18741,warhod,2,0.00013,387398,24.81607,1561077
18742,warnyul,2,0.00013,387400,24.81620,1561077
18743,warrickhill,2,0.00013,387402,24.81633,1561077
18744,washeck,2,0.00013,387404,24.81646,1561077
18745,wawashra,2,0.00013,387406,24.81658,1561077
18746,wawelover,2,0.00013,387408,24.81671,1561077
18747,waylon-edmodo,2,0.00013,387410,24.81684,1561077
18748,Wayne-Liu,2,0.00013,387412,24.81697,1561077
18749,waynenelson,2,0.00013,387414,24.81710,1561077
18750,wayneseymour,2,0.00013,387416,24.81723,1561077
18751,Wayonb,2,0.00013,387418,24.81735,1561077
18752,wblair-ebsco,2,0.00013,387420,24.81748,1561077
18753,wczqll,2,0.00013,387422,24.81761,1561077
18754,weiguang1017,2,0.00013,387424,24.81774,1561077
18755,weiliango,2,0.00013,387426,24.81787,1561077
18756,weinmannd,2,0.00013,387428,24.81799,1561077
18757,weinrich15,2,0.00013,387430,24.81812,1561077
18758,wei-qiang,2,0.00013,387432,24.81825,1561077
18759,weirded,2,0.00013,387434,24.81838,1561077
18760,wernla,2,0.00013,387436,24.81851,1561077
18761,westbywest,2,0.00013,387438,24.81863,1561077
18762,westlakem,2,0.00013,387440,24.81876,1561077
18763,wetest3159,2,0.00013,387442,24.81889,1561077
18764,w-gates,2,0.00013,387444,24.81902,1561077
18765,Whalesharkking,2,0.00013,387446,24.81915,1561077
18766,whatdon,2,0.00013,387448,24.81928,1561077
18767,whifix,2,0.00013,387450,24.81940,1561077
18768,whimboo,2,0.00013,387452,24.81953,1561077
18769,whizzosoftware,2,0.00013,387454,24.81966,1561077
18770,wiccan2,2,0.00013,387456,24.81979,1561077
18771,wickett,2,0.00013,387458,24.81992,1561077
18772,wickkidd,2,0.00013,387460,24.82004,1561077
18773,wied03,2,0.00013,387462,24.82017,1561077
18774,WildSaCk,2,0.00013,387464,24.82030,1561077
18775,willaerk,2,0.00013,387466,24.82043,1561077
18776,willdavidwarren,2,0.00013,387468,24.82056,1561077
18777,willharris,2,0.00013,387470,24.82068,1561077
18778,william76,2,0.00013,387472,24.82081,1561077
18779,WilliamBehrens,2,0.00013,387474,24.82094,1561077
18780,WilliamBerryiii,2,0.00013,387476,24.82107,1561077
18781,william-monroy,2,0.00013,387478,24.82120,1561077
18782,william-will-angi,2,0.00013,387480,24.82133,1561077
18783,williamzhao87,2,0.00013,387482,24.82145,1561077
18784,willwolfram18,2,0.00013,387484,24.82158,1561077
18785,willysamz,2,0.00013,387486,24.82171,1561077
18786,wilsoc5,2,0.00013,387488,24.82184,1561077
18787,wingedfox,2,0.00013,387490,24.82197,1561077
18788,Wingjam,2,0.00013,387492,24.82209,1561077
18789,winternorth,2,0.00013,387494,24.82222,1561077
18790,witold-gren,2,0.00013,387496,24.82235,1561077
18791,wityamin,2,0.00013,387498,24.82248,1561077
18792,wjymtg,2,0.00013,387500,24.82261,1561077
18793,wkok,2,0.00013,387502,24.82273,1561077
18794,wkonsek,2,0.00013,387504,24.82286,1561077
18795,wliao008,2,0.00013,387506,24.82299,1561077
18796,wm-khurrum-mujeeb,2,0.00013,387508,24.82312,1561077
18797,wmontgomery-splunk,2,0.00013,387510,24.82325,1561077
18798,woile,2,0.00013,387512,24.82338,1561077
18799,wojciechzachwieja,2,0.00013,387514,24.82350,1561077
18800,Wolfe1,2,0.00013,387516,24.82363,1561077
18801,wollsi,2,0.00013,387518,24.82376,1561077
18802,wonderphil,2,0.00013,387520,24.82389,1561077
18803,woniuzhang,2,0.00013,387522,24.82402,1561077
18804,woodongwong,2,0.00013,387524,24.82414,1561077
18805,woodspeed,2,0.00013,387526,24.82427,1561077
18806,woodywei,2,0.00013,387528,24.82440,1561077
18807,woogie-wolgemuth,2,0.00013,387530,24.82453,1561077
18808,WorkHorseIndustries,2,0.00013,387532,24.82466,1561077
18809,worldcompass,2,0.00013,387534,24.82478,1561077
18810,wosc,2,0.00013,387536,24.82491,1561077
18811,wpieters,2,0.00013,387538,24.82504,1561077
18812,wrightm,2,0.00013,387540,24.82517,1561077
18813,ws1088,2,0.00013,387542,24.82530,1561077
18814,wschomburg,2,0.00013,387544,24.82543,1561077
18815,wsszh,2,0.00013,387546,24.82555,1561077
18816,wstrox,2,0.00013,387548,24.82568,1561077
18817,wtnebel,2,0.00013,387550,24.82581,1561077
18818,wudidehuangtiandi,2,0.00013,387552,24.82594,1561077
18819,wuhao-ouyang,2,0.00013,387554,24.82607,1561077
18820,wukq,2,0.00013,387556,24.82619,1561077
18821,Wulkop,2,0.00013,387558,24.82632,1561077
18822,wunderabt,2,0.00013,387560,24.82645,1561077
18823,wupeng1988,2,0.00013,387562,24.82658,1561077
18824,wushuzh,2,0.00013,387564,24.82671,1561077
18825,wwftw,2,0.00013,387566,24.82683,1561077
18826,wwojdanowski,2,0.00013,387568,24.82696,1561077
18827,wxxiong6,2,0.00013,387570,24.82709,1561077
18828,wybczu,2,0.00013,387572,24.82722,1561077
18829,wynet321,2,0.00013,387574,24.82735,1561077
18830,wypnnewbie,2,0.00013,387576,24.82747,1561077
18831,wysockim,2,0.00013,387578,24.82760,1561077
18832,wzcwts521,2,0.00013,387580,24.82773,1561077
18833,wzyboy,2,0.00013,387582,24.82786,1561077
18834,x0randgat3,2,0.00013,387584,24.82799,1561077
18835,x1989z,2,0.00013,387586,24.82812,1561077
18836,x3ntrix,2,0.00013,387588,24.82824,1561077
18837,x418,2,0.00013,387590,24.82837,1561077
18838,xalbillos,2,0.00013,387592,24.82850,1561077
18839,xaxa06,2,0.00013,387594,24.82863,1561077
18840,xbsd-nikolay,2,0.00013,387596,24.82876,1561077
18841,Xenius97,2,0.00013,387598,24.82888,1561077
18842,Xephi,2,0.00013,387600,24.82901,1561077
18843,xer0x,2,0.00013,387602,24.82914,1561077
18844,xetra11,2,0.00013,387604,24.82927,1561077
18845,xhaggi,2,0.00013,387606,24.82940,1561077
18846,xhappy,2,0.00013,387608,24.82952,1561077
18847,xhuichen,2,0.00013,387610,24.82965,1561077
18848,xiangyu5945,2,0.00013,387612,24.82978,1561077
18849,xiaolongli827,2,0.00013,387614,24.82991,1561077
18850,XiaoMuYi,2,0.00013,387616,24.83004,1561077
18851,xiaosazixian,2,0.00013,387618,24.83017,1561077
18852,xiaoxuetu,2,0.00013,387620,24.83029,1561077
18853,xicubed,2,0.00013,387622,24.83042,1561077
18854,XinfinityoO,2,0.00013,387624,24.83055,1561077
18855,xingyuzhe,2,0.00013,387626,24.83068,1561077
18856,xinsir88,2,0.00013,387628,24.83081,1561077
18857,Xinyan272,2,0.00013,387630,24.83093,1561077
18858,xiyutao,2,0.00013,387632,24.83106,1561077
18859,xjliang2007,2,0.00013,387634,24.83119,1561077
18860,xJom,2,0.00013,387636,24.83132,1561077
18861,xkobal,2,0.00013,387638,24.83145,1561077
18862,xKostyan,2,0.00013,387640,24.83157,1561077
18863,XmiliaH,2,0.00013,387642,24.83170,1561077
18864,xoleja01,2,0.00013,387644,24.83183,1561077
18865,xorgnz,2,0.00013,387646,24.83196,1561077
18866,xpepper,2,0.00013,387648,24.83209,1561077
18867,XQDD,2,0.00013,387650,24.83222,1561077
18868,xspynks,2,0.00013,387652,24.83234,1561077
18869,xtang,2,0.00013,387654,24.83247,1561077
18870,xuhuijun,2,0.00013,387656,24.83260,1561077
18871,xussof,2,0.00013,387658,24.83273,1561077
18872,xx1501xx,2,0.00013,387660,24.83286,1561077
18873,xxlaila,2,0.00013,387662,24.83298,1561077
18874,xyggun,2,0.00013,387664,24.83311,1561077
18875,YacheLee,2,0.00013,387666,24.83324,1561077
18876,yacn,2,0.00013,387668,24.83337,1561077
18877,yael-lorenzo-olx,2,0.00013,387670,24.83350,1561077
18878,YanceyWang,2,0.00013,387672,24.83362,1561077
18879,yanivop,2,0.00013,387674,24.83375,1561077
18880,yanniks,2,0.00013,387676,24.83388,1561077
18881,yannislionis,2,0.00013,387678,24.83401,1561077
18882,yannk,2,0.00013,387680,24.83414,1561077
18883,yanzhiwei147,2,0.00013,387682,24.83427,1561077
18884,yaochenfeng,2,0.00013,387684,24.83439,1561077
18885,yaogunfantuan,2,0.00013,387686,24.83452,1561077
18886,yaras,2,0.00013,387688,24.83465,1561077
18887,yarashenkajitpack,2,0.00013,387690,24.83478,1561077
18888,yardenshoham,2,0.00013,387692,24.83491,1561077
18889,yashwanthupsc,2,0.00013,387694,24.83503,1561077
18890,yaycmyk,2,0.00013,387696,24.83516,1561077
18891,yayoec,2,0.00013,387698,24.83529,1561077
18892,ybrodskiy,2,0.00013,387700,24.83542,1561077
18893,yeluolei,2,0.00013,387702,24.83555,1561077
18894,Yethal,2,0.00013,387704,24.83567,1561077
18895,yevhen-hryhorevskyi,2,0.00013,387706,24.83580,1561077
18896,yf225,2,0.00013,387708,24.83593,1561077
18897,yfei1,2,0.00013,387710,24.83606,1561077
18898,ygkonglingwei,2,0.00013,387712,24.83619,1561077
18899,YGwen,2,0.00013,387714,24.83631,1561077
18900,yhung124,2,0.00013,387716,24.83644,1561077
18901,yinduo527,2,0.00013,387718,24.83657,1561077
18902,yitshakyarom,2,0.00013,387720,24.83670,1561077
18903,yizhuan,2,0.00013,387722,24.83683,1561077
18904,yjp211,2,0.00013,387724,24.83696,1561077
18905,ykoer,2,0.00013,387726,24.83708,1561077
18906,ymajoros,2,0.00013,387728,24.83721,1561077
18907,YMasliah-neotys,2,0.00013,387730,24.83734,1561077
18908,YmerejRedienhcs,2,0.00013,387732,24.83747,1561077
18909,ynedelin,2,0.00013,387734,24.83760,1561077
18910,YoannBuch,2,0.00013,387736,24.83772,1561077
18911,yoav-klein,2,0.00013,387738,24.83785,1561077
18912,yogeshkhandelwal,2,0.00013,387740,24.83798,1561077
18913,yonggang985,2,0.00013,387742,24.83811,1561077
18914,yonwon01,2,0.00013,387744,24.83824,1561077
18915,yorlov,2,0.00013,387746,24.83836,1561077
18916,yossihan,2,0.00013,387748,24.83849,1561077
18917,yourowndisaster09,2,0.00013,387750,24.83862,1561077
18918,yroffin,2,0.00013,387752,24.83875,1561077
18919,yr-sudhakar,2,0.00013,387754,24.83888,1561077
18920,ystreibel,2,0.00013,387756,24.83901,1561077
18921,yuantianchi,2,0.00013,387758,24.83913,1561077
18922,yuanzhilei,2,0.00013,387760,24.83926,1561077
18923,yuliabaron,2,0.00013,387762,24.83939,1561077
18924,yultide,2,0.00013,387764,24.83952,1561077
18925,yuniers,2,0.00013,387766,24.83965,1561077
18926,yuppie-flu,2,0.00013,387768,24.83977,1561077
18927,yuri-karpovich,2,0.00013,387770,24.83990,1561077
18928,yurikilian,2,0.00013,387772,24.84003,1561077
18929,yurivict,2,0.00013,387774,24.84016,1561077
18930,yuri-wisestamp,2,0.00013,387776,24.84029,1561077
18931,yuryoleynik,2,0.00013,387778,24.84041,1561077
18932,yury-tyumin,2,0.00013,387780,24.84054,1561077
18933,YuukanOO,2,0.00013,387782,24.84067,1561077
18934,yuval-yaari,2,0.00013,387784,24.84080,1561077
18935,yuvi3814,2,0.00013,387786,24.84093,1561077
18936,yuyijq,2,0.00013,387788,24.84106,1561077
18937,yvk-1970,2,0.00013,387790,24.84118,1561077
18938,yvonnevictoria,2,0.00013,387792,24.84131,1561077
18939,Yvtq8K3n,2,0.00013,387794,24.84144,1561077
18940,ywchang,2,0.00013,387796,24.84157,1561077
18941,yxliang01,2,0.00013,387798,24.84170,1561077
18942,yylin1,2,0.00013,387800,24.84182,1561077
18943,yzhydovich,2,0.00013,387802,24.84195,1561077
18944,z0ph,2,0.00013,387804,24.84208,1561077
18945,zabio3,2,0.00013,387806,24.84221,1561077
18946,Zaccc123,2,0.00013,387808,24.84234,1561077
18947,zachary-duquette,2,0.00013,387810,24.84246,1561077
18948,ZachDZimmerman,2,0.00013,387812,24.84259,1561077
18949,zackpayton,2,0.00013,387814,24.84272,1561077
18950,zackse,2,0.00013,387816,24.84285,1561077
18951,zakaf,2,0.00013,387818,24.84298,1561077
18952,zakirhossain-dsi,2,0.00013,387820,24.84311,1561077
18953,Zamyatin,2,0.00013,387822,24.84323,1561077
18954,zaneobrien,2,0.00013,387824,24.84336,1561077
18955,ZAntony,2,0.00013,387826,24.84349,1561077
18956,zawadzkip,2,0.00013,387828,24.84362,1561077
18957,zazrivec,2,0.00013,387830,24.84375,1561077
18958,zbjincheng,2,0.00013,387832,24.84387,1561077
18959,zcsongor,2,0.00013,387834,24.84400,1561077
18960,zduymz,2,0.00013,387836,24.84413,1561077
18961,zekedroid,2,0.00013,387838,24.84426,1561077
18962,zelahi,2,0.00013,387840,24.84439,1561077
18963,zenglian,2,0.00013,387842,24.84451,1561077
18964,ZenithDK,2,0.00013,387844,24.84464,1561077
18965,zenseth,2,0.00013,387846,24.84477,1561077
18966,zenspider,2,0.00013,387848,24.84490,1561077
18967,Zephery,2,0.00013,387850,24.84503,1561077
18968,zephyrmohan,2,0.00013,387852,24.84515,1561077
18969,zeralight,2,0.00013,387854,24.84528,1561077
18970,zeridon,2,0.00013,387856,24.84541,1561077
18971,zeroem,2,0.00013,387858,24.84554,1561077
18972,zerog2k,2,0.00013,387860,24.84567,1561077
18973,zeton3,2,0.00013,387862,24.84580,1561077
18974,zett42,2,0.00013,387864,24.84592,1561077
18975,ZeusMinos,2,0.00013,387866,24.84605,1561077
18976,zevin,2,0.00013,387868,24.84618,1561077
18977,zezke,2,0.00013,387870,24.84631,1561077
18978,zgc,2,0.00013,387872,24.84644,1561077
18979,zhang520,2,0.00013,387874,24.84656,1561077
18980,ZhangfengSun,2,0.00013,387876,24.84669,1561077
18981,zhanglong2015,2,0.00013,387878,24.84682,1561077
18982,zhangwenlong8911,2,0.00013,387880,24.84695,1561077
18983,zhangxichun,2,0.00013,387882,24.84708,1561077
18984,zhaodanwjk,2,0.00013,387884,24.84720,1561077
18985,Zhaoningx,2,0.00013,387886,24.84733,1561077
18986,zhaoxiangyu,2,0.00013,387888,24.84746,1561077
18987,zhengshuheng,2,0.00013,387890,24.84759,1561077
18988,zhuyongxuan,2,0.00013,387892,24.84772,1561077
18989,zi-adis,2,0.00013,387894,24.84785,1561077
18990,zibber2015,2,0.00013,387896,24.84797,1561077
18991,ziggy-star-dust,2,0.00013,387898,24.84810,1561077
18992,zilmTT,2,0.00013,387900,24.84823,1561077
18993,zinuzoid,2,0.00013,387902,24.84836,1561077
18994,Ziomalon,2,0.00013,387904,24.84849,1561077
18995,ziqiangxu,2,0.00013,387906,24.84861,1561077
18996,zivmessing,2,0.00013,387908,24.84874,1561077
18997,ziyadElon,2,0.00013,387910,24.84887,1561077
18998,zizizach,2,0.00013,387912,24.84900,1561077
18999,zjfroot,2,0.00013,387914,24.84913,1561077
19000,zkl94,2,0.00013,387916,24.84925,1561077
19001,zlacelle,2,0.00013,387918,24.84938,1561077
19002,znqerz,2,0.00013,387920,24.84951,1561077
19003,zodiac1214,2,0.00013,387922,24.84964,1561077
19004,zollo,2,0.00013,387924,24.84977,1561077
19005,zoomequipd,2,0.00013,387926,24.84990,1561077
19006,zopanix,2,0.00013,387928,24.85002,1561077
19007,zouhir,2,0.00013,387930,24.85015,1561077
19008,zshi456,2,0.00013,387932,24.85028,1561077
19009,zsolt-biro,2,0.00013,387934,24.85041,1561077
19010,zsw007,2,0.00013,387936,24.85054,1561077
19011,ztepsic,2,0.00013,387938,24.85066,1561077
19012,zubcevic,2,0.00013,387940,24.85079,1561077
19013,zutherb,2,0.00013,387942,24.85092,1561077
19014,zxcasdqw,2,0.00013,387944,24.85105,1561077
19015,zybreak,2,0.00013,387946,24.85118,1561077
19016,zyjin,2,0.00013,387948,24.85130,1561077
19017,0107shashankgarg,1,0.00006,387949,24.85137,1561077
19018,0312birdzhang,1,0.00006,387950,24.85143,1561077
19019,03-aditi,1,0.00006,387951,24.85150,1561077
19020,0814jimmy,1,0.00006,387952,24.85156,1561077
19021,0mega,1,0.00006,387953,24.85162,1561077
19022,0mok,1,0.00006,387954,24.85169,1561077
19023,0sayed0,1,0.00006,387955,24.85175,1561077
19024,0x69676f72,1,0.00006,387956,24.85182,1561077
19025,0xDAFE,1,0.00006,387957,24.85188,1561077
19026,0xkasun,1,0.00006,387958,24.85195,1561077
19027,1084565,1,0.00006,387959,24.85201,1561077
19028,123batman,1,0.00006,387960,24.85207,1561077
19029,1312655689,1,0.00006,387961,24.85214,1561077
19030,15538135426,1,0.00006,387962,24.85220,1561077
19031,15it36,1,0.00006,387963,24.85227,1561077
19032,16slowly,1,0.00006,387964,24.85233,1561077
19033,1765659645,1,0.00006,387965,24.85239,1561077
19034,18515291426,1,0.00006,387966,24.85246,1561077
19035,18981119465,1,0.00006,387967,24.85252,1561077
19036,190484ck,1,0.00006,387968,24.85259,1561077
19037,1987jy,1,0.00006,387969,24.85265,1561077
19038,1beb,1,0.00006,387970,24.85271,1561077
19039,1cto,1,0.00006,387971,24.85278,1561077
19040,1daniyal2,1,0.00006,387972,24.85284,1561077
19041,1GitHeavy,1,0.00006,387973,24.85291,1561077
19042,1MaJKeL1,1,0.00006,387974,24.85297,1561077
19043,1st,1,0.00006,387975,24.85303,1561077
19044,21region,1,0.00006,387976,24.85310,1561077
19045,22phuber,1,0.00006,387977,24.85316,1561077
19046,2397744634,1,0.00006,387978,24.85323,1561077
19047,240ch,1,0.00006,387979,24.85329,1561077
19048,243826,1,0.00006,387980,24.85335,1561077
19049,256x240,1,0.00006,387981,24.85342,1561077
19050,264768502,1,0.00006,387982,24.85348,1561077
19051,282919088,1,0.00006,387983,24.85355,1561077
19052,288milan,1,0.00006,387984,24.85361,1561077
19053,2ssue,1,0.00006,387985,24.85367,1561077
19054,2toginc,1,0.00006,387986,24.85374,1561077
19055,317brian,1,0.00006,387987,24.85380,1561077
19056,3303387067,1,0.00006,387988,24.85387,1561077
19057,345paul,1,0.00006,387989,24.85393,1561077
19058,370569218,1,0.00006,387990,24.85400,1561077
19059,375gnu,1,0.00006,387991,24.85406,1561077
19060,37b,1,0.00006,387992,24.85412,1561077
19061,39-misaka-mikoto,1,0.00006,387993,24.85419,1561077
19062,3eka,1,0.00006,387994,24.85425,1561077
19063,3sky,1,0.00006,387995,24.85432,1561077
19064,459737087,1,0.00006,387996,24.85438,1561077
19065,462548187,1,0.00006,387997,24.85444,1561077
19066,4eyecoder,1,0.00006,387998,24.85451,1561077
19067,4insavage,1,0.00006,387999,24.85457,1561077
19068,4sachi,1,0.00006,388000,24.85464,1561077
19069,4wdmh,1,0.00006,388001,24.85470,1561077
19070,526f73656e0a,1,0.00006,388002,24.85476,1561077
19071,52doho,1,0.00006,388003,24.85483,1561077
19072,5452,1,0.00006,388004,24.85489,1561077
19073,60secs,1,0.00006,388005,24.85496,1561077
19074,625440531,1,0.00006,388006,24.85502,1561077
19075,66667888sssttt,1,0.00006,388007,24.85508,1561077
19076,69pankaj69,1,0.00006,388008,24.85515,1561077
19077,6aKa,1,0.00006,388009,24.85521,1561077
19078,749145134,1,0.00006,388010,24.85528,1561077
19079,78722689,1,0.00006,388011,24.85534,1561077
19080,7DataBits,1,0.00006,388012,24.85540,1561077
19081,7etrahedral,1,0.00006,388013,24.85547,1561077
19082,7kms,1,0.00006,388014,24.85553,1561077
19083,7oas7er,1,0.00006,388015,24.85560,1561077
19084,80kk,1,0.00006,388016,24.85566,1561077
19085,81519434,1,0.00006,388017,24.85572,1561077
19086,839928622,1,0.00006,388018,24.85579,1561077
19087,88weighed,1,0.00006,388019,24.85585,1561077
19088,8a8aleo,1,0.00006,388020,24.85592,1561077
19089,8bitbrad,1,0.00006,388021,24.85598,1561077
19090,91wangmeng,1,0.00006,388022,24.85604,1561077
19091,9652040795,1,0.00006,388023,24.85611,1561077
19092,9970807747,1,0.00006,388024,24.85617,1561077
19093,9dre4m,1,0.00006,388025,24.85624,1561077
19094,a760109,1,0.00006,388026,24.85630,1561077
19095,aaboyd,1,0.00006,388027,24.85637,1561077
19096,aadheeb,1,0.00006,388028,24.85643,1561077
19097,aadilc33,1,0.00006,388029,24.85649,1561077
19098,aadir7,1,0.00006,388030,24.85656,1561077
19099,aaditya47,1,0.00006,388031,24.85662,1561077
19100,aah9,1,0.00006,388032,24.85669,1561077
19101,aalexgabi,1,0.00006,388033,24.85675,1561077
19102,aalim-nisum-com,1,0.00006,388034,24.85681,1561077
19103,AAlvz,1,0.00006,388035,24.85688,1561077
19104,aantillonl,1,0.00006,388036,24.85694,1561077
19105,aantonczak,1,0.00006,388037,24.85701,1561077
19106,Aaqib041,1,0.00006,388038,24.85707,1561077
19107,aaratushnyak,1,0.00006,388039,24.85713,1561077
19108,aarnwri,1,0.00006,388040,24.85720,1561077
19109,aaronang,1,0.00006,388041,24.85726,1561077
19110,aaronborden-rivian,1,0.00006,388042,24.85733,1561077
19111,aaronbrownasp,1,0.00006,388043,24.85739,1561077
19112,aaroncadillac,1,0.00006,388044,24.85745,1561077
19113,a-a-ronCC,1,0.00006,388045,24.85752,1561077
19114,aarongo,1,0.00006,388046,24.85758,1561077
19115,aaronkitchens,1,0.00006,388047,24.85765,1561077
19116,aaronmarkham,1,0.00006,388048,24.85771,1561077
19117,aaronmray,1,0.00006,388049,24.85777,1561077
19118,aaronosb,1,0.00006,388050,24.85784,1561077
19119,aaronovz1,1,0.00006,388051,24.85790,1561077
19120,aaronr93,1,0.00006,388052,24.85797,1561077
19121,aarora79,1,0.00006,388053,24.85803,1561077
19122,aarrateg,1,0.00006,388054,24.85809,1561077
19123,aaryanmehtaops,1,0.00006,388055,24.85816,1561077
19124,aasheishmody,1,0.00006,388056,24.85822,1561077
19125,aasigma,1,0.00006,388057,24.85829,1561077
19126,AASyedAbbas,1,0.00006,388058,24.85835,1561077
19127,aatishraj,1,0.00006,388059,24.85842,1561077
19128,AAverin,1,0.00006,388060,24.85848,1561077
19129,AbacusIntegrationPlatform,1,0.00006,388061,24.85854,1561077
19130,abaditsegay,1,0.00006,388062,24.85861,1561077
19131,abaird,1,0.00006,388063,24.85867,1561077
19132,aballano,1,0.00006,388064,24.85874,1561077
19133,abaradulkin,1,0.00006,388065,24.85880,1561077
19134,aba-rechsteiner,1,0.00006,388066,24.85886,1561077
19135,abbottdev,1,0.00006,388067,24.85893,1561077
19136,AbdealiJK,1,0.00006,388068,24.85899,1561077
19137,abdiali9617,1,0.00006,388069,24.85906,1561077
19138,abdohossam5,1,0.00006,388070,24.85912,1561077
19139,abdulhaseebxflow,1,0.00006,388071,24.85918,1561077
19140,abdullahkhawer,1,0.00006,388072,24.85925,1561077
19141,AbdulRahim14,1,0.00006,388073,24.85931,1561077
19142,abdulrahman25,1,0.00006,388074,24.85938,1561077
19143,abekenov93,1,0.00006,388075,24.85944,1561077
19144,abelcher,1,0.00006,388076,24.85950,1561077
19145,AbelNavarro,1,0.00006,388077,24.85957,1561077
19146,abelyaevskiy,1,0.00006,388078,24.85963,1561077
19147,Abenlakhdhar,1,0.00006,388079,24.85970,1561077
19148,aberhaneTopps,1,0.00006,388080,24.85976,1561077
19149,aberkvam,1,0.00006,388081,24.85982,1561077
19150,abe-rodriguez-nuvalence,1,0.00006,388082,24.85989,1561077
19151,AbfrmBlr,1,0.00006,388083,24.85995,1561077
19152,abhadfield,1,0.00006,388084,24.86002,1561077
19153,abhay4291,1,0.00006,388085,24.86008,1561077
19154,abhi-146,1,0.00006,388086,24.86014,1561077
19155,AbhiAuto,1,0.00006,388087,24.86021,1561077
19156,abhiboost,1,0.00006,388088,24.86027,1561077
19157,abhijangid123,1,0.00006,388089,24.86034,1561077
19158,abhijeetmoon,1,0.00006,388090,24.86040,1561077
19159,AbhiLitmus,1,0.00006,388091,24.86046,1561077
19160,abhinav2196,1,0.00006,388092,24.86053,1561077
19161,abhinavaditya777,1,0.00006,388093,24.86059,1561077
19162,abhinavashok,1,0.00006,388094,24.86066,1561077
19163,abhinavgautam07,1,0.00006,388095,24.86072,1561077
19164,AbhinavSinha12,1,0.00006,388096,24.86079,1561077
19165,abhinvsinh,1,0.00006,388097,24.86085,1561077
19166,AbhiPatodi,1,0.00006,388098,24.86091,1561077
19167,abhiram-krishnan,1,0.00006,388099,24.86098,1561077
19168,abhiroop93,1,0.00006,388100,24.86104,1561077
19169,abhiruppaul156,1,0.00006,388101,24.86111,1561077
19170,abhishakeonteddu,1,0.00006,388102,24.86117,1561077
19171,abhishek8908,1,0.00006,388103,24.86123,1561077
19172,AbhishekAgarwalSmartbear,1,0.00006,388104,24.86130,1561077
19173,abhishek-singh-tomar,1,0.00006,388105,24.86136,1561077
19174,abhisku,1,0.00006,388106,24.86143,1561077
19175,abienkowski,1,0.00006,388107,24.86149,1561077
19176,abierbaum,1,0.00006,388108,24.86155,1561077
19177,abihf,1,0.00006,388109,24.86162,1561077
19178,abinkrishna,1,0.00006,388110,24.86168,1561077
19179,Abirpal202049,1,0.00006,388111,24.86175,1561077
19180,abist,1,0.00006,388112,24.86181,1561077
19181,abiycisco,1,0.00006,388113,24.86187,1561077
19182,abjrcode,1,0.00006,388114,24.86194,1561077
19183,aboivin,1,0.00006,388115,24.86200,1561077
19184,abourdon,1,0.00006,388116,24.86207,1561077
19185,abouthiroppy,1,0.00006,388117,24.86213,1561077
19186,abovas0321,1,0.00006,388118,24.86219,1561077
19187,a-bra,1,0.00006,388119,24.86226,1561077
19188,AbrahamAlcaina,1,0.00006,388120,24.86232,1561077
19189,abrahamoshel,1,0.00006,388121,24.86239,1561077
19190,abryleuski,1,0.00006,388122,24.86245,1561077
19191,abstrus,1,0.00006,388123,24.86251,1561077
19192,Absurd-Mind,1,0.00006,388124,24.86258,1561077
19193,abtiddle,1,0.00006,388125,24.86264,1561077
19194,abubeck,1,0.00006,388126,24.86271,1561077
19195,abustany,1,0.00006,388127,24.86277,1561077
19196,AByzhynar,1,0.00006,388128,24.86284,1561077
19197,academic-sakharov,1,0.00006,388129,24.86290,1561077
19198,acaproulx,1,0.00006,388130,24.86296,1561077
19199,acasanovass,1,0.00006,388131,24.86303,1561077
19200,AccidentallyTheCable,1,0.00006,388132,24.86309,1561077
19201,accu-joeykarns,1,0.00006,388133,24.86316,1561077
19202,accwebs,1,0.00006,388134,24.86322,1561077
19203,ace03uec,1,0.00006,388135,24.86328,1561077
19204,Acejames87,1,0.00006,388136,24.86335,1561077
19205,acepsaepudin,1,0.00006,388137,24.86341,1561077
19206,a-cesari,1,0.00006,388138,24.86348,1561077
19207,AceSlash,1,0.00006,388139,24.86354,1561077
19208,aceslup,1,0.00006,388140,24.86360,1561077
19209,acevif,1,0.00006,388141,24.86367,1561077
19210,achalawb,1,0.00006,388142,24.86373,1561077
19211,achalshah20,1,0.00006,388143,24.86380,1561077
19212,Achari-Sumanth,1,0.00006,388144,24.86386,1561077
19213,acheaito,1,0.00006,388145,24.86392,1561077
19214,achino520,1,0.00006,388146,24.86399,1561077
19215,acidbathory,1,0.00006,388147,24.86405,1561077
19216,Ackertron,1,0.00006,388148,24.86412,1561077
19217,ac-seym45,1,0.00006,388149,24.86418,1561077
19218,actionless,1,0.00006,388150,24.86424,1561077
19219,activiti7-comcast,1,0.00006,388151,24.86431,1561077
19220,actown,1,0.00006,388152,24.86437,1561077
19221,acuthbert,1,0.00006,388153,24.86444,1561077
19222,adambournsonos,1,0.00006,388154,24.86450,1561077
19223,AdamKobus,1,0.00006,388155,24.86456,1561077
19224,adamo57,1,0.00006,388156,24.86463,1561077
19225,adamorhd,1,0.00006,388157,24.86469,1561077
19226,adamoutler,1,0.00006,388158,24.86476,1561077
19227,adampats,1,0.00006,388159,24.86482,1561077
19228,adam-power,1,0.00006,388160,24.86488,1561077
19229,AdamSalma,1,0.00006,388161,24.86495,1561077
19230,adamsantos67,1,0.00006,388162,24.86501,1561077
19231,adamtheturtle,1,0.00006,388163,24.86508,1561077
19232,adamwong246,1,0.00006,388164,24.86514,1561077
19233,adamzolyak,1,0.00006,388165,24.86521,1561077
19234,adashen,1,0.00006,388166,24.86527,1561077
19235,adborden,1,0.00006,388167,24.86533,1561077
19236,addoula88,1,0.00006,388168,24.86540,1561077
19237,adeadrat,1,0.00006,388169,24.86546,1561077
19238,adelbert-ureta,1,0.00006,388170,24.86553,1561077
19239,adelwin,1,0.00006,388171,24.86559,1561077
19240,adelyafatykhova,1,0.00006,388172,24.86565,1561077
19241,adenhertog,1,0.00006,388173,24.86572,1561077
19242,adeoke,1,0.00006,388174,24.86578,1561077
19243,adeolaawoyemi,1,0.00006,388175,24.86585,1561077
19244,ader1990,1,0.00006,388176,24.86591,1561077
19245,Adercley,1,0.00006,388177,24.86597,1561077
19246,Aderemi,1,0.00006,388178,24.86604,1561077
19247,adhavanlatha,1,0.00006,388179,24.86610,1561077
19248,Adhira-Deogade,1,0.00006,388180,24.86617,1561077
19249,adi1133,1,0.00006,388181,24.86623,1561077
19250,adiallot,1,0.00006,388182,24.86629,1561077
19251,adichiru,1,0.00006,388183,24.86636,1561077
19252,adidik,1,0.00006,388184,24.86642,1561077
19253,adiffpirate,1,0.00006,388185,24.86649,1561077
19254,adiha2033,1,0.00006,388186,24.86655,1561077
19255,adilmehmoodbutt,1,0.00006,388187,24.86661,1561077
19256,AdimUser,1,0.00006,388188,24.86668,1561077
19257,adithya180498,1,0.00006,388189,24.86674,1561077
19258,adityagautam,1,0.00006,388190,24.86681,1561077
19259,adityakapre,1,0.00006,388191,24.86687,1561077
19260,adityapratap12,1,0.00006,388192,24.86693,1561077
19261,adityasharma1,1,0.00006,388193,24.86700,1561077
19262,aditya-soni,1,0.00006,388194,24.86706,1561077
19263,adjshort,1,0.00006,388195,24.86713,1561077
19264,admin4ek,1,0.00006,388196,24.86719,1561077
19265,admin-andikem,1,0.00006,388197,24.86726,1561077
19266,admindmn,1,0.00006,388198,24.86732,1561077
19267,admizh,1,0.00006,388199,24.86738,1561077
19268,admmasters,1,0.00006,388200,24.86745,1561077
19269,adnux,1,0.00006,388201,24.86751,1561077
19270,ADobrodey,1,0.00006,388202,24.86758,1561077
19271,adokarasev,1,0.00006,388203,24.86764,1561077
19272,adou600,1,0.00006,388204,24.86770,1561077
19273,adoylesimplisafe,1,0.00006,388205,24.86777,1561077
19274,adrach,1,0.00006,388206,24.86783,1561077
19275,a-drees,1,0.00006,388207,24.86790,1561077
19276,adri1s,1,0.00006,388208,24.86796,1561077
19277,adrianharabula,1,0.00006,388209,24.86802,1561077
19278,adrianhincuvisma,1,0.00006,388210,24.86809,1561077
19279,adrianhirst,1,0.00006,388211,24.86815,1561077
19280,adriankirchner,1,0.00006,388212,24.86822,1561077
19281,adrianmaurer,1,0.00006,388213,24.86828,1561077
19282,adrianrojas-j,1,0.00006,388214,24.86834,1561077
19283,adriantodorov,1,0.00006,388215,24.86841,1561077
19284,adrkn,1,0.00006,388216,24.86847,1561077
19285,adrpp,1,0.00006,388217,24.86854,1561077
19286,adumat,1,0.00006,388218,24.86860,1561077
19287,adv-spinnaker,1,0.00006,388219,24.86866,1561077
19288,adyanthaya17,1,0.00006,388220,24.86873,1561077
19289,adziura-ledger,1,0.00006,388221,24.86879,1561077
19290,aedades,1,0.00006,388222,24.86886,1561077
19291,aekrohn,1,0.00006,388223,24.86892,1561077
19292,aenniw,1,0.00006,388224,24.86898,1561077
19293,aerben,1,0.00006,388225,24.86905,1561077
19294,Aereliz,1,0.00006,388226,24.86911,1561077
19295,aernout,1,0.00006,388227,24.86918,1561077
19296,afe038,1,0.00006,388228,24.86924,1561077
19297,afeiszli,1,0.00006,388229,24.86930,1561077
19298,afejiang,1,0.00006,388230,24.86937,1561077
19299,aferreeira,1,0.00006,388231,24.86943,1561077
19300,afex,1,0.00006,388232,24.86950,1561077
19301,afflux,1,0.00006,388233,24.86956,1561077
19302,afiguera,1,0.00006,388234,24.86963,1561077
19303,afnanqureshi,1,0.00006,388235,24.86969,1561077
19304,aformyname,1,0.00006,388236,24.86975,1561077
19305,afrostalin,1,0.00006,388237,24.86982,1561077
19306,aftabnaqvi,1,0.00006,388238,24.86988,1561077
19307,AFurryCat,1,0.00006,388239,24.86995,1561077
19308,afx114,1,0.00006,388240,24.87001,1561077
19309,afzalbin64,1,0.00006,388241,24.87007,1561077
19310,ag143,1,0.00006,388242,24.87014,1561077
19311,ag4ta,1,0.00006,388243,24.87020,1561077
19312,agaengel,1,0.00006,388244,24.87027,1561077
19313,agathver,1,0.00006,388245,24.87033,1561077
19314,agbanagba,1,0.00006,388246,24.87039,1561077
19315,Agentbars,1,0.00006,388247,24.87046,1561077
19316,agentgt,1,0.00006,388248,24.87052,1561077
19317,agenticarus,1,0.00006,388249,24.87059,1561077
19318,AgentSlim,1,0.00006,388250,24.87065,1561077
19319,aggarwav,1,0.00006,388251,24.87071,1561077
19320,aghassabian,1,0.00006,388252,24.87078,1561077
19321,Aghassi,1,0.00006,388253,24.87084,1561077
19322,aghazi,1,0.00006,388254,24.87091,1561077
19323,AGiantSquid,1,0.00006,388255,24.87097,1561077
19324,agilderdale,1,0.00006,388256,24.87103,1561077
19325,aglees,1,0.00006,388257,24.87110,1561077
19326,agnnn,1,0.00006,388258,24.87116,1561077
19327,agoldfain-interview,1,0.00006,388259,24.87123,1561077
19328,agonyeye,1,0.00006,388260,24.87129,1561077
19329,agosto-lorinronken,1,0.00006,388261,24.87135,1561077
19330,agpituk,1,0.00006,388262,24.87142,1561077
19331,agray1017,1,0.00006,388263,24.87148,1561077
19332,agriet,1,0.00006,388264,24.87155,1561077
19333,agroszer,1,0.00006,388265,24.87161,1561077
19334,agrrh,1,0.00006,388266,24.87168,1561077
19335,ags313,1,0.00006,388267,24.87174,1561077
19336,aguang123789,1,0.00006,388268,24.87180,1561077
19337,agusgambina,1,0.00006,388269,24.87187,1561077
19338,a-hab,1,0.00006,388270,24.87193,1561077
19339,ahadrez,1,0.00006,388271,24.87200,1561077
19340,aharrison24,1,0.00006,388272,24.87206,1561077
19341,aharya,1,0.00006,388273,24.87212,1561077
19342,ahewstone,1,0.00006,388274,24.87219,1561077
19343,ahlae,1,0.00006,388275,24.87225,1561077
19344,ahliddin,1,0.00006,388276,24.87232,1561077
19345,ahmade3,1,0.00006,388277,24.87238,1561077
19346,AhmadMasry,1,0.00006,388278,24.87244,1561077
19347,ahmed20391849,1,0.00006,388279,24.87251,1561077
19348,ahmedsalah0001,1,0.00006,388280,24.87257,1561077
19349,ahoereth,1,0.00006,388281,24.87264,1561077
19350,ahvigil,1,0.00006,388282,24.87270,1561077
19351,aibuildmaster,1,0.00006,388283,24.87276,1561077
19352,AicBousa,1,0.00006,388284,24.87283,1561077
19353,aicheung,1,0.00006,388285,24.87289,1561077
19354,aikar,1,0.00006,388286,24.87296,1561077
19355,AIKiller,1,0.00006,388287,24.87302,1561077
19356,Airc0n,1,0.00006,388288,24.87308,1561077
19357,aisachenka,1,0.00006,388289,24.87315,1561077
19358,aivans,1,0.00006,388290,24.87321,1561077
19359,aivcec,1,0.00006,388291,24.87328,1561077
19360,aj141,1,0.00006,388292,24.87334,1561077
19361,ajanthanh,1,0.00006,388293,24.87340,1561077
19362,ajanwari,1,0.00006,388294,24.87347,1561077
19363,AjaxLeVallee,1,0.00006,388295,24.87353,1561077
19364,Ajaykumar-N-ML,1,0.00006,388296,24.87360,1561077
19365,ajbanck,1,0.00006,388297,24.87366,1561077
19366,ajboni,1,0.00006,388298,24.87372,1561077
19367,ajbowler,1,0.00006,388299,24.87379,1561077
19368,ajc-grndr,1,0.00006,388300,24.87385,1561077
19369,ajeetraina,1,0.00006,388301,24.87392,1561077
19370,ajesh1995,1,0.00006,388302,24.87398,1561077
19371,ajitatif,1,0.00006,388303,24.87405,1561077
19372,ajithashokkumar001,1,0.00006,388304,24.87411,1561077
19373,AjithPulakkazhy,1,0.00006,388305,24.87417,1561077
19374,ajithr,1,0.00006,388306,24.87424,1561077
19375,ajkyffin,1,0.00006,388307,24.87430,1561077
19376,ajmax,1,0.00006,388308,24.87437,1561077
19377,ajmenteng,1,0.00006,388309,24.87443,1561077
19378,ajorpheus,1,0.00006,388310,24.87449,1561077
19379,ajorquera,1,0.00006,388311,24.87456,1561077
19380,ajoysinhactc,1,0.00006,388312,24.87462,1561077
19381,ajpessi,1,0.00006,388313,24.87469,1561077
19382,ajplarson,1,0.00006,388314,24.87475,1561077
19383,ajreddy1,1,0.00006,388315,24.87481,1561077
19384,akallabeth,1,0.00006,388316,24.87488,1561077
19385,akang1,1,0.00006,388317,24.87494,1561077
19386,akaoj,1,0.00006,388318,24.87501,1561077
19387,akapoor47,1,0.00006,388319,24.87507,1561077
19388,Akarsh-14,1,0.00006,388320,24.87513,1561077
19389,akasati,1,0.00006,388321,24.87520,1561077
19390,akashdhruv,1,0.00006,388322,24.87526,1561077
19391,AkashGulati45,1,0.00006,388323,24.87533,1561077
19392,akashgupta987,1,0.00006,388324,24.87539,1561077
19393,akashissu,1,0.00006,388325,24.87545,1561077
19394,akashsuresh,1,0.00006,388326,24.87552,1561077
19395,akdag979,1,0.00006,388327,24.87558,1561077
19396,akeating,1,0.00006,388328,24.87565,1561077
19397,akeely,1,0.00006,388329,24.87571,1561077
19398,Akhi1,1,0.00006,388330,24.87577,1561077
19399,Akhil88328832,1,0.00006,388331,24.87584,1561077
19400,akhilbojedla,1,0.00006,388332,24.87590,1561077
19401,akhilesh0,1,0.00006,388333,24.87597,1561077
19402,akhileshappala,1,0.00006,388334,24.87603,1561077
19403,akhilojha,1,0.00006,388335,24.87610,1561077
19404,akinaru,1,0.00006,388336,24.87616,1561077
19405,akirakw,1,0.00006,388337,24.87622,1561077
19406,akitson-degreed,1,0.00006,388338,24.87629,1561077
19407,akmabrouk,1,0.00006,388339,24.87635,1561077
19408,akohout,1,0.00006,388340,24.87642,1561077
19409,akoi,1,0.00006,388341,24.87648,1561077
19410,akonokhov,1,0.00006,388342,24.87654,1561077
19411,akouznetchik,1,0.00006,388343,24.87661,1561077
19412,aksakalli,1,0.00006,388344,24.87667,1561077
19413,akshat-crypto,1,0.00006,388345,24.87674,1561077
19414,AkshayGhawade,1,0.00006,388346,24.87680,1561077
19415,akshaygupta2208,1,0.00006,388347,24.87686,1561077
19416,akshayks,1,0.00006,388348,24.87693,1561077
19417,Akshay-Phapale,1,0.00006,388349,24.87699,1561077
19418,akshayraut211,1,0.00006,388350,24.87706,1561077
19419,aksiksi,1,0.00006,388351,24.87712,1561077
19420,aktiver,1,0.00006,388352,24.87718,1561077
19421,aktungmak,1,0.00006,388353,24.87725,1561077
19422,akulakhan,1,0.00006,388354,24.87731,1561077
19423,akumacxd,1,0.00006,388355,24.87738,1561077
19424,akwiatek,1,0.00006,388356,24.87744,1561077
19425,alaaseada,1,0.00006,388357,24.87750,1561077
19426,alahijani,1,0.00006,388358,24.87757,1561077
19427,alain-kermis-sonarsource,1,0.00006,388359,24.87763,1561077
19428,Alalk,1,0.00006,388360,24.87770,1561077
19429,AlameluSubbiah,1,0.00006,388361,24.87776,1561077
19430,alamsz,1,0.00006,388362,24.87782,1561077
19431,alanamircruz,1,0.00006,388363,24.87789,1561077
19432,alandovskis,1,0.00006,388364,24.87795,1561077
19433,alanharder,1,0.00006,388365,24.87802,1561077
19434,AlanHohn,1,0.00006,388366,24.87808,1561077
19435,alan-stokes,1,0.00006,388367,24.87815,1561077
19436,alansun2,1,0.00006,388368,24.87821,1561077
19437,alappe,1,0.00006,388369,24.87827,1561077
19438,alarud,1,0.00006,388370,24.87834,1561077
19439,alasarr,1,0.00006,388371,24.87840,1561077
19440,albertodebortoli,1,0.00006,388372,24.87847,1561077
19441,albertofem,1,0.00006,388373,24.87853,1561077
19442,albertoquintanaheras,1,0.00006,388374,24.87859,1561077
19443,albertosottile,1,0.00006,388375,24.87866,1561077
19444,albertvveld,1,0.00006,388376,24.87872,1561077
19445,Albertwzp,1,0.00006,388377,24.87879,1561077
19446,albsOps,1,0.00006,388378,24.87885,1561077
19447,albundy83,1,0.00006,388379,24.87891,1561077
19448,aldennisa15,1,0.00006,388380,24.87898,1561077
19449,aldenquimby,1,0.00006,388381,24.87904,1561077
19450,aldialimucaj,1,0.00006,388382,24.87911,1561077
19451,aldobl1415daw2,1,0.00006,388383,24.87917,1561077
19452,aldosuwandi,1,0.00006,388384,24.87923,1561077
19453,aldredb,1,0.00006,388385,24.87930,1561077
19454,Ale0x78ButInBinary,1,0.00006,388386,24.87936,1561077
19455,aleboulanger,1,0.00006,388387,24.87943,1561077
19456,aleclerc,1,0.00006,388388,24.87949,1561077
19457,alecomputacao,1,0.00006,388389,24.87955,1561077
19458,alec-v,1,0.00006,388390,24.87962,1561077
19459,aledelsur,1,0.00006,388391,24.87968,1561077
19460,aleeaxon,1,0.00006,388392,24.87975,1561077
19461,alegma,1,0.00006,388393,24.87981,1561077
19462,alehane,1,0.00006,388394,24.87987,1561077
19463,aleibovitch,1,0.00006,388395,24.87994,1561077
19464,aleixrm-scopely,1,0.00006,388396,24.88000,1561077
19465,Alejandro9917,1,0.00006,388397,24.88007,1561077
19466,AlejandroGil,1,0.00006,388398,24.88013,1561077
19467,alejurwal,1,0.00006,388399,24.88019,1561077
19468,aleksandarknezevic,1,0.00006,388400,24.88026,1561077
19469,aleksandar-stefanovic-tamedia,1,0.00006,388401,24.88032,1561077
19470,aleksandr-barykov,1,0.00006,388402,24.88039,1561077
19471,AlekseyFicht,1,0.00006,388403,24.88045,1561077
19472,AleksJag,1,0.00006,388404,24.88052,1561077
19473,alekskar,1,0.00006,388405,24.88058,1561077
19474,aleMaqueda,1,0.00006,388406,24.88064,1561077
19475,Alemorato,1,0.00006,388407,24.88071,1561077
19476,alenickwork,1,0.00006,388408,24.88077,1561077
19477,Alenjojo,1,0.00006,388409,24.88084,1561077
19478,alequint,1,0.00006,388410,24.88090,1561077
19479,alevinetx,1,0.00006,388411,24.88096,1561077
19480,alex1atd,1,0.00006,388412,24.88103,1561077
19481,Alex35520,1,0.00006,388413,24.88109,1561077
19482,alexander-gorelik,1,0.00006,388414,24.88116,1561077
19483,AlexanderRainchikArammeem,1,0.00006,388415,24.88122,1561077
19484,alexander-wiechert,1,0.00006,388416,24.88128,1561077
19485,AlexandraRumyantseva,1,0.00006,388417,24.88135,1561077
19486,AlexandreAllemand,1,0.00006,388418,24.88141,1561077
19487,AlexandreFenyo,1,0.00006,388419,24.88148,1561077
19488,alexandre-perrin,1,0.00006,388420,24.88154,1561077
19489,AlexandreRzc,1,0.00006,388421,24.88160,1561077
19490,alexandreSalconiDenis,1,0.00006,388422,24.88167,1561077
19491,alexandrosntak,1,0.00006,388423,24.88173,1561077
19492,alexandrusavin,1,0.00006,388424,24.88180,1561077
19493,alexb5,1,0.00006,388425,24.88186,1561077
19494,alexbeams1898,1,0.00006,388426,24.88192,1561077
19495,alex-ception,1,0.00006,388427,24.88199,1561077
19496,alexchiriac,1,0.00006,388428,24.88205,1561077
19497,alexdean,1,0.00006,388429,24.88212,1561077
19498,alex-driveu,1,0.00006,388430,24.88218,1561077
19499,alexey-aurea,1,0.00006,388431,24.88224,1561077
19500,alexeyhohlov,1,0.00006,388432,24.88231,1561077
19501,alexey-kudrya,1,0.00006,388433,24.88237,1561077
19502,alexey-sellforte,1,0.00006,388434,24.88244,1561077
19503,alexeyulasevich,1,0.00006,388435,24.88250,1561077
19504,alexfaker,1,0.00006,388436,24.88257,1561077
19505,alexfmanihuruk,1,0.00006,388437,24.88263,1561077
19506,Alexgittest,1,0.00006,388438,24.88269,1561077
19507,AlexGreg,1,0.00006,388439,24.88276,1561077
19508,alexgrist,1,0.00006,388440,24.88282,1561077
19509,AlexHarp,1,0.00006,388441,24.88289,1561077
19510,alexhass,1,0.00006,388442,24.88295,1561077
19511,alex-hempel,1,0.00006,388443,24.88301,1561077
19512,AlexisNarvaez97,1,0.00006,388444,24.88308,1561077
19513,alexistrejo,1,0.00006,388445,24.88314,1561077
19514,alexjeffries,1,0.00006,388446,24.88321,1561077
19515,alexkar598,1,0.00006,388447,24.88327,1561077
19516,alexkas1977,1,0.00006,388448,24.88333,1561077
19517,alexlep,1,0.00006,388449,24.88340,1561077
19518,alexlogy,1,0.00006,388450,24.88346,1561077
19519,alex-lx,1,0.00006,388451,24.88353,1561077
19520,alexmanly,1,0.00006,388452,24.88359,1561077
19521,alexmbe,1,0.00006,388453,24.88365,1561077
19522,alexmc6,1,0.00006,388454,24.88372,1561077
19523,alex-mesfin,1,0.00006,388455,24.88378,1561077
19524,alexmherrmann,1,0.00006,388456,24.88385,1561077
19525,alexmojaki,1,0.00006,388457,24.88391,1561077
19526,alex-namely,1,0.00006,388458,24.88397,1561077
19527,alexnovak,1,0.00006,388459,24.88404,1561077
19528,alexqfredrickson,1,0.00006,388460,24.88410,1561077
19529,alexraju,1,0.00006,388461,24.88417,1561077
19530,alexrp,1,0.00006,388462,24.88423,1561077
19531,alexskr,1,0.00006,388463,24.88429,1561077
19532,alexsloan,1,0.00006,388464,24.88436,1561077
19533,alex-souslik-hs,1,0.00006,388465,24.88442,1561077
19534,AlexTalker,1,0.00006,388466,24.88449,1561077
19535,AlexTawse,1,0.00006,388467,24.88455,1561077
19536,alextbrandwatch,1,0.00006,388468,24.88461,1561077
19537,alexter42,1,0.00006,388469,24.88468,1561077
19538,alex-w-k,1,0.00006,388470,24.88474,1561077
19539,AlfredHudson,1,0.00006,388471,24.88481,1561077
19540,alfredocambera,1,0.00006,388472,24.88487,1561077
19541,AlfredoVidalArmory,1,0.00006,388473,24.88494,1561077
19542,algoreriddum,1,0.00006,388474,24.88500,1561077
19543,alhoo,1,0.00006,388475,24.88506,1561077
19544,alialrabi,1,0.00006,388476,24.88513,1561077
19545,AliArdaOrhan,1,0.00006,388477,24.88519,1561077
19546,aliasfalse,1,0.00006,388478,24.88526,1561077
19547,aliasmani,1,0.00006,388479,24.88532,1561077
19548,ALibrada,1,0.00006,388480,24.88538,1561077
19549,alice0706,1,0.00006,388481,24.88545,1561077
19550,alick,1,0.00006,388482,24.88551,1561077
19551,aliei,1,0.00006,388483,24.88558,1561077
19552,alielgamal,1,0.00006,388484,24.88564,1561077
19553,alienfs,1,0.00006,388485,24.88570,1561077
19554,AlienHoboken,1,0.00006,388486,24.88577,1561077
19555,alienspaces,1,0.00006,388487,24.88583,1561077
19556,alifiroozi80,1,0.00006,388488,24.88590,1561077
19557,aligin,1,0.00006,388489,24.88596,1561077
19558,alikbm,1,0.00006,388490,24.88602,1561077
19559,alimeerutech,1,0.00006,388491,24.88609,1561077
19560,alincalinciuc,1,0.00006,388492,24.88615,1561077
19561,alindobre,1,0.00006,388493,24.88622,1561077
19562,alioguzhan,1,0.00006,388494,24.88628,1561077
19563,alisade,1,0.00006,388495,24.88634,1561077
19564,AlishahSingh20,1,0.00006,388496,24.88641,1561077
19565,alisonchico,1,0.00006,388497,24.88647,1561077
19566,alisson-gomesc,1,0.00006,388498,24.88654,1561077
19567,AlissonRS,1,0.00006,388499,24.88660,1561077
19568,alistaircross,1,0.00006,388500,24.88666,1561077
19569,alitariq4589,1,0.00006,388501,24.88673,1561077
19570,aliugenb,1,0.00006,388502,24.88679,1561077
19571,al-jamf,1,0.00006,388503,24.88686,1561077
19572,allahshukur-ahmadzada,1,0.00006,388504,24.88692,1561077
19573,allanffg,1,0.00006,388505,24.88699,1561077
19574,allanw,1,0.00006,388506,24.88705,1561077
19575,alledm,1,0.00006,388507,24.88711,1561077
19576,allenrice,1,0.00006,388508,24.88718,1561077
19577,alllexandrz,1,0.00006,388509,24.88724,1561077
19578,allomov,1,0.00006,388510,24.88731,1561077
19579,allpha,1,0.00006,388511,24.88737,1561077
19580,allthatjazzleo,1,0.00006,388512,24.88743,1561077
19581,allthecode0,1,0.00006,388513,24.88750,1561077
19582,almottier,1,0.00006,388514,24.88756,1561077
19583,almurray63,1,0.00006,388515,24.88763,1561077
19584,alonsoir,1,0.00006,388516,24.88769,1561077
19585,AlperennK,1,0.00006,388517,24.88775,1561077
19586,alphakevin,1,0.00006,388518,24.88782,1561077
19587,Alren-huang,1,0.00006,388519,24.88788,1561077
19588,alrf,1,0.00006,388520,24.88795,1561077
19589,alt250,1,0.00006,388521,24.88801,1561077
19590,althelion,1,0.00006,388522,24.88807,1561077
19591,althummar,1,0.00006,388523,24.88814,1561077
19592,altimea,1,0.00006,388524,24.88820,1561077
19593,altvnk,1,0.00006,388525,24.88827,1561077
19594,alubneuski,1,0.00006,388526,24.88833,1561077
19595,alustenberg,1,0.00006,388527,24.88839,1561077
19596,Alvarus,1,0.00006,388528,24.88846,1561077
19597,Alveel,1,0.00006,388529,24.88852,1561077
19598,AlvinChacko,1,0.00006,388530,24.88859,1561077
19599,AlvinSoong,1,0.00006,388531,24.88865,1561077
19600,alv-lop,1,0.00006,388532,24.88871,1561077
19601,Alwandy,1,0.00006,388533,24.88878,1561077
19602,alwaysharsha,1,0.00006,388534,24.88884,1561077
19603,alwayslurking,1,0.00006,388535,24.88891,1561077
19604,alwynpan,1,0.00006,388536,24.88897,1561077
19605,alxayo,1,0.00006,388537,24.88903,1561077
19606,alxch-,1,0.00006,388538,24.88910,1561077
19607,alyx-codez,1,0.00006,388539,24.88916,1561077
19608,amagar1,1,0.00006,388540,24.88923,1561077
19609,amalaowala,1,0.00006,388541,24.88929,1561077
19610,amalcp,1,0.00006,388542,24.88936,1561077
19611,amalsgit,1,0.00006,388543,24.88942,1561077
19612,amanda-skilljar,1,0.00006,388544,24.88948,1561077
19613,amangupta679,1,0.00006,388545,24.88955,1561077
19614,AmanMishra1321,1,0.00006,388546,24.88961,1561077
19615,amansatija,1,0.00006,388547,24.88968,1561077
19616,amansukhaniEBSCO,1,0.00006,388548,24.88974,1561077
19617,amar8821,1,0.00006,388549,24.88980,1561077
19618,amarm85,1,0.00006,388550,24.88987,1561077
19619,amartin755,1,0.00006,388551,24.88993,1561077
19620,amartyamandal,1,0.00006,388552,24.89000,1561077
19621,amattei,1,0.00006,388553,24.89006,1561077
19622,ambakshi,1,0.00006,388554,24.89012,1561077
19623,ambassi153,1,0.00006,388555,24.89019,1561077
19624,amberjungminlee,1,0.00006,388556,24.89025,1561077
19625,amchoukir,1,0.00006,388557,24.89032,1561077
19626,amdas383,1,0.00006,388558,24.89038,1561077
19627,amdoucette,1,0.00006,388559,24.89044,1561077
19628,AmedeeBulle,1,0.00006,388560,24.89051,1561077
19629,amejiarosario,1,0.00006,388561,24.89057,1561077
19630,amer,1,0.00006,388562,24.89064,1561077
19631,AmericusMommy,1,0.00006,388563,24.89070,1561077
19632,ameyanator,1,0.00006,388564,24.89076,1561077
19633,am-firnas,1,0.00006,388565,24.89083,1561077
19634,amhammett,1,0.00006,388566,24.89089,1561077
19635,amilstead,1,0.00006,388567,24.89096,1561077
19636,amine95bz,1,0.00006,388568,24.89102,1561077
19637,aminem15,1,0.00006,388569,24.89108,1561077
19638,aminsikhalizada,1,0.00006,388570,24.89115,1561077
19639,aminvakil,1,0.00006,388571,24.89121,1561077
19640,amireh,1,0.00006,388572,24.89128,1561077
19641,amirmisgav,1,0.00006,388573,24.89134,1561077
19642,amirmograbi,1,0.00006,388574,24.89141,1561077
19643,amirpzk,1,0.00006,388575,24.89147,1561077
19644,amit15091996,1,0.00006,388576,24.89153,1561077
19645,amit-301,1,0.00006,388577,24.89160,1561077
19646,amitbis,1,0.00006,388578,24.89166,1561077
19647,amitdhawan,1,0.00006,388579,24.89173,1561077
19648,amitgilad3,1,0.00006,388580,24.89179,1561077
19649,Amithahiriadaka,1,0.00006,388581,24.89185,1561077
19650,amit-kushwaha-std-ep,1,0.00006,388582,24.89192,1561077
19651,amitmahbubani,1,0.00006,388583,24.89198,1561077
19652,amitpandey2194,1,0.00006,388584,24.89205,1561077
19653,amitpawarcbg,1,0.00006,388585,24.89211,1561077
19654,amitrangari,1,0.00006,388586,24.89217,1561077
19655,amitrangaritelus,1,0.00006,388587,24.89224,1561077
19656,amitripshtos,1,0.00006,388588,24.89230,1561077
19657,amitron72,1,0.00006,388589,24.89237,1561077
19658,amitSA,1,0.00006,388590,24.89243,1561077
19659,amitvocate,1,0.00006,388591,24.89249,1561077
19660,amitydevops,1,0.00006,388592,24.89256,1561077
19661,amit-zact,1,0.00006,388593,24.89262,1561077
19662,amorillotraxens,1,0.00006,388594,24.89269,1561077
19663,amosro,1,0.00006,388595,24.89275,1561077
19664,amousa1968,1,0.00006,388596,24.89281,1561077
19665,ampc,1,0.00006,388597,24.89288,1561077
19666,ampie,1,0.00006,388598,24.89294,1561077
19667,amrabdelrahmanvaleo,1,0.00006,388599,24.89301,1561077
19668,amrichko,1,0.00006,388600,24.89307,1561077
19669,amrishseo02gmailcom,1,0.00006,388601,24.89313,1561077
19670,amritdeep,1,0.00006,388602,24.89320,1561077
19671,Amrith2020,1,0.00006,388603,24.89326,1561077
19672,amritihealthlabs,1,0.00006,388604,24.89333,1561077
19673,amrutprabhu,1,0.00006,388605,24.89339,1561077
19674,ams-tech,1,0.00006,388606,24.89345,1561077
19675,amtux,1,0.00006,388607,24.89352,1561077
19676,amymitch,1,0.00006,388608,24.89358,1561077
19677,analouarendaying20,1,0.00006,388609,24.89365,1561077
19678,AnamikaN,1,0.00006,388610,24.89371,1561077
19679,anamul-haque-sap,1,0.00006,388611,24.89378,1561077
19680,anandathithan,1,0.00006,388612,24.89384,1561077
19681,anandbvks,1,0.00006,388613,24.89390,1561077
19682,anandhs,1,0.00006,388614,24.89397,1561077
19683,anandjaisy,1,0.00006,388615,24.89403,1561077
19684,anandrkskd,1,0.00006,388616,24.89410,1561077
19685,anandvarkeyphilips,1,0.00006,388617,24.89416,1561077
19686,AnanthRavi,1,0.00006,388618,24.89422,1561077
19687,anantrajput523,1,0.00006,388619,24.89429,1561077
19688,AnatoliyDutchak,1,0.00006,388620,24.89435,1561077
19689,anauckunas,1,0.00006,388621,24.89442,1561077
19690,anbeque,1,0.00006,388622,24.89448,1561077
19691,anca1108,1,0.00006,388623,24.89454,1561077
19692,andchar,1,0.00006,388624,24.89461,1561077
19693,andeersg,1,0.00006,388625,24.89467,1561077
19694,anderso1,1,0.00006,388626,24.89474,1561077
19695,andikemgitopsbot,1,0.00006,388627,24.89480,1561077
19696,andradedpg,1,0.00006,388628,24.89486,1561077
19697,andre1987,1,0.00006,388629,24.89493,1561077
19698,Andre601,1,0.00006,388630,24.89499,1561077
19699,andrea-82,1,0.00006,388631,24.89506,1561077
19700,andreacab,1,0.00006,388632,24.89512,1561077
19701,andreacfm,1,0.00006,388633,24.89518,1561077
19702,andreasbenzing,1,0.00006,388634,24.89525,1561077
19703,andreas-doppelhofer,1,0.00006,388635,24.89531,1561077
19704,andreaseger,1,0.00006,388636,24.89538,1561077
19705,AndreasHohn,1,0.00006,388637,24.89544,1561077
19706,andreashouben,1,0.00006,388638,24.89550,1561077
19707,AndreasKarg,1,0.00006,388639,24.89557,1561077
19708,andreasmarkussen,1,0.00006,388640,24.89563,1561077
19709,andreasmuelhaupt,1,0.00006,388641,24.89570,1561077
19710,AndreasSoiron,1,0.00006,388642,24.89576,1561077
19711,andreasvirkus,1,0.00006,388643,24.89583,1561077
19712,andreaswittig,1,0.00006,388644,24.89589,1561077
19713,andreatondelli,1,0.00006,388645,24.89595,1561077
19714,andrea-vaccaro,1,0.00006,388646,24.89602,1561077
19715,AndreBrinkop,1,0.00006,388647,24.89608,1561077
19716,andreeagheorghescu,1,0.00006,388648,24.89615,1561077
19717,Andrei-85,1,0.00006,388649,24.89621,1561077
19718,andrei-cacio,1,0.00006,388650,24.89627,1561077
19719,andreijuc,1,0.00006,388651,24.89634,1561077
19720,andreimatveyeu,1,0.00006,388652,24.89640,1561077
19721,AndreiNikitin,1,0.00006,388653,24.89647,1561077
19722,andreisohan,1,0.00006,388654,24.89653,1561077
19723,andrei-tonita,1,0.00006,388655,24.89659,1561077
19724,andreldm,1,0.00006,388656,24.89666,1561077
19725,andrepinto,1,0.00006,388657,24.89672,1561077
19726,andrepintorj,1,0.00006,388658,24.89679,1561077
19727,andresrv94,1,0.00006,388659,24.89685,1561077
19728,AndreVirtimo,1,0.00006,388660,24.89691,1561077
19729,andrewbaillie91,1,0.00006,388661,24.89698,1561077
19730,andrewcamerondouglas,1,0.00006,388662,24.89704,1561077
19731,AndrewCFerrari,1,0.00006,388663,24.89711,1561077
19732,andrewcheny,1,0.00006,388664,24.89717,1561077
19733,andrew-eng,1,0.00006,388665,24.89723,1561077
19734,andrew-garner,1,0.00006,388666,24.89730,1561077
19735,andrewhood125,1,0.00006,388667,24.89736,1561077
19736,andrewjaanuu,1,0.00006,388668,24.89743,1561077
19737,andrewjkerr,1,0.00006,388669,24.89749,1561077
19738,andrewkaczynski,1,0.00006,388670,24.89755,1561077
19739,andrewkm,1,0.00006,388671,24.89762,1561077
19740,andrewkro,1,0.00006,388672,24.89768,1561077
19741,andrew-speers,1,0.00006,388673,24.89775,1561077
19742,AndrewsTDA,1,0.00006,388674,24.89781,1561077
19743,andrewtoth,1,0.00006,388675,24.89787,1561077
19744,andrewzhaosc,1,0.00006,388676,24.89794,1561077
19745,andrey3diq,1,0.00006,388677,24.89800,1561077
19746,andreyminov,1,0.00006,388678,24.89807,1561077
19747,andreyshade,1,0.00006,388679,24.89813,1561077
19748,AndreyShamis,1,0.00006,388680,24.89820,1561077
19749,andreyzher,1,0.00006,388681,24.89826,1561077
19750,AndreyZykov,1,0.00006,388682,24.89832,1561077
19751,andrii29,1,0.00006,388683,24.89839,1561077
19752,andrikoz,1,0.00006,388684,24.89845,1561077
19753,andriuss-xilinx,1,0.00006,388685,24.89852,1561077
19754,Andriy-Sorochak,1,0.00006,388686,24.89858,1561077
19755,Android1029,1,0.00006,388687,24.89864,1561077
19756,andrusha19,1,0.00006,388688,24.89871,1561077
19757,andvolodko,1,0.00006,388689,24.89877,1561077
19758,andyberry88,1,0.00006,388690,24.89884,1561077
19759,andycockerill-cpi,1,0.00006,388691,24.89890,1561077
19760,andy-dws,1,0.00006,388692,24.89896,1561077
19761,andyjansson,1,0.00006,388693,24.89903,1561077
19762,andyjohns,1,0.00006,388694,24.89909,1561077
19763,andyleclair,1,0.00006,388695,24.89916,1561077
19764,andylhz-mojie,1,0.00006,388696,24.89922,1561077
19765,andymcf,1,0.00006,388697,24.89928,1561077
19766,AndyNelsenTR,1,0.00006,388698,24.89935,1561077
19767,andynemzek,1,0.00006,388699,24.89941,1561077
19768,andyperlitch,1,0.00006,388700,24.89948,1561077
19769,andyreagan,1,0.00006,388701,24.89954,1561077
19770,andytson-inviqa,1,0.00006,388702,24.89960,1561077
19771,aneela1,1,0.00006,388703,24.89967,1561077
19772,aneesh-joseph,1,0.00006,388704,24.89973,1561077
19773,anetbnd,1,0.00006,388705,24.89980,1561077
19774,anfxanfx,1,0.00006,388706,24.89986,1561077
19775,angbamfield,1,0.00006,388707,24.89992,1561077
19776,angelabad,1,0.00006,388708,24.89999,1561077
19777,angelblade27,1,0.00006,388709,24.90005,1561077
19778,angel-git,1,0.00006,388710,24.90012,1561077
19779,angel-moveapps,1,0.00006,388711,24.90018,1561077
19780,angelorod,1,0.00006,388712,24.90025,1561077
19781,angelsclare,1,0.00006,388713,24.90031,1561077
19782,angueta,1,0.00006,388714,24.90037,1561077
19783,angus-88,1,0.00006,388715,24.90044,1561077
19784,angusmf,1,0.00006,388716,24.90050,1561077
19785,Anh-Vo,1,0.00006,388717,24.90057,1561077
19786,ANI2407rudh,1,0.00006,388718,24.90063,1561077
19787,anic,1,0.00006,388719,24.90069,1561077
19788,anichari,1,0.00006,388720,24.90076,1561077
19789,anicolas,1,0.00006,388721,24.90082,1561077
19790,AniGarikipati,1,0.00006,388722,24.90089,1561077
19791,anikamurarka,1,0.00006,388723,24.90095,1561077
19792,Aniket1989,1,0.00006,388724,24.90101,1561077
19793,anikiej,1,0.00006,388725,24.90108,1561077
19794,anilaraveti,1,0.00006,388726,24.90114,1561077
19795,anilk14,1,0.00006,388727,24.90121,1561077
19796,anilkumarpanditi,1,0.00006,388728,24.90127,1561077
19797,anilkumk,1,0.00006,388729,24.90133,1561077
19798,anilsakr,1,0.00006,388730,24.90140,1561077
19799,animit-kulkarni,1,0.00006,388731,24.90146,1561077
19800,AnirudhDagar,1,0.00006,388732,24.90153,1561077
19801,AnishBAH,1,0.00006,388733,24.90159,1561077
19802,AnjaleeJung52,1,0.00006,388734,24.90165,1561077
19803,AnjuMeleth,1,0.00006,388735,24.90172,1561077
19804,ankcrimson,1,0.00006,388736,24.90178,1561077
19805,ankit-arora-369,1,0.00006,388737,24.90185,1561077
19806,ankitc26,1,0.00006,388738,24.90191,1561077
19807,ankitg1989,1,0.00006,388739,24.90197,1561077
19808,ankitkhadria1,1,0.00006,388740,24.90204,1561077
19809,ankur25140,1,0.00006,388741,24.90210,1561077
19810,ankur47,1,0.00006,388742,24.90217,1561077
19811,ankur83d,1,0.00006,388743,24.90223,1561077
19812,ankushkhobragade,1,0.00006,388744,24.90230,1561077
19813,anlambert,1,0.00006,388745,24.90236,1561077
19814,anmakove,1,0.00006,388746,24.90242,1561077
19815,anmolmore15,1,0.00006,388747,24.90249,1561077
19816,annafw,1,0.00006,388748,24.90255,1561077
19817,AnnaHaylett,1,0.00006,388749,24.90262,1561077
19818,AnnD-K,1,0.00006,388750,24.90268,1561077
19819,anne23,1,0.00006,388751,24.90274,1561077
19820,anneq,1,0.00006,388752,24.90281,1561077
19821,annmcd,1,0.00006,388753,24.90287,1561077
19822,anonfriese,1,0.00006,388754,24.90294,1561077
19823,anonimitoraf,1,0.00006,388755,24.90300,1561077
19824,ansafonov,1,0.00006,388756,24.90306,1561077
19825,an-sangkil,1,0.00006,388757,24.90313,1561077
19826,anshchauhan,1,0.00006,388758,24.90319,1561077
19827,Anshul22Verma,1,0.00006,388759,24.90326,1561077
19828,anshulOpscale,1,0.00006,388760,24.90332,1561077
19829,anshulpatel25,1,0.00006,388761,24.90338,1561077
19830,anshulverma22,1,0.00006,388762,24.90345,1561077
19831,ansib,1,0.00006,388763,24.90351,1561077
19832,ansraliant,1,0.00006,388764,24.90358,1561077
19833,ant100,1,0.00006,388765,24.90364,1561077
19834,antbewes,1,0.00006,388766,24.90370,1561077
19835,anthoai97,1,0.00006,388767,24.90377,1561077
19836,AnthonyBarbier,1,0.00006,388768,24.90383,1561077
19837,anthonyGuo,1,0.00006,388769,24.90390,1561077
19838,anthonylau,1,0.00006,388770,24.90396,1561077
19839,anthony-zawacki,1,0.00006,388771,24.90402,1561077
19840,Antobbo,1,0.00006,388772,24.90409,1561077
19841,antoinebourayne,1,0.00006,388773,24.90415,1561077
19842,antoine-mg,1,0.00006,388774,24.90422,1561077
19843,AntoineMonnet,1,0.00006,388775,24.90428,1561077
19844,antoinemvh,1,0.00006,388776,24.90434,1561077
19845,antoinepourriot,1,0.00006,388777,24.90441,1561077
19846,antoinesaliba,1,0.00006,388778,24.90447,1561077
19847,anton7811,1,0.00006,388779,24.90454,1561077
19848,antonin07130,1,0.00006,388780,24.90460,1561077
19849,antonioamendoladev,1,0.00006,388781,24.90467,1561077
19850,AntonioCayulao,1,0.00006,388782,24.90473,1561077
19851,antoniodna,1,0.00006,388783,24.90479,1561077
19852,antoniosthanasisgit,1,0.00006,388784,24.90486,1561077
19853,antonio-tolentino,1,0.00006,388785,24.90492,1561077
19854,anton-kasperovich,1,0.00006,388786,24.90499,1561077
19855,anton-kyrylenko,1,0.00006,388787,24.90505,1561077
19856,antonmirko,1,0.00006,388788,24.90511,1561077
19857,antonmos,1,0.00006,388789,24.90518,1561077
19858,AntonOfTheWoods,1,0.00006,388790,24.90524,1561077
19859,antonovicha,1,0.00006,388791,24.90531,1561077
19860,antonpatsev,1,0.00006,388792,24.90537,1561077
19861,AntonSalnikov,1,0.00006,388793,24.90543,1561077
19862,AntonyRileyAtVerto,1,0.00006,388794,24.90550,1561077
19863,antwan2093,1,0.00006,388795,24.90556,1561077
19864,antydemant,1,0.00006,388796,24.90563,1561077
19865,anu11may,1,0.00006,388797,24.90569,1561077
19866,anubes19,1,0.00006,388798,24.90575,1561077
19867,Anubhav0072,1,0.00006,388799,24.90582,1561077
19868,Anujakumari,1,0.00006,388800,24.90588,1561077
19869,anuo,1,0.00006,388801,24.90595,1561077
19870,anup8000,1,0.00006,388802,24.90601,1561077
19871,anupama513,1,0.00006,388803,24.90607,1561077
19872,anupamgogoi0907,1,0.00006,388804,24.90614,1561077
19873,anuppoojari,1,0.00006,388805,24.90620,1561077
19874,anupprakash,1,0.00006,388806,24.90627,1561077
19875,anupreet19,1,0.00006,388807,24.90633,1561077
19876,anupshrestha,1,0.00006,388808,24.90639,1561077
19877,Anuraag-Advani,1,0.00006,388809,24.90646,1561077
19878,Anurag-Band,1,0.00006,388810,24.90652,1561077
19879,anushamalledi,1,0.00006,388811,24.90659,1561077
19880,anushkagarg,1,0.00006,388812,24.90665,1561077
19881,anvithgowda,1,0.00006,388813,24.90672,1561077
19882,anwoolterton,1,0.00006,388814,24.90678,1561077
19883,anyangocynthia,1,0.00006,388815,24.90684,1561077
19884,anz-ecp,1,0.00006,388816,24.90691,1561077
19885,aodeniyide,1,0.00006,388817,24.90697,1561077
19886,aogorodnikov,1,0.00006,388818,24.90704,1561077
19887,aomega08,1,0.00006,388819,24.90710,1561077
19888,aosheter,1,0.00006,388820,24.90716,1561077
19889,aostrcontinuum,1,0.00006,388821,24.90723,1561077
19890,ap200027,1,0.00006,388822,24.90729,1561077
19891,ApacheEx,1,0.00006,388823,24.90736,1561077
19892,apallares19,1,0.00006,388824,24.90742,1561077
19893,aparker591,1,0.00006,388825,24.90748,1561077
19894,apasrini,1,0.00006,388826,24.90755,1561077
19895,apatr,1,0.00006,388827,24.90761,1561077
19896,apavlidi,1,0.00006,388828,24.90768,1561077
19897,apeckys,1,0.00006,388829,24.90774,1561077
19898,aperdomob,1,0.00006,388830,24.90780,1561077
19899,aperesypkin,1,0.00006,388831,24.90787,1561077
19900,apeteri,1,0.00006,388832,24.90793,1561077
19901,apgallon,1,0.00006,388833,24.90800,1561077
19902,apkatsikas,1,0.00006,388834,24.90806,1561077
19903,aplsms,1,0.00006,388835,24.90812,1561077
19904,apolegoshko,1,0.00006,388836,24.90819,1561077
19905,Apoorv-Gaurav-Agarwal,1,0.00006,388837,24.90825,1561077
19906,apopescu99,1,0.00006,388838,24.90832,1561077
19907,Aposhian,1,0.00006,388839,24.90838,1561077
19908,appranix-admin,1,0.00006,388840,24.90844,1561077
19909,appraveen,1,0.00006,388841,24.90851,1561077
19910,apriendeau,1,0.00006,388842,24.90857,1561077
19911,aprilkmace,1,0.00006,388843,24.90864,1561077
19912,apritykin,1,0.00006,388844,24.90870,1561077
19913,aptalca,1,0.00006,388845,24.90876,1561077
19914,apton-sooraj,1,0.00006,388846,24.90883,1561077
19915,apurbain,1,0.00006,388847,24.90889,1561077
19916,ApurvDevops,1,0.00006,388848,24.90896,1561077
19917,Apyz,1,0.00006,388849,24.90902,1561077
19918,aqua2021,1,0.00006,388850,24.90909,1561077
19919,Aquarius888,1,0.00006,388851,24.90915,1561077
19920,aquasika,1,0.00006,388852,24.90921,1561077
19921,aqyx,1,0.00006,388853,24.90928,1561077
19922,arapoport,1,0.00006,388854,24.90934,1561077
19923,arashcuzi,1,0.00006,388855,24.90941,1561077
19924,arashm2,1,0.00006,388856,24.90947,1561077
19925,arashmalekzadeh,1,0.00006,388857,24.90953,1561077
19926,arausuy,1,0.00006,388858,24.90960,1561077
19927,aravichandran,1,0.00006,388859,24.90966,1561077
19928,aravindgv,1,0.00006,388860,24.90973,1561077
19929,aravindsuram,1,0.00006,388861,24.90979,1561077
19930,aravinthchandramouli,1,0.00006,388862,24.90985,1561077
19931,ArbazSheikh,1,0.00006,388863,24.90992,1561077
19932,arbe,1,0.00006,388864,24.90998,1561077
19933,archolewa,1,0.00006,388865,24.91005,1561077
19934,Archonoid,1,0.00006,388866,24.91011,1561077
19935,arciisine,1,0.00006,388867,24.91017,1561077
19936,arctanzyy,1,0.00006,388868,24.91024,1561077
19937,are512,1,0.00006,388869,24.91030,1561077
19938,arechavarria,1,0.00006,388870,24.91037,1561077
19939,arendej,1,0.00006,388871,24.91043,1561077
19940,aressem,1,0.00006,388872,24.91049,1561077
19941,arfciuu,1,0.00006,388873,24.91056,1561077
19942,argeas,1,0.00006,388874,24.91062,1561077
19943,arghya18,1,0.00006,388875,24.91069,1561077
19944,arharovec,1,0.00006,388876,24.91075,1561077
19945,arharvey918,1,0.00006,388877,24.91081,1561077
19946,Ariana-Hlavaty-i2,1,0.00006,388878,24.91088,1561077
19947,arichards215,1,0.00006,388879,24.91094,1561077
19948,arielb2,1,0.00006,388880,24.91101,1561077
19949,arielbangiev,1,0.00006,388881,24.91107,1561077
19950,arielcloud,1,0.00006,388882,24.91114,1561077
19951,arielelkin,1,0.00006,388883,24.91120,1561077
19952,ariellevy,1,0.00006,388884,24.91126,1561077
19953,arielschiavoni,1,0.00006,388885,24.91133,1561077
19954,arielsrv,1,0.00006,388886,24.91139,1561077
19955,ArielZhang,1,0.00006,388887,24.91146,1561077
19956,aries1980,1,0.00006,388888,24.91152,1561077
19957,ariesduanmu,1,0.00006,388889,24.91158,1561077
19958,ArievdB,1,0.00006,388890,24.91165,1561077
19959,arifmukhthar,1,0.00006,388891,24.91171,1561077
19960,arijitdhar,1,0.00006,388892,24.91178,1561077
19961,arioch,1,0.00006,388893,24.91184,1561077
19962,ariretiarno,1,0.00006,388894,24.91190,1561077
19963,ArisBlkkr,1,0.00006,388895,24.91197,1561077
19964,arjunKay,1,0.00006,388896,24.91203,1561077
19965,arjunnayak11,1,0.00006,388897,24.91210,1561077
19966,arjunprabhulal,1,0.00006,388898,24.91216,1561077
19967,arjunsbabu43,1,0.00006,388899,24.91222,1561077
19968,arkachat,1,0.00006,388900,24.91229,1561077
19969,arkadiyk,1,0.00006,388901,24.91235,1561077
19970,arkadye,1,0.00006,388902,24.91242,1561077
19971,arkaitzj,1,0.00006,388903,24.91248,1561077
19972,Arlechin,1,0.00006,388904,24.91254,1561077
19973,armandocanals,1,0.00006,388905,24.91261,1561077
19974,arnabcse28,1,0.00006,388906,24.91267,1561077
19975,arnaud-lb,1,0.00006,388907,24.91274,1561077
19976,arnav3000,1,0.00006,388908,24.91280,1561077
19977,arnisjuraga,1,0.00006,388909,24.91286,1561077
19978,ArnoldKell,1,0.00006,388910,24.91293,1561077
19979,arnoldyahad,1,0.00006,388911,24.91299,1561077
19980,arodus,1,0.00006,388912,24.91306,1561077
19981,arolls,1,0.00006,388913,24.91312,1561077
19982,aRooooooba,1,0.00006,388914,24.91318,1561077
19983,aroq,1,0.00006,388915,24.91325,1561077
19984,aroramayank2002,1,0.00006,388916,24.91331,1561077
19985,arosales,1,0.00006,388917,24.91338,1561077
19986,aross,1,0.00006,388918,24.91344,1561077
19987,arowland-informatics,1,0.00006,388919,24.91351,1561077
19988,aroy27,1,0.00006,388920,24.91357,1561077
19989,arpansolanki,1,0.00006,388921,24.91363,1561077
19990,arpitgupta,1,0.00006,388922,24.91370,1561077
19991,arpitjain305,1,0.00006,388923,24.91376,1561077
19992,arprastogi,1,0.00006,388924,24.91383,1561077
19993,arran-huxtable,1,0.00006,388925,24.91389,1561077
19994,arsamigullin,1,0.00006,388926,24.91395,1561077
19995,arsgashaw1,1,0.00006,388927,24.91402,1561077
19996,Arshdeep88,1,0.00006,388928,24.91408,1561077
19997,arslaanmalik,1,0.00006,388929,24.91415,1561077
19998,artak116,1,0.00006,388930,24.91421,1561077
19999,artbaghdasaryan,1,0.00006,388931,24.91427,1561077
20000,artbycrunk,1,0.00006,388932,24.91434,1561077
20001,art-divin,1,0.00006,388933,24.91440,1561077
20002,ArtemChumachenko,1,0.00006,388934,24.91447,1561077
20003,artempervin,1,0.00006,388935,24.91453,1561077
20004,ArthiIreddy,1,0.00006,388936,24.91459,1561077
20005,arthur657834,1,0.00006,388937,24.91466,1561077
20006,arthur798,1,0.00006,388938,24.91472,1561077
20007,arthurkhlghatyan,1,0.00006,388939,24.91479,1561077
20008,arthurplma,1,0.00006,388940,24.91485,1561077
20009,artiombell,1,0.00006,388941,24.91491,1561077
20010,artizirk,1,0.00006,388942,24.91498,1561077
20011,artk199,1,0.00006,388943,24.91504,1561077
20012,artola,1,0.00006,388944,24.91511,1561077
20013,ArtourTetraPak,1,0.00006,388945,24.91517,1561077
20014,ArtS,1,0.00006,388946,24.91523,1561077
20015,Arts13,1,0.00006,388947,24.91530,1561077
20016,artsilenkov,1,0.00006,388948,24.91536,1561077
20017,artur-malinowski,1,0.00006,388949,24.91543,1561077
20018,Artusamak,1,0.00006,388950,24.91549,1561077
20019,ArtushGhandilyan,1,0.00006,388951,24.91556,1561077
20020,aruder77,1,0.00006,388952,24.91562,1561077
20021,arulmohanp,1,0.00006,388953,24.91568,1561077
20022,arulrajnet,1,0.00006,388954,24.91575,1561077
20023,arulselvan,1,0.00006,388955,24.91581,1561077
20024,arun-421,1,0.00006,388956,24.91588,1561077
20025,arun6445,1,0.00006,388957,24.91594,1561077
20026,aruna1715,1,0.00006,388958,24.91600,1561077
20027,arunamat,1,0.00006,388959,24.91607,1561077
20028,arunanc,1,0.00006,388960,24.91613,1561077
20029,arunpatyal,1,0.00006,388961,24.91620,1561077
20030,Arunrajg,1,0.00006,388962,24.91626,1561077
20031,arunveersingh,1,0.00006,388963,24.91632,1561077
20032,arupadhy,1,0.00006,388964,24.91639,1561077
20033,arvalaan,1,0.00006,388965,24.91645,1561077
20034,arvindpai,1,0.00006,388966,24.91652,1561077
20035,arvindpathare,1,0.00006,388967,24.91658,1561077
20036,Arvingrep,1,0.00006,388968,24.91664,1561077
20037,arvkonstantin,1,0.00006,388969,24.91671,1561077
20038,Arvoreen,1,0.00006,388970,24.91677,1561077
20039,aryzhkou,1,0.00006,388971,24.91684,1561077
20040,arzoo-midha,1,0.00006,388972,24.91690,1561077
20041,AsaAhlberg,1,0.00006,388973,24.91696,1561077
20042,asadbilu,1,0.00006,388974,24.91703,1561077
20043,asaf7011,1,0.00006,388975,24.91709,1561077
20044,asaf92,1,0.00006,388976,24.91716,1561077
20045,asafp-nice,1,0.00006,388977,24.91722,1561077
20046,asagi687,1,0.00006,388978,24.91728,1561077
20047,asanc115,1,0.00006,388979,24.91735,1561077
20048,asantos-fuze,1,0.00006,388980,24.91741,1561077
20049,asaphe,1,0.00006,388981,24.91748,1561077
20050,asbach,1,0.00006,388982,24.91754,1561077
20051,aschlei,1,0.00006,388983,24.91760,1561077
20052,ascholz,1,0.00006,388984,24.91767,1561077
20053,asciifaceman,1,0.00006,388985,24.91773,1561077
20054,asdwsda,1,0.00006,388986,24.91780,1561077
20055,asedel,1,0.00006,388987,24.91786,1561077
20056,asekra,1,0.00006,388988,24.91793,1561077
20057,aseno-grammatech,1,0.00006,388989,24.91799,1561077
20058,aserrallerios,1,0.00006,388990,24.91805,1561077
20059,aservedio,1,0.00006,388991,24.91812,1561077
20060,asgarma,1,0.00006,388992,24.91818,1561077
20061,asgerjensen,1,0.00006,388993,24.91825,1561077
20062,asgoel,1,0.00006,388994,24.91831,1561077
20063,Asha-Hiremath,1,0.00006,388995,24.91837,1561077
20064,ashaybatwal,1,0.00006,388996,24.91844,1561077
20065,ashay-mulesoft,1,0.00006,388997,24.91850,1561077
20066,AshCoolman,1,0.00006,388998,24.91857,1561077
20067,AshCripps,1,0.00006,388999,24.91863,1561077
20068,ashenp,1,0.00006,389000,24.91869,1561077
20069,asherlporetz,1,0.00006,389001,24.91876,1561077
20070,ashhwani,1,0.00006,389002,24.91882,1561077
20071,ashinde20,1,0.00006,389003,24.91889,1561077
20072,ashiru,1,0.00006,389004,24.91895,1561077
20073,ashish160294,1,0.00006,389005,24.91901,1561077
20074,ashish-saha,1,0.00006,389006,24.91908,1561077
20075,ashishsme14,1,0.00006,389007,24.91914,1561077
20076,AshishThakur,1,0.00006,389008,24.91921,1561077
20077,ashiskumarnaik,1,0.00006,389009,24.91927,1561077
20078,ashithwilson,1,0.00006,389010,24.91933,1561077
20079,ashkulz,1,0.00006,389011,24.91940,1561077
20080,ashleypittman,1,0.00006,389012,24.91946,1561077
20081,ashmere,1,0.00006,389013,24.91953,1561077
20082,Ashok82,1,0.00006,389014,24.91959,1561077
20083,ashok9git,1,0.00006,389015,24.91965,1561077
20084,ashokaklt,1,0.00006,389016,24.91972,1561077
20085,ashokmahato,1,0.00006,389017,24.91978,1561077
20086,ashok-sri,1,0.00006,389018,24.91985,1561077
20087,ashoksvumca,1,0.00006,389019,24.91991,1561077
20088,AshrayViswanath,1,0.00006,389020,24.91998,1561077
20089,ashrimalivmware,1,0.00006,389021,24.92004,1561077
20090,ashuoooo,1,0.00006,389022,24.92010,1561077
20091,ashutosh175,1,0.00006,389023,24.92017,1561077
20092,ashutosh3105,1,0.00006,389024,24.92023,1561077
20093,ashvini,1,0.00006,389025,24.92030,1561077
20094,ashwani-dlt,1,0.00006,389026,24.92036,1561077
20095,AshwinKul28,1,0.00006,389027,24.92042,1561077
20096,ashwin-subramanian,1,0.00006,389028,24.92049,1561077
20097,askldjd,1,0.00006,389029,24.92055,1561077
20098,askmeegs,1,0.00006,389030,24.92062,1561077
20099,askoobe,1,0.00006,389031,24.92068,1561077
20100,asmarre,1,0.00006,389032,24.92074,1561077
20101,asmidutz,1,0.00006,389033,24.92081,1561077
20102,asmild,1,0.00006,389034,24.92087,1561077
20103,aso1datov,1,0.00006,389035,24.92094,1561077
20104,a-socha,1,0.00006,389036,24.92100,1561077
20105,asogbetun,1,0.00006,389037,24.92106,1561077
20106,asoldo11,1,0.00006,389038,24.92113,1561077
20107,Aspekt112,1,0.00006,389039,24.92119,1561077
20108,aspring,1,0.00006,389040,24.92126,1561077
20109,asrajmane193,1,0.00006,389041,24.92132,1561077
20110,asrivastava2017,1,0.00006,389042,24.92138,1561077
20111,assens,1,0.00006,389043,24.92145,1561077
20112,asteele0,1,0.00006,389044,24.92151,1561077
20113,astephen-conga,1,0.00006,389045,24.92158,1561077
20114,astuetz,1,0.00006,389046,24.92164,1561077
20115,astwyg,1,0.00006,389047,24.92170,1561077
20116,asubodh,1,0.00006,389048,24.92177,1561077
20117,asuri3,1,0.00006,389049,24.92183,1561077
20118,asvishnyakov,1,0.00006,389050,24.92190,1561077
20119,Aswartha-Rupa,1,0.00006,389051,24.92196,1561077
20120,Aswinidasm,1,0.00006,389052,24.92202,1561077
20121,AswinKakarot,1,0.00006,389053,24.92209,1561077
20122,asyd,1,0.00006,389054,24.92215,1561077
20123,asztal,1,0.00006,389055,24.92222,1561077
20124,aTadatoshiTokutake,1,0.00006,389056,24.92228,1561077
20125,AtanuNeogi,1,0.00006,389057,24.92235,1561077
20126,atc-,1,0.00006,389058,24.92241,1561077
20127,ATECU,1,0.00006,389059,24.92247,1561077
20128,ateglas,1,0.00006,389060,24.92254,1561077
20129,ath88,1,0.00006,389061,24.92260,1561077
20130,atharfaraz,1,0.00006,389062,24.92267,1561077
20131,atheros,1,0.00006,389063,24.92273,1561077
20132,AthithChandra,1,0.00006,389064,24.92279,1561077
20133,athkalia,1,0.00006,389065,24.92286,1561077
20134,athrane,1,0.00006,389066,24.92292,1561077
20135,AthulMohanDevkar,1,0.00006,389067,24.92299,1561077
20136,atif7865,1,0.00006,389068,24.92305,1561077
20137,atistler,1,0.00006,389069,24.92311,1561077
20138,atlix,1,0.00006,389070,24.92318,1561077
20139,atmosx,1,0.00006,389071,24.92324,1561077
20140,atomicleads,1,0.00006,389072,24.92331,1561077
20141,atomLee1,1,0.00006,389073,24.92337,1561077
20142,atomporowski,1,0.00006,389074,24.92343,1561077
20143,Atomschinken,1,0.00006,389075,24.92350,1561077
20144,atom-x,1,0.00006,389076,24.92356,1561077
20145,attrib,1,0.00006,389077,24.92363,1561077
20146,atulag91,1,0.00006,389078,24.92369,1561077
20147,atutorme,1,0.00006,389079,24.92375,1561077
20148,at-vinhhuynh,1,0.00006,389080,24.92382,1561077
20149,atward,1,0.00006,389081,24.92388,1561077
20150,atwright,1,0.00006,389082,24.92395,1561077
20151,a-type,1,0.00006,389083,24.92401,1561077
20152,atzoum,1,0.00006,389084,24.92407,1561077
20153,Aub-C,1,0.00006,389085,24.92414,1561077
20154,audalykh,1,0.00006,389086,24.92420,1561077
20155,augu65,1,0.00006,389087,24.92427,1561077
20156,a-umaniuc,1,0.00006,389088,24.92433,1561077
20157,auqf,1,0.00006,389089,24.92440,1561077
20158,aurelienlt,1,0.00006,389090,24.92446,1561077
20159,aurelien-poscia-sonarsource,1,0.00006,389091,24.92452,1561077
20160,auser,1,0.00006,389092,24.92459,1561077
20161,austinkelleher,1,0.00006,389093,24.92465,1561077
20162,austinpapp,1,0.00006,389094,24.92472,1561077
20163,AustinReichert,1,0.00006,389095,24.92478,1561077
20164,austinstoker,1,0.00006,389096,24.92484,1561077
20165,autarch,1,0.00006,389097,24.92491,1561077
20166,authayam,1,0.00006,389098,24.92497,1561077
20167,autoGirl,1,0.00006,389099,24.92504,1561077
20168,Automationrode,1,0.00006,389100,24.92510,1561077
20169,auula,1,0.00006,389101,24.92516,1561077
20170,avadhmr,1,0.00006,389102,24.92523,1561077
20171,avaiss,1,0.00006,389103,24.92529,1561077
20172,AvaJay,1,0.00006,389104,24.92536,1561077
20173,avallecillac,1,0.00006,389105,24.92542,1561077
20174,avances123,1,0.00006,389106,24.92548,1561077
20175,avazhnov-griddynamics,1,0.00006,389107,24.92555,1561077
20176,avchulkov,1,0.00006,389108,24.92561,1561077
20177,AvetSargsyan,1,0.00006,389109,24.92568,1561077
20178,avichal-neweradeveloper,1,0.00006,389110,24.92574,1561077
20179,Avikam123,1,0.00006,389111,24.92580,1561077
20180,a-villagra,1,0.00006,389112,24.92587,1561077
20181,avillev,1,0.00006,389113,24.92593,1561077
20182,avinashmuvva,1,0.00006,389114,24.92600,1561077
20183,avineshwar,1,0.00006,389115,24.92606,1561077
20184,avinogradov,1,0.00006,389116,24.92612,1561077
20185,aviorma,1,0.00006,389117,24.92619,1561077
20186,aviscaerulea,1,0.00006,389118,24.92625,1561077
20187,Avishek1210,1,0.00006,389119,24.92632,1561077
20188,avishekroy63,1,0.00006,389120,24.92638,1561077
20189,aviv-clover,1,0.00006,389121,24.92645,1561077
20190,avivmu,1,0.00006,389122,24.92651,1561077
20191,avlad,1,0.00006,389123,24.92657,1561077
20192,avloss,1,0.00006,389124,24.92664,1561077
20193,avnerbarr,1,0.00006,389125,24.92670,1561077
20194,AvnerCohen,1,0.00006,389126,24.92677,1561077
20195,AvoCH,1,0.00006,389127,24.92683,1561077
20196,avogler,1,0.00006,389128,24.92689,1561077
20197,avoosh,1,0.00006,389129,24.92696,1561077
20198,Awawdi,1,0.00006,389130,24.92702,1561077
20199,awebneck,1,0.00006,389131,24.92709,1561077
20200,AwesomeBobX64,1,0.00006,389132,24.92715,1561077
20201,AwesomeDude091,1,0.00006,389133,24.92721,1561077
20202,awillinger-work,1,0.00006,389134,24.92728,1561077
20203,awons,1,0.00006,389135,24.92734,1561077
20204,AwooPH,1,0.00006,389136,24.92741,1561077
20205,awootton,1,0.00006,389137,24.92747,1561077
20206,awsanu,1,0.00006,389138,24.92753,1561077
20207,aw-was-here,1,0.00006,389139,24.92760,1561077
20208,axelramirez21,1,0.00006,389140,24.92766,1561077
20209,axgrap,1,0.00006,389141,24.92773,1561077
20210,axisofentropy,1,0.00006,389142,24.92779,1561077
20211,aya-hamed1,1,0.00006,389143,24.92785,1561077
20212,ayalaio,1,0.00006,389144,24.92792,1561077
20213,AyaSerry,1,0.00006,389145,24.92798,1561077
20214,ayasuda2003,1,0.00006,389146,24.92805,1561077
20215,ayeja,1,0.00006,389147,24.92811,1561077
20216,ayen-tibco,1,0.00006,389148,24.92817,1561077
20217,ay-man,1,0.00006,389149,24.92824,1561077
20218,ayokyun,1,0.00006,389150,24.92830,1561077
20219,ayoubboulila,1,0.00006,389151,24.92837,1561077
20220,ayoub-elbachiri,1,0.00006,389152,24.92843,1561077
20221,ayoubensalem,1,0.00006,389153,24.92849,1561077
20222,aytekk,1,0.00006,389154,24.92856,1561077
20223,AyubOpen,1,0.00006,389155,24.92862,1561077
20224,ayush-devops,1,0.00006,389156,24.92869,1561077
20225,ayushi-test,1,0.00006,389157,24.92875,1561077
20226,a-zacharenkov,1,0.00006,389158,24.92882,1561077
20227,azakharenka,1,0.00006,389159,24.92888,1561077
20228,azakordonets,1,0.00006,389160,24.92894,1561077
20229,a-zen,1,0.00006,389161,24.92901,1561077
20230,azenakhi,1,0.00006,389162,24.92907,1561077
20231,azheval,1,0.00006,389163,24.92914,1561077
20232,azizmethiwala123,1,0.00006,389164,24.92920,1561077
20233,azoulad,1,0.00006,389165,24.92926,1561077
20234,Azrael808,1,0.00006,389166,24.92933,1561077
20235,aztechian,1,0.00006,389167,24.92939,1561077
20236,b0dh1,1,0.00006,389168,24.92946,1561077
20237,b1czu,1,0.00006,389169,24.92952,1561077
20238,b2234913,1,0.00006,389170,24.92958,1561077
20239,b2un0,1,0.00006,389171,24.92965,1561077
20240,b8,1,0.00006,389172,24.92971,1561077
20241,babakx,1,0.00006,389173,24.92978,1561077
20242,babbottscott,1,0.00006,389174,24.92984,1561077
20243,babielph,1,0.00006,389175,24.92990,1561077
20244,bac-dam-1991,1,0.00006,389176,24.92997,1561077
20245,bacharacherif,1,0.00006,389177,24.93003,1561077
20246,bachrilq,1,0.00006,389178,24.93010,1561077
20247,backbasejeff,1,0.00006,389179,24.93016,1561077
20248,bad884,1,0.00006,389180,24.93022,1561077
20249,badcorporatelogo,1,0.00006,389181,24.93029,1561077
20250,badevops,1,0.00006,389182,24.93035,1561077
20251,badger451,1,0.00006,389183,24.93042,1561077
20252,bad-hambo,1,0.00006,389184,24.93048,1561077
20253,badouuuuuu,1,0.00006,389185,24.93054,1561077
20254,baffamn,1,0.00006,389186,24.93061,1561077
20255,bagintz,1,0.00006,389187,24.93067,1561077
20256,baguasquirrel,1,0.00006,389188,24.93074,1561077
20257,bahrb,1,0.00006,389189,24.93080,1561077
20258,bailejl,1,0.00006,389190,24.93087,1561077
20259,bajjurisanthosh,1,0.00006,389191,24.93093,1561077
20260,bakaibalazs,1,0.00006,389192,24.93099,1561077
20261,bakasmarius,1,0.00006,389193,24.93106,1561077
20262,bakerlee,1,0.00006,389194,24.93112,1561077
20263,bakkc,1,0.00006,389195,24.93119,1561077
20264,balaarunreddyv1,1,0.00006,389196,24.93125,1561077
20265,balagaa,1,0.00006,389197,24.93131,1561077
20266,balagez,1,0.00006,389198,24.93138,1561077
20267,balajeetm,1,0.00006,389199,24.93144,1561077
20268,balamuraligceb05,1,0.00006,389200,24.93151,1561077
20269,balazs-pinter,1,0.00006,389201,24.93157,1561077
20270,balderbach,1,0.00006,389202,24.93163,1561077
20271,baldzern4,1,0.00006,389203,24.93170,1561077
20272,Ballwang,1,0.00006,389204,24.93176,1561077
20273,balooo,1,0.00006,389205,24.93183,1561077
20274,balta3,1,0.00006,389206,24.93189,1561077
20275,balualla,1,0.00006,389207,24.93195,1561077
20276,balukondamuri,1,0.00006,389208,24.93202,1561077
20277,balzic,1,0.00006,389209,24.93208,1561077
20278,bamb00,1,0.00006,389210,24.93215,1561077
20279,bamboox,1,0.00006,389211,24.93221,1561077
20280,banchuanyu,1,0.00006,389212,24.93227,1561077
20281,bandophahita,1,0.00006,389213,24.93234,1561077
20282,bangi123,1,0.00006,389214,24.93240,1561077
20283,bangkar,1,0.00006,389215,24.93247,1561077
20284,bansan85,1,0.00006,389216,24.93253,1561077
20285,banwang811,1,0.00006,389217,24.93259,1561077
20286,bapetc,1,0.00006,389218,24.93266,1561077
20287,bapril,1,0.00006,389219,24.93272,1561077
20288,baptistemesta,1,0.00006,389220,24.93279,1561077
20289,baraths84,1,0.00006,389221,24.93285,1561077
20290,barbarosalp,1,0.00006,389222,24.93291,1561077
20291,barbarosh,1,0.00006,389223,24.93298,1561077
20292,barcaxxx,1,0.00006,389224,24.93304,1561077
20293,barchinsky,1,0.00006,389225,24.93311,1561077
20294,bargemayur05,1,0.00006,389226,24.93317,1561077
20295,barnabyaaron,1,0.00006,389227,24.93324,1561077
20296,barnetd2,1,0.00006,389228,24.93330,1561077
20297,barnish,1,0.00006,389229,24.93336,1561077
20298,barra51,1,0.00006,389230,24.93343,1561077
20299,bartek-lopatka,1,0.00006,389231,24.93349,1561077
20300,bartekrutkowski,1,0.00006,389232,24.93356,1561077
20301,bartekurbanski,1,0.00006,389233,24.93362,1561077
20302,barthorre,1,0.00006,389234,24.93368,1561077
20303,barthr,1,0.00006,389235,24.93375,1561077
20304,barti80,1,0.00006,389236,24.93381,1561077
20305,BartoszStempien-TomTom,1,0.00006,389237,24.93388,1561077
20306,BartSaelen,1,0.00006,389238,24.93394,1561077
20307,bartuart,1,0.00006,389239,24.93400,1561077
20308,bartvanhoutte,1,0.00006,389240,24.93407,1561077
20309,based64god,1,0.00006,389241,24.93413,1561077
20310,bashkiby,1,0.00006,389242,24.93420,1561077
20311,bashou,1,0.00006,389243,24.93426,1561077
20312,BasicBeluga,1,0.00006,389244,24.93432,1561077
20313,basilevs,1,0.00006,389245,24.93439,1561077
20314,basivireddy,1,0.00006,389246,24.93445,1561077
20315,basmussen,1,0.00006,389247,24.93452,1561077
20316,basovnik,1,0.00006,389248,24.93458,1561077
20317,bassani2014,1,0.00006,389249,24.93464,1561077
20318,bastienlemaitre,1,0.00006,389250,24.93471,1561077
20319,basyskom-hlei,1,0.00006,389251,24.93477,1561077
20320,bataliero,1,0.00006,389252,24.93484,1561077
20321,bateau84,1,0.00006,389253,24.93490,1561077
20322,batesyuk,1,0.00006,389254,24.93496,1561077
20323,batman1911,1,0.00006,389255,24.93503,1561077
20324,battlesnake,1,0.00006,389256,24.93509,1561077
20325,Bavac,1,0.00006,389257,24.93516,1561077
20326,bavedarnow,1,0.00006,389258,24.93522,1561077
20327,baxterj,1,0.00006,389259,24.93529,1561077
20328,Bazyli-Kot,1,0.00006,389260,24.93535,1561077
20329,bazzargh,1,0.00006,389261,24.93541,1561077
20330,bbakersmith,1,0.00006,389262,24.93548,1561077
20331,bbankowski,1,0.00006,389263,24.93554,1561077
20332,bbansalWolfPack,1,0.00006,389264,24.93561,1561077
20333,bbarhight,1,0.00006,389265,24.93567,1561077
20334,bbarreau,1,0.00006,389266,24.93573,1561077
20335,bbatliner,1,0.00006,389267,24.93580,1561077
20336,bbaugher,1,0.00006,389268,24.93586,1561077
20337,bb-benjaminl,1,0.00006,389269,24.93593,1561077
20338,bbc2,1,0.00006,389270,24.93599,1561077
20339,bbcrgoliveira,1,0.00006,389271,24.93605,1561077
20340,bb-dsa,1,0.00006,389272,24.93612,1561077
20341,bbeattie-phxlabs,1,0.00006,389273,24.93618,1561077
20342,bbendes,1,0.00006,389274,24.93625,1561077
20343,bberzinskas-tw,1,0.00006,389275,24.93631,1561077
20344,bblackham,1,0.00006,389276,24.93637,1561077
20345,bbossola,1,0.00006,389277,24.93644,1561077
20346,bboule,1,0.00006,389278,24.93650,1561077
20347,bboysca,1,0.00006,389279,24.93657,1561077
20348,bbratchiv,1,0.00006,389280,24.93663,1561077
20349,bbscripps,1,0.00006,389281,24.93669,1561077
20350,bcall-r7,1,0.00006,389282,24.93676,1561077
20351,bcamishrapr,1,0.00006,389283,24.93682,1561077
20352,bcerati,1,0.00006,389284,24.93689,1561077
20353,bchand44,1,0.00006,389285,24.93695,1561077
20354,bchanson,1,0.00006,389286,24.93701,1561077
20355,bchatelard,1,0.00006,389287,24.93708,1561077
20356,bchen88,1,0.00006,389288,24.93714,1561077
20357,bchiodo,1,0.00006,389289,24.93721,1561077
20358,bchipman,1,0.00006,389290,24.93727,1561077
20359,bcleenders,1,0.00006,389291,24.93733,1561077
20360,bcolferzd,1,0.00006,389292,24.93740,1561077
20361,BcTpe4HbIu,1,0.00006,389293,24.93746,1561077
20362,bcygan,1,0.00006,389294,24.93753,1561077
20363,bdcloud2020,1,0.00006,389295,24.93759,1561077
20364,bdeeming,1,0.00006,389296,24.93766,1561077
20365,bdentino,1,0.00006,389297,24.93772,1561077
20366,bdesham-vdx,1,0.00006,389298,24.93778,1561077
20367,bdimcheff,1,0.00006,389299,24.93785,1561077
20368,bdruemen,1,0.00006,389300,24.93791,1561077
20369,bdruth,1,0.00006,389301,24.93798,1561077
20370,bdzevel,1,0.00006,389302,24.93804,1561077
20371,bea26184,1,0.00006,389303,24.93810,1561077
20372,beanz,1,0.00006,389304,24.93817,1561077
20373,bearrito,1,0.00006,389305,24.93823,1561077
20374,beastob,1,0.00006,389306,24.93830,1561077
20375,beatrausch,1,0.00006,389307,24.93836,1561077
20376,BeckNT,1,0.00006,389308,24.93842,1561077
20377,bedeveloper123,1,0.00006,389309,24.93849,1561077
20378,bee-keeper,1,0.00006,389310,24.93855,1561077
20379,Beennnn,1,0.00006,389311,24.93862,1561077
20380,begault,1,0.00006,389312,24.93868,1561077
20381,beingamarnath,1,0.00006,389313,24.93874,1561077
20382,beklapko,1,0.00006,389314,24.93881,1561077
20383,belen-pruvost-sonarsource,1,0.00006,389315,24.93887,1561077
20384,belfo,1,0.00006,389316,24.93894,1561077
20385,bellkharkiv,1,0.00006,389317,24.93900,1561077
20386,belooussov,1,0.00006,389318,24.93906,1561077
20387,belsander,1,0.00006,389319,24.93913,1561077
20388,benairs3,1,0.00006,389320,24.93919,1561077
20389,benauca,1,0.00006,389321,24.93926,1561077
20390,BenCamareno,1,0.00006,389322,24.93932,1561077
20391,bencao,1,0.00006,389323,24.93938,1561077
20392,bencarrington,1,0.00006,389324,24.93945,1561077
20393,bencehornak,1,0.00006,389325,24.93951,1561077
20394,bencehornak-gls,1,0.00006,389326,24.93958,1561077
20395,ben-cripps,1,0.00006,389327,24.93964,1561077
20396,bendenoz,1,0.00006,389328,24.93971,1561077
20397,bendermIBM,1,0.00006,389329,24.93977,1561077
20398,benedict1986,1,0.00006,389330,24.93983,1561077
20399,benevitygh,1,0.00006,389331,24.93990,1561077
20400,benfab,1,0.00006,389332,24.93996,1561077
20401,benflodge,1,0.00006,389333,24.94003,1561077
20402,BengalBrony,1,0.00006,389334,24.94009,1561077
20403,ben-galusha,1,0.00006,389335,24.94015,1561077
20404,BenHildebrand,1,0.00006,389336,24.94022,1561077
20405,benissl,1,0.00006,389337,24.94028,1561077
20406,benjah1,1,0.00006,389338,24.94035,1561077
20407,BenjaminITS,1,0.00006,389339,24.94041,1561077
20408,benjamin-johnston,1,0.00006,389340,24.94047,1561077
20409,benjaminliugang,1,0.00006,389341,24.94054,1561077
20410,benjaminprojas,1,0.00006,389342,24.94060,1561077
20411,benjamint-bsquare,1,0.00006,389343,24.94067,1561077
20412,benjaques,1,0.00006,389344,24.94073,1561077
20413,benjroy,1,0.00006,389345,24.94079,1561077
20414,ben-lei-gfm,1,0.00006,389346,24.94086,1561077
20415,BenLinnik,1,0.00006,389347,24.94092,1561077
20416,benmappen,1,0.00006,389348,24.94099,1561077
20417,bennettmt,1,0.00006,389349,24.94105,1561077
20418,BennyHarv3,1,0.00006,389350,24.94111,1561077
20419,bennymestel,1,0.00006,389351,24.94118,1561077
20420,bennypi,1,0.00006,389352,24.94124,1561077
20421,benoit74,1,0.00006,389353,24.94131,1561077
20422,Benoit-Besnier,1,0.00006,389354,24.94137,1561077
20423,benoitbleuze,1,0.00006,389355,24.94143,1561077
20424,benoit-parmentier,1,0.00006,389356,24.94150,1561077
20425,Ben-Pfirsich,1,0.00006,389357,24.94156,1561077
20426,benSlaughter,1,0.00006,389358,24.94163,1561077
20427,Ben-Smith-AbleVets,1,0.00006,389359,24.94169,1561077
20428,bensquire,1,0.00006,389360,24.94175,1561077
20429,bentruyman,1,0.00006,389361,24.94182,1561077
20430,benwilkes9,1,0.00006,389362,24.94188,1561077
20431,benzier,1,0.00006,389363,24.94195,1561077
20432,benzsuankularb,1,0.00006,389364,24.94201,1561077
20433,BePo65,1,0.00006,389365,24.94208,1561077
20434,berabulut,1,0.00006,389366,24.94214,1561077
20435,berbiera,1,0.00006,389367,24.94220,1561077
20436,Bergil32,1,0.00006,389368,24.94227,1561077
20437,bergstenarn,1,0.00006,389369,24.94233,1561077
20438,berndhofmann,1,0.00006,389370,24.94240,1561077
20439,BerndPfaff,1,0.00006,389371,24.94246,1561077
20440,berngp,1,0.00006,389372,24.94252,1561077
20441,BerSomBen,1,0.00006,389373,24.94259,1561077
20442,bert2tag,1,0.00006,389374,24.94265,1561077
20443,bery,1,0.00006,389375,24.94272,1561077
20444,beshanoe,1,0.00006,389376,24.94278,1561077
20445,Best1s,1,0.00006,389377,24.94284,1561077
20446,bestofyour,1,0.00006,389378,24.94291,1561077
20447,betabandido,1,0.00006,389379,24.94297,1561077
20448,BetaKevin,1,0.00006,389380,24.94304,1561077
20449,betalb,1,0.00006,389381,24.94310,1561077
20450,betaorbust,1,0.00006,389382,24.94316,1561077
20451,beton-cementownia,1,0.00006,389383,24.94323,1561077
20452,betrcode,1,0.00006,389384,24.94329,1561077
20453,bewczardski,1,0.00006,389385,24.94336,1561077
20454,bfarayev,1,0.00006,389386,24.94342,1561077
20455,bfarka,1,0.00006,389387,24.94348,1561077
20456,bfederau,1,0.00006,389388,24.94355,1561077
20457,b-fein,1,0.00006,389389,24.94361,1561077
20458,bfwg,1,0.00006,389390,24.94368,1561077
20459,BGBiao,1,0.00006,389391,24.94374,1561077
20460,bgiorgini,1,0.00006,389392,24.94380,1561077
20461,bgmg20171120,1,0.00006,389393,24.94387,1561077
20462,bgrabows1,1,0.00006,389394,24.94393,1561077
20463,bgshacklett,1,0.00006,389395,24.94400,1561077
20464,bguerout,1,0.00006,389396,24.94406,1561077
20465,bhanu6009,1,0.00006,389397,24.94413,1561077
20466,Bhanuchander210,1,0.00006,389398,24.94419,1561077
20467,Bhanu-mbvg,1,0.00006,389399,24.94425,1561077
20468,bharath0080,1,0.00006,389400,24.94432,1561077
20469,Bharath-Ganesh,1,0.00006,389401,24.94438,1561077
20470,bharathik933,1,0.00006,389402,24.94445,1561077
20471,bharathkumar2020,1,0.00006,389403,24.94451,1561077
20472,bharathkumar33,1,0.00006,389404,24.94457,1561077
20473,bharathpantala,1,0.00006,389405,24.94464,1561077
20474,Bharatj5,1,0.00006,389406,24.94470,1561077
20475,bhaskarkancherla,1,0.00006,389407,24.94477,1561077
20476,bhat-ganesh,1,0.00006,389408,24.94483,1561077
20477,bhavanki,1,0.00006,389409,24.94489,1561077
20478,Bheemalingareddyh,1,0.00006,389410,24.94496,1561077
20479,bhellema,1,0.00006,389411,24.94502,1561077
20480,bhermosa,1,0.00006,389412,24.94509,1561077
20481,bhoaraju,1,0.00006,389413,24.94515,1561077
20482,bhorwood,1,0.00006,389414,24.94521,1561077
20483,bhundven,1,0.00006,389415,24.94528,1561077
20484,bhushansona,1,0.00006,389416,24.94534,1561077
20485,Bhuvanesh-G,1,0.00006,389417,24.94541,1561077
20486,bhuvi123ACACIA,1,0.00006,389418,24.94547,1561077
20487,biagi,1,0.00006,389419,24.94553,1561077
20488,biagiolampo,1,0.00006,389420,24.94560,1561077
20489,biaji,1,0.00006,389421,24.94566,1561077
20490,biancamrcf,1,0.00006,389422,24.94573,1561077
20491,bianconiglio,1,0.00006,389423,24.94579,1561077
20492,bienstock,1,0.00006,389424,24.94585,1561077
20493,BiernatPiotr,1,0.00006,389425,24.94592,1561077
20494,bifunctor,1,0.00006,389426,24.94598,1561077
20495,BigBrokkokliMan,1,0.00006,389427,24.94605,1561077
20496,bigdaddyc,1,0.00006,389428,24.94611,1561077
20497,bigdata-etl,1,0.00006,389429,24.94617,1561077
20498,Bigluu,1,0.00006,389430,24.94624,1561077
20499,bignay2000,1,0.00006,389431,24.94630,1561077
20500,bigoctopus8,1,0.00006,389432,24.94637,1561077
20501,Bigrich44,1,0.00006,389433,24.94643,1561077
20502,Bijaya196,1,0.00006,389434,24.94650,1561077
20503,bijaybisht,1,0.00006,389435,24.94656,1561077
20504,bikeusaland,1,0.00006,389436,24.94662,1561077
20505,bikrampaul123,1,0.00006,389437,24.94669,1561077
20506,Bilalaybar,1,0.00006,389438,24.94675,1561077
20507,Bilalssbb,1,0.00006,389439,24.94682,1561077
20508,bilki,1,0.00006,389440,24.94688,1561077
20509,Bill,1,0.00006,389441,24.94694,1561077
20510,Bill0412,1,0.00006,389442,24.94701,1561077
20511,bill23-kim,1,0.00006,389443,24.94707,1561077
20512,billestibor,1,0.00006,389444,24.94714,1561077
20513,billinra,1,0.00006,389445,24.94720,1561077
20514,BillioJeverson,1,0.00006,389446,24.94726,1561077
20515,billnorton,1,0.00006,389447,24.94733,1561077
20516,billstark,1,0.00006,389448,24.94739,1561077
20517,billyfoss,1,0.00006,389449,24.94746,1561077
20518,BillyGalbreath,1,0.00006,389450,24.94752,1561077
20519,billygoo,1,0.00006,389451,24.94758,1561077
20520,billypchan,1,0.00006,389452,24.94765,1561077
20521,bily621,1,0.00006,389453,24.94771,1561077
20522,bina-abhinav,1,0.00006,389454,24.94778,1561077
20523,binakot,1,0.00006,389455,24.94784,1561077
20524,binbjz,1,0.00006,389456,24.94790,1561077
20525,binbrayer,1,0.00006,389457,24.94797,1561077
20526,binhnh17,1,0.00006,389458,24.94803,1561077
20527,binjianwu,1,0.00006,389459,24.94810,1561077
20528,binlan,1,0.00006,389460,24.94816,1561077
20529,BinWayne,1,0.00006,389461,24.94822,1561077
20530,biodrone,1,0.00006,389462,24.94829,1561077
20531,Biorix,1,0.00006,389463,24.94835,1561077
20532,bioshazard,1,0.00006,389464,24.94842,1561077
20533,birlibirloque,1,0.00006,389465,24.94848,1561077
20534,bisi1,1,0.00006,389466,24.94855,1561077
20535,biskandar,1,0.00006,389467,24.94861,1561077
20536,biswarup1290dass,1,0.00006,389468,24.94867,1561077
20537,bitcalibrator,1,0.00006,389469,24.94874,1561077
20538,bitnik,1,0.00006,389470,24.94880,1561077
20539,BitOne,1,0.00006,389471,24.94887,1561077
20540,bitsofdave,1,0.00006,389472,24.94893,1561077
20541,bjarneo,1,0.00006,389473,24.94899,1561077
20542,bje,1,0.00006,389474,24.94906,1561077
20543,bjoernwenzel-tommapps,1,0.00006,389475,24.94912,1561077
20544,bjones,1,0.00006,389476,24.94919,1561077
20545,bjorncs,1,0.00006,389477,24.94925,1561077
20546,bjornreppen,1,0.00006,389478,24.94931,1561077
20547,Bjrules,1,0.00006,389479,24.94938,1561077
20548,bjsee,1,0.00006,389480,24.94944,1561077
20549,bjsignalfx,1,0.00006,389481,24.94951,1561077
20550,bk00041,1,0.00006,389482,24.94957,1561077
20551,bkowenswork,1,0.00006,389483,24.94963,1561077
20552,bkuszewski,1,0.00006,389484,24.94970,1561077
20553,bl4de,1,0.00006,389485,24.94976,1561077
20554,bl9690,1,0.00006,389486,24.94983,1561077
20555,blacix,1,0.00006,389487,24.94989,1561077
20556,blackandred,1,0.00006,389488,24.94995,1561077
20557,Blackbaud-KimberlyHammer,1,0.00006,389489,24.95002,1561077
20558,Blackbaud-SriniHasti,1,0.00006,389490,24.95008,1561077
20559,BlackDuckCoPilot,1,0.00006,389491,24.95015,1561077
20560,blackjack-jx-1,1,0.00006,389492,24.95021,1561077
20561,BlackMaria,1,0.00006,389493,24.95027,1561077
20562,Blackout77x,1,0.00006,389494,24.95034,1561077
20563,blaise-io,1,0.00006,389495,24.95040,1561077
20564,blaisep,1,0.00006,389496,24.95047,1561077
20565,blakecmartin,1,0.00006,389497,24.95053,1561077
20566,blalapeta,1,0.00006,389498,24.95060,1561077
20567,blarojo,1,0.00006,389499,24.95066,1561077
20568,blaskovicz,1,0.00006,389500,24.95072,1561077
20569,blaukvik,1,0.00006,389501,24.95079,1561077
20570,blazejocd,1,0.00006,389502,24.95085,1561077
20571,blizzy78,1,0.00006,389503,24.95092,1561077
20572,blka,1,0.00006,389504,24.95098,1561077
20573,bloihl,1,0.00006,389505,24.95104,1561077
20574,bloodstain5201,1,0.00006,389506,24.95111,1561077
20575,BloodWorkXGaming,1,0.00006,389507,24.95117,1561077
20576,BLOPESLO,1,0.00006,389508,24.95124,1561077
20577,bluckau,1,0.00006,389509,24.95130,1561077
20578,bludginozzie,1,0.00006,389510,24.95136,1561077
20579,bluedog13,1,0.00006,389511,24.95143,1561077
20580,bluedread,1,0.00006,389512,24.95149,1561077
20581,bluejack2000,1,0.00006,389513,24.95156,1561077
20582,bluejamesbond,1,0.00006,389514,24.95162,1561077
20583,bluemonki,1,0.00006,389515,24.95168,1561077
20584,blueSwordfish,1,0.00006,389516,24.95175,1561077
20585,blue-user-poz,1,0.00006,389517,24.95181,1561077
20586,B-Lukas,1,0.00006,389518,24.95188,1561077
20587,BluMist,1,0.00006,389519,24.95194,1561077
20588,bluser86,1,0.00006,389520,24.95200,1561077
20589,Blystad,1,0.00006,389521,24.95207,1561077
20590,bMasson,1,0.00006,389522,24.95213,1561077
20591,bmaury-bouet,1,0.00006,389523,24.95220,1561077
20592,bmcguire,1,0.00006,389524,24.95226,1561077
20593,bmeruva,1,0.00006,389525,24.95232,1561077
20594,bmihaescu,1,0.00006,389526,24.95239,1561077
20595,bmudda,1,0.00006,389527,24.95245,1561077
20596,bmxlugo,1,0.00006,389528,24.95252,1561077
20597,bnallapeta,1,0.00006,389529,24.95258,1561077
20598,bnfbiz,1,0.00006,389530,24.95264,1561077
20599,bo0ts,1,0.00006,389531,24.95271,1561077
20600,Bo1337,1,0.00006,389532,24.95277,1561077
20601,bobbotron,1,0.00006,389533,24.95284,1561077
20602,Bobby862,1,0.00006,389534,24.95290,1561077
20603,bobbydennett,1,0.00006,389535,24.95297,1561077
20604,bobbykritzer,1,0.00006,389536,24.95303,1561077
20605,bobchaos,1,0.00006,389537,24.95309,1561077
20606,bobo,1,0.00006,389538,24.95316,1561077
20607,bobonaut,1,0.00006,389539,24.95322,1561077
20608,bogdan-calapod,1,0.00006,389540,24.95329,1561077
20609,bogdankatishev,1,0.00006,389541,24.95335,1561077
20610,bogdan-litescu,1,0.00006,389542,24.95341,1561077
20611,boggard,1,0.00006,389543,24.95348,1561077
20612,boindil,1,0.00006,389544,24.95354,1561077
20613,bojanstok,1,0.00006,389545,24.95361,1561077
20614,bojjac,1,0.00006,389546,24.95367,1561077
20615,bolee,1,0.00006,389547,24.95373,1561077
20616,bolfran001,1,0.00006,389548,24.95380,1561077
20617,Bolth,1,0.00006,389549,24.95386,1561077
20618,boly38,1,0.00006,389550,24.95393,1561077
20619,Bombe,1,0.00006,389551,24.95399,1561077
20620,Bonaducci,1,0.00006,389552,24.95405,1561077
20621,bonclay7,1,0.00006,389553,24.95412,1561077
20622,bondpp7-2,1,0.00006,389554,24.95418,1561077
20623,bonduu01,1,0.00006,389555,24.95425,1561077
20624,BongoEADGC6,1,0.00006,389556,24.95431,1561077
20625,bonikforever,1,0.00006,389557,24.95437,1561077
20626,bonocore,1,0.00006,389558,24.95444,1561077
20627,bontibon,1,0.00006,389559,24.95450,1561077
20628,bontscho,1,0.00006,389560,24.95457,1561077
20629,BonusLord,1,0.00006,389561,24.95463,1561077
20630,bootandy,1,0.00006,389562,24.95469,1561077
20631,bootswithdefer,1,0.00006,389563,24.95476,1561077
20632,bop0hz,1,0.00006,389564,24.95482,1561077
20633,borbamartin,1,0.00006,389565,24.95489,1561077
20634,boredomwontgetus,1,0.00006,389566,24.95495,1561077
20635,Borets,1,0.00006,389567,24.95502,1561077
20636,borgiani,1,0.00006,389568,24.95508,1561077
20637,BorisBabiy,1,0.00006,389569,24.95514,1561077
20638,boriscosic,1,0.00006,389570,24.95521,1561077
20639,boristsr,1,0.00006,389571,24.95527,1561077
20640,borkke,1,0.00006,389572,24.95534,1561077
20641,Born2Bake,1,0.00006,389573,24.95540,1561077
20642,borsch,1,0.00006,389574,24.95546,1561077
20643,boscard,1,0.00006,389575,24.95553,1561077
20644,boscharun,1,0.00006,389576,24.95559,1561077
20645,bototoai,1,0.00006,389577,24.95566,1561077
20646,bottxiang,1,0.00006,389578,24.95572,1561077
20647,Botz,1,0.00006,389579,24.95578,1561077
20648,bougar,1,0.00006,389580,24.95585,1561077
20649,bouland,1,0.00006,389581,24.95591,1561077
20650,Boulet-,1,0.00006,389582,24.95598,1561077
20651,boweeb,1,0.00006,389583,24.95604,1561077
20652,boxymoron,1,0.00006,389584,24.95610,1561077
20653,BoydL,1,0.00006,389585,24.95617,1561077
20654,bozhaojiang,1,0.00006,389586,24.95623,1561077
20655,bozydar,1,0.00006,389587,24.95630,1561077
20656,bparinas,1,0.00006,389588,24.95636,1561077
20657,Bpazy,1,0.00006,389589,24.95642,1561077
20658,bpbhai,1,0.00006,389590,24.95649,1561077
20659,bperryvt,1,0.00006,389591,24.95655,1561077
20660,bpguasch,1,0.00006,389592,24.95662,1561077
20661,bpoplauschi,1,0.00006,389593,24.95668,1561077
20662,Bradeskojest,1,0.00006,389594,24.95674,1561077
20663,bradflood,1,0.00006,389595,24.95681,1561077
20664,bradley-curran,1,0.00006,389596,24.95687,1561077
20665,bradleyjames,1,0.00006,389597,24.95694,1561077
20666,Bradmoon,1,0.00006,389598,24.95700,1561077
20667,brad-neighbors,1,0.00006,389599,24.95706,1561077
20668,braghome,1,0.00006,389600,24.95713,1561077
20669,brailovskiy,1,0.00006,389601,24.95719,1561077
20670,BrainCell23,1,0.00006,389602,24.95726,1561077
20671,brainsik,1,0.00006,389603,24.95732,1561077
20672,brainstorm,1,0.00006,389604,24.95739,1561077
20673,bramwelt,1,0.00006,389605,24.95745,1561077
20674,brandaomarcos,1,0.00006,389606,24.95751,1561077
20675,brandoncordell,1,0.00006,389607,24.95758,1561077
20676,brandongottesman-taulia,1,0.00006,389608,24.95764,1561077
20677,brandonguigo,1,0.00006,389609,24.95771,1561077
20678,brandonparncutt,1,0.00006,389610,24.95777,1561077
20679,BrandonTsai,1,0.00006,389611,24.95783,1561077
20680,brant4test,1,0.00006,389612,24.95790,1561077
20681,braveswang,1,0.00006,389613,24.95796,1561077
20682,BreakDW,1,0.00006,389614,24.95803,1561077
20683,breakingspell,1,0.00006,389615,24.95809,1561077
20684,Breee,1,0.00006,389616,24.95815,1561077
20685,breinjhel,1,0.00006,389617,24.95822,1561077
20686,bremerjonathan,1,0.00006,389618,24.95828,1561077
20687,bremme,1,0.00006,389619,24.95835,1561077
20688,brenguy,1,0.00006,389620,24.95841,1561077
20689,brennenawana,1,0.00006,389621,24.95847,1561077
20690,brennonobst,1,0.00006,389622,24.95854,1561077
20691,brennx0r,1,0.00006,389623,24.95860,1561077
20692,brent80,1,0.00006,389624,24.95867,1561077
20693,brenthdaniel,1,0.00006,389625,24.95873,1561077
20694,brentjohnson,1,0.00006,389626,24.95879,1561077
20695,brentmcconnell,1,0.00006,389627,24.95886,1561077
20696,brettcat,1,0.00006,389628,24.95892,1561077
20697,brettneese,1,0.00006,389629,24.95899,1561077
20698,brettwporter,1,0.00006,389630,24.95905,1561077
20699,brettwsnare,1,0.00006,389631,24.95911,1561077
20700,brgv,1,0.00006,389632,24.95918,1561077
20701,brharrington,1,0.00006,389633,24.95924,1561077
20702,brian316,1,0.00006,389634,24.95931,1561077
20703,brian65535,1,0.00006,389635,24.95937,1561077
20704,brian-beckett-hp,1,0.00006,389636,24.95944,1561077
20705,brianfroelund,1,0.00006,389637,24.95950,1561077
20706,brian-leveille,1,0.00006,389638,24.95956,1561077
20707,Brian-McG,1,0.00006,389639,24.95963,1561077
20708,brianpreuss,1,0.00006,389640,24.95969,1561077
20709,briantd,1,0.00006,389641,24.95976,1561077
20710,briantist,1,0.00006,389642,24.95982,1561077
20711,brianwallace,1,0.00006,389643,24.95988,1561077
20712,briceo,1,0.00006,389644,24.95995,1561077
20713,brice-pinguetti,1,0.00006,389645,24.96001,1561077
20714,brichter89,1,0.00006,389646,24.96008,1561077
20715,briggsw,1,0.00006,389647,24.96014,1561077
20716,Briggybros,1,0.00006,389648,24.96020,1561077
20717,brightgarden,1,0.00006,389649,24.96027,1561077
20718,brijeshsch,1,0.00006,389650,24.96033,1561077
20719,brilong,1,0.00006,389651,24.96040,1561077
20720,brions,1,0.00006,389652,24.96046,1561077
20721,britnoth,1,0.00006,389653,24.96052,1561077
20722,brittanystoroz,1,0.00006,389654,24.96059,1561077
20723,brix4dayz,1,0.00006,389655,24.96065,1561077
20724,brleite,1,0.00006,389656,24.96072,1561077
20725,brndnmtthws,1,0.00006,389657,24.96078,1561077
20726,brneto,1,0.00006,389658,24.96084,1561077
20727,broadcom-akshayas,1,0.00006,389659,24.96091,1561077
20728,brockhjones,1,0.00006,389660,24.96097,1561077
20729,broodzak,1,0.00006,389661,24.96104,1561077
20730,Brother-Andy,1,0.00006,389662,24.96110,1561077
20731,brownwheel,1,0.00006,389663,24.96116,1561077
20732,broxgit,1,0.00006,389664,24.96123,1561077
20733,brpatel007,1,0.00006,389665,24.96129,1561077
20734,brrian,1,0.00006,389666,24.96136,1561077
20735,Bruce17,1,0.00006,389667,24.96142,1561077
20736,brucetsaitw,1,0.00006,389668,24.96148,1561077
20737,brudnyhenry,1,0.00006,389669,24.96155,1561077
20738,brunocriado,1,0.00006,389670,24.96161,1561077
20739,brunocvcunha,1,0.00006,389671,24.96168,1561077
20740,brunodias20,1,0.00006,389672,24.96174,1561077
20741,BrunoFonttes,1,0.00006,389673,24.96181,1561077
20742,bruno-lopes,1,0.00006,389674,24.96187,1561077
20743,brunomendola,1,0.00006,389675,24.96193,1561077
20744,brunomiguel-teixeira,1,0.00006,389676,24.96200,1561077
20745,brunopma,1,0.00006,389677,24.96206,1561077
20746,brussell757,1,0.00006,389678,24.96213,1561077
20747,brute4s99,1,0.00006,389679,24.96219,1561077
20748,bruthwik,1,0.00006,389680,24.96225,1561077
20749,BryanLaura,1,0.00006,389681,24.96232,1561077
20750,Bryan-Ortiz,1,0.00006,389682,24.96238,1561077
20751,bryanrego,1,0.00006,389683,24.96245,1561077
20752,bryan-schuknecht-noaa,1,0.00006,389684,24.96251,1561077
20753,brycedrennan,1,0.00006,389685,24.96257,1561077
20754,bsawyer,1,0.00006,389686,24.96264,1561077
20755,bschaatsbergen,1,0.00006,389687,24.96270,1561077
20756,bschaefer99,1,0.00006,389688,24.96277,1561077
20757,bschoenfeld16,1,0.00006,389689,24.96283,1561077
20758,bseibel,1,0.00006,389690,24.96289,1561077
20759,bskarda,1,0.00006,389691,24.96296,1561077
20760,bskart,1,0.00006,389692,24.96302,1561077
20761,bsnareshorc,1,0.00006,389693,24.96309,1561077
20762,bspeiser,1,0.00006,389694,24.96315,1561077
20763,bsramin,1,0.00006,389695,24.96321,1561077
20764,bss,1,0.00006,389696,24.96328,1561077
20765,bstuff,1,0.00006,389697,24.96334,1561077
20766,bsudy,1,0.00006,389698,24.96341,1561077
20767,b-szypelow,1,0.00006,389699,24.96347,1561077
20768,btd,1,0.00006,389700,24.96353,1561077
20769,btilford,1,0.00006,389701,24.96360,1561077
20770,btkelly,1,0.00006,389702,24.96366,1561077
20771,btmash,1,0.00006,389703,24.96373,1561077
20772,btomblin,1,0.00006,389704,24.96379,1561077
20773,btsteve,1,0.00006,389705,24.96386,1561077
20774,btwewek,1,0.00006,389706,24.96392,1561077
20775,btzc,1,0.00006,389707,24.96398,1561077
20776,buamod,1,0.00006,389708,24.96405,1561077
20777,buchs,1,0.00006,389709,24.96411,1561077
20778,buehlerfa,1,0.00006,389710,24.96418,1561077
20779,bugmaker31,1,0.00006,389711,24.96424,1561077
20780,bugs84,1,0.00006,389712,24.96430,1561077
20781,builderatemboticsdotcom,1,0.00006,389713,24.96437,1561077
20782,Bujail,1,0.00006,389714,24.96443,1561077
20783,buliverd53,1,0.00006,389715,24.96450,1561077
20784,bullboa,1,0.00006,389716,24.96456,1561077
20785,bungeeskimmer,1,0.00006,389717,24.96462,1561077
20786,bungle,1,0.00006,389718,24.96469,1561077
20787,buntyray,1,0.00006,389719,24.96475,1561077
20788,burakbal751,1,0.00006,389720,24.96482,1561077
20789,burakkp,1,0.00006,389721,24.96488,1561077
20790,Burden50,1,0.00006,389722,24.96494,1561077
20791,Burke9077,1,0.00006,389723,24.96501,1561077
20792,burlo2,1,0.00006,389724,24.96507,1561077
20793,burnedikt,1,0.00006,389725,24.96514,1561077
20794,burtino,1,0.00006,389726,24.96520,1561077
20795,burtsevyg,1,0.00006,389727,24.96526,1561077
20796,burukuru,1,0.00006,389728,24.96533,1561077
20797,burythehammer,1,0.00006,389729,24.96539,1561077
20798,bushanlove,1,0.00006,389730,24.96546,1561077
20799,bussrrajeshnayak,1,0.00006,389731,24.96552,1561077
20800,butterandfly,1,0.00006,389732,24.96558,1561077
20801,butterlyextreme,1,0.00006,389733,24.96565,1561077
20802,buurd,1,0.00006,389734,24.96571,1561077
20803,buuren,1,0.00006,389735,24.96578,1561077
20804,buzdin,1,0.00006,389736,24.96584,1561077
20805,bvamos,1,0.00006,389737,24.96590,1561077
20806,bvdriel,1,0.00006,389738,24.96597,1561077
20807,bvdwalt,1,0.00006,389739,24.96603,1561077
20808,bwall,1,0.00006,389740,24.96610,1561077
20809,bwilczek,1,0.00006,389741,24.96616,1561077
20810,bwomsm1,1,0.00006,389742,24.96623,1561077
20811,b-x,1,0.00006,389743,24.96629,1561077
20812,bxjbxj,1,0.00006,389744,24.96635,1561077
20813,byangtri,1,0.00006,389745,24.96642,1561077
20814,byeddula,1,0.00006,389746,24.96648,1561077
20815,byF,1,0.00006,389747,24.96655,1561077
20816,byrondover,1,0.00006,389748,24.96661,1561077
20817,Byteflux,1,0.00006,389749,24.96667,1561077
20818,bytemain,1,0.00006,389750,24.96674,1561077
20819,bzbikowski,1,0.00006,389751,24.96680,1561077
20820,bz-keitaro-kobayashi,1,0.00006,389752,24.96687,1561077
20821,c00,1,0.00006,389753,24.96693,1561077
20822,c0nfleis,1,0.00006,389754,24.96699,1561077
20823,c32hedge,1,0.00006,389755,24.96706,1561077
20824,C3vin,1,0.00006,389756,24.96712,1561077
20825,c4p7-n30k,1,0.00006,389757,24.96719,1561077
20826,c4sh,1,0.00006,389758,24.96725,1561077
20827,c4urself,1,0.00006,389759,24.96731,1561077
20828,c6h3un,1,0.00006,389760,24.96738,1561077
20829,caarek,1,0.00006,389761,24.96744,1561077
20830,caas-test,1,0.00006,389762,24.96751,1561077
20831,caddac,1,0.00006,389763,24.96757,1561077
20832,cadditon,1,0.00006,389764,24.96763,1561077
20833,cadement,1,0.00006,389765,24.96770,1561077
20834,Caellion,1,0.00006,389766,24.96776,1561077
20835,caelym,1,0.00006,389767,24.96783,1561077
20836,cafeliker,1,0.00006,389768,24.96789,1561077
20837,cafkafk,1,0.00006,389769,24.96795,1561077
20838,cagriy,1,0.00006,389770,24.96802,1561077
20839,cah-walker-miller,1,0.00006,389771,24.96808,1561077
20840,caibirdme,1,0.00006,389772,24.96815,1561077
20841,caio2k,1,0.00006,389773,24.96821,1561077
20842,caipre,1,0.00006,389774,24.96828,1561077
20843,cal101,1,0.00006,389775,24.96834,1561077
20844,calbertts,1,0.00006,389776,24.96840,1561077
20845,calebeno,1,0.00006,389777,24.96847,1561077
20846,caliahub,1,0.00006,389778,24.96853,1561077
20847,calj,1,0.00006,389779,24.96860,1561077
20848,CallmeTorre,1,0.00006,389780,24.96866,1561077
20849,callum-george,1,0.00006,389781,24.96872,1561077
20850,calmzhu,1,0.00006,389782,24.96879,1561077
20851,calumgilchristmodulr,1,0.00006,389783,24.96885,1561077
20852,calvaradoq6,1,0.00006,389784,24.96892,1561077
20853,calvinShan,1,0.00006,389785,24.96898,1561077
20854,CalvinWilkinson,1,0.00006,389786,24.96904,1561077
20855,camara-dds,1,0.00006,389787,24.96911,1561077
20856,camelinckx,1,0.00006,389788,24.96917,1561077
20857,camillake,1,0.00006,389789,24.96924,1561077
20858,camilo12369,1,0.00006,389790,24.96930,1561077
20859,camilolopes,1,0.00006,389791,24.96936,1561077
20860,CammoKing,1,0.00006,389792,24.96943,1561077
20861,cammoraton,1,0.00006,389793,24.96949,1561077
20862,campanellaf,1,0.00006,389794,24.96956,1561077
20863,campi01,1,0.00006,389795,24.96962,1561077
20864,Camsteack,1,0.00006,389796,24.96968,1561077
20865,canaras81,1,0.00006,389797,24.96975,1561077
20866,canatac,1,0.00006,389798,24.96981,1561077
20867,canb0,1,0.00006,389799,24.96988,1561077
20868,candiebot-jenkins-github,1,0.00006,389800,24.96994,1561077
20869,caneridge,1,0.00006,389801,24.97000,1561077
20870,canidam,1,0.00006,389802,24.97007,1561077
20871,cannibal-kush,1,0.00006,389803,24.97013,1561077
20872,canonical-is,1,0.00006,389804,24.97020,1561077
20873,cantSleepNow,1,0.00006,389805,24.97026,1561077
20874,cao2504,1,0.00006,389806,24.97032,1561077
20875,caohhung,1,0.00006,389807,24.97039,1561077
20876,caolandix,1,0.00006,389808,24.97045,1561077
20877,caoxianke,1,0.00006,389809,24.97052,1561077
20878,caoyin0727,1,0.00006,389810,24.97058,1561077
20879,capethegreat,1,0.00006,389811,24.97065,1561077
20880,caplike,1,0.00006,389812,24.97071,1561077
20881,caporegim,1,0.00006,389813,24.97077,1561077
20882,captdestrukto,1,0.00006,389814,24.97084,1561077
20883,CaptnBlubber,1,0.00006,389815,24.97090,1561077
20884,captSL,1,0.00006,389816,24.97097,1561077
20885,capybaras,1,0.00006,389817,24.97103,1561077
20886,capyvara,1,0.00006,389818,24.97109,1561077
20887,cardiff1982,1,0.00006,389819,24.97116,1561077
20888,cardinalX,1,0.00006,389820,24.97122,1561077
20889,carl1990,1,0.00006,389821,24.97129,1561077
20890,carledriss,1,0.00006,389822,24.97135,1561077
20891,CarlesContell,1,0.00006,389823,24.97141,1561077
20892,carles-protopixel,1,0.00006,389824,24.97148,1561077
20893,carlfischerjba,1,0.00006,389825,24.97154,1561077
20894,carlomorelli,1,0.00006,389826,24.97161,1561077
20895,carlosaya,1,0.00006,389827,24.97167,1561077
20896,carlosflorencio,1,0.00006,389828,24.97173,1561077
20897,carlosrfranco,1,0.00006,389829,24.97180,1561077
20898,carlost,1,0.00006,389830,24.97186,1561077
20899,carlos-wong,1,0.00006,389831,24.97193,1561077
20900,carltonbrown,1,0.00006,389832,24.97199,1561077
20901,carneiroskeeled,1,0.00006,389833,24.97205,1561077
20902,caroeber,1,0.00006,389834,24.97212,1561077
20903,carol-cap,1,0.00006,389835,24.97218,1561077
20904,carolinewang,1,0.00006,389836,24.97225,1561077
20905,CarotUnima,1,0.00006,389837,24.97231,1561077
20906,carrigmore,1,0.00006,389838,24.97237,1561077
20907,carrisonj,1,0.00006,389839,24.97244,1561077
20908,cartoloupe,1,0.00006,389840,24.97250,1561077
20909,carun,1,0.00006,389841,24.97257,1561077
20910,casacco,1,0.00006,389842,24.97263,1561077
20911,casareafer2908,1,0.00006,389843,24.97270,1561077
20912,Caseledde,1,0.00006,389844,24.97276,1561077
20913,caseybea,1,0.00006,389845,24.97282,1561077
20914,caseydaly,1,0.00006,389846,24.97289,1561077
20915,CatCassie,1,0.00006,389847,24.97295,1561077
20916,category,1,0.00006,389848,24.97302,1561077
20917,catfish1225,1,0.00006,389849,24.97308,1561077
20918,catshout,1,0.00006,389850,24.97314,1561077
20919,cat-turner,1,0.00006,389851,24.97321,1561077
20920,cauvery,1,0.00006,389852,24.97327,1561077
20921,cavamagie,1,0.00006,389853,24.97334,1561077
20922,cavdhut,1,0.00006,389854,24.97340,1561077
20923,caweidmann,1,0.00006,389855,24.97346,1561077
20924,cawka,1,0.00006,389856,24.97353,1561077
20925,caye,1,0.00006,389857,24.97359,1561077
20926,cazalot,1,0.00006,389858,24.97366,1561077
20927,cazino,1,0.00006,389859,24.97372,1561077
20928,cazzoo,1,0.00006,389860,24.97378,1561077
20929,CB-abhinavdamarapati,1,0.00006,389861,24.97385,1561077
20930,cbaenziger,1,0.00006,389862,24.97391,1561077
20931,cbarath1986,1,0.00006,389863,24.97398,1561077
20932,cbcunc,1,0.00006,389864,24.97404,1561077
20933,CB-dave-arnold,1,0.00006,389865,24.97410,1561077
20934,cbfshr,1,0.00006,389866,24.97417,1561077
20935,cbladd,1,0.00006,389867,24.97423,1561077
20936,cblakkan,1,0.00006,389868,24.97430,1561077
20937,cblegare,1,0.00006,389869,24.97436,1561077
20938,cblomqvist,1,0.00006,389870,24.97442,1561077
20939,cbmcvey,1,0.00006,389871,24.97449,1561077
20940,cbohrtarwater,1,0.00006,389872,24.97455,1561077
20941,cbolson1,1,0.00006,389873,24.97462,1561077
20942,cbsmith,1,0.00006,389874,24.97468,1561077
20943,cbxp,1,0.00006,389875,24.97474,1561077
20944,cc189,1,0.00006,389876,24.97481,1561077
20945,ccarpita,1,0.00006,389877,24.97487,1561077
20946,ccarrasc,1,0.00006,389878,24.97494,1561077
20947,cchene,1,0.00006,389879,24.97500,1561077
20948,ccnet-microarea,1,0.00006,389880,24.97507,1561077
20949,CCorrado,1,0.00006,389881,24.97513,1561077
20950,ccschneidr,1,0.00006,389882,24.97519,1561077
20951,cdaf,1,0.00006,389883,24.97526,1561077
20952,cddude229,1,0.00006,389884,24.97532,1561077
20953,cdelguercio,1,0.00006,389885,24.97539,1561077
20954,cdennison,1,0.00006,389886,24.97545,1561077
20955,cderici,1,0.00006,389887,24.97551,1561077
20956,cdewoozy,1,0.00006,389888,24.97558,1561077
20957,cdunford,1,0.00006,389889,24.97564,1561077
20958,ceagan,1,0.00006,389890,24.97571,1561077
20959,cecchisandrone,1,0.00006,389891,24.97577,1561077
20960,cedric05,1,0.00006,389892,24.97583,1561077
20961,cedric-c84-eu,1,0.00006,389893,24.97590,1561077
20962,cedson,1,0.00006,389894,24.97596,1561077
20963,cedwards-reisys,1,0.00006,389895,24.97603,1561077
20964,ceelian,1,0.00006,389896,24.97609,1561077
20965,celebaldeepak,1,0.00006,389897,24.97615,1561077
20966,Celebrate-future,1,0.00006,389898,24.97622,1561077
20967,ceme393,1,0.00006,389899,24.97628,1561077
20968,cenbiliu,1,0.00006,389900,24.97635,1561077
20969,centerfire,1,0.00006,389901,24.97641,1561077
20970,centrex-ops,1,0.00006,389902,24.97647,1561077
20971,cepster,1,0.00006,389903,24.97654,1561077
20972,cernenwein,1,0.00006,389904,24.97660,1561077
20973,cernerBrah,1,0.00006,389905,24.97667,1561077
20974,certara-tpagden,1,0.00006,389906,24.97673,1561077
20975,cesarhernandezgt,1,0.00006,389907,24.97679,1561077
20976,cesaribeiro,1,0.00006,389908,24.97686,1561077
20977,cezarguimaraes,1,0.00006,389909,24.97692,1561077
20978,cezariuszmarek,1,0.00006,389910,24.97699,1561077
20979,cfanatic,1,0.00006,389911,24.97705,1561077
20980,CFenner,1,0.00006,389912,24.97712,1561077
20981,cfischer-oo-software,1,0.00006,389913,24.97718,1561077
20982,cfoehrdes,1,0.00006,389914,24.97724,1561077
20983,cfoote,1,0.00006,389915,24.97731,1561077
20984,cg14823,1,0.00006,389916,24.97737,1561077
20985,cgkades,1,0.00006,389917,24.97744,1561077
20986,cgmartin,1,0.00006,389918,24.97750,1561077
20987,cgomestw,1,0.00006,389919,24.97756,1561077
20988,cgonul,1,0.00006,389920,24.97763,1561077
20989,cgos,1,0.00006,389921,24.97769,1561077
20990,Ch3D,1,0.00006,389922,24.97776,1561077
20991,ch3lo,1,0.00006,389923,24.97782,1561077
20992,ch4rms,1,0.00006,389924,24.97788,1561077
20993,chadtripod,1,0.00006,389925,24.97795,1561077
20994,chaitanyakusumba,1,0.00006,389926,24.97801,1561077
20995,chaitanyarai21,1,0.00006,389927,24.97808,1561077
20996,chaithra-M,1,0.00006,389928,24.97814,1561077
20997,chaitukr11,1,0.00006,389929,24.97820,1561077
20998,chaitumemphis,1,0.00006,389930,24.97827,1561077
20999,chakch,1,0.00006,389931,24.97833,1561077
21000,chalapathy,1,0.00006,389932,24.97840,1561077
21001,chalbersma,1,0.00006,389933,24.97846,1561077
21002,chales,1,0.00006,389934,24.97852,1561077
21003,chandan607,1,0.00006,389935,24.97859,1561077
21004,chandardayakar,1,0.00006,389936,24.97865,1561077
21005,chandlersamuels,1,0.00006,389937,24.97872,1561077
21006,chandraanwar91,1,0.00006,389938,24.97878,1561077
21007,chandranpranav,1,0.00006,389939,24.97884,1561077
21008,ChanForPres,1,0.00006,389940,24.97891,1561077
21009,chapitos,1,0.00006,389941,24.97897,1561077
21010,charandas,1,0.00006,389942,24.97904,1561077
21011,charettes,1,0.00006,389943,24.97910,1561077
21012,charlag,1,0.00006,389944,24.97917,1561077
21013,CharlesAbetz,1,0.00006,389945,24.97923,1561077
21014,charleschen,1,0.00006,389946,24.97929,1561077
21015,charlesheidemann,1,0.00006,389947,24.97936,1561077
21016,charlesmchen,1,0.00006,389948,24.97942,1561077
21017,charlesmelby,1,0.00006,389949,24.97949,1561077
21018,charlesrg,1,0.00006,389950,24.97955,1561077
21019,charlesroddie,1,0.00006,389951,24.97961,1561077
21020,charliegracie,1,0.00006,389952,24.97968,1561077
21021,Charliocat,1,0.00006,389953,24.97974,1561077
21022,charlyrayappan,1,0.00006,389954,24.97981,1561077
21023,charlysotelo,1,0.00006,389955,24.97987,1561077
21024,CharmanderJieniJieni,1,0.00006,389956,24.97993,1561077
21025,charshin,1,0.00006,389957,24.98000,1561077
21026,chaseadamsio,1,0.00006,389958,24.98006,1561077
21027,ChasingDreamSeeker,1,0.00006,389959,24.98013,1561077
21028,chatchaisi,1,0.00006,389960,24.98019,1561077
21029,chauncey-garrett,1,0.00006,389961,24.98025,1561077
21030,chaustone1,1,0.00006,389962,24.98032,1561077
21031,chawkshaw-frecra,1,0.00006,389963,24.98038,1561077
21032,chaws,1,0.00006,389964,24.98045,1561077
21033,chbieri,1,0.00006,389965,24.98051,1561077
21034,chbloemer,1,0.00006,389966,24.98057,1561077
21035,CH-DanReif,1,0.00006,389967,24.98064,1561077
21036,chdwlch,1,0.00006,389968,24.98070,1561077
21037,checkphi,1,0.00006,389969,24.98077,1561077
21038,cheesydev,1,0.00006,389970,24.98083,1561077
21039,cheeyeo,1,0.00006,389971,24.98089,1561077
21040,chekly,1,0.00006,389972,24.98096,1561077
21041,chen2319,1,0.00006,389973,24.98102,1561077
21042,chen497147884,1,0.00006,389974,24.98109,1561077
21043,chenchix,1,0.00006,389975,24.98115,1561077
21044,chenconghe,1,0.00006,389976,24.98121,1561077
21045,chendelin1982,1,0.00006,389977,24.98128,1561077
21046,chenFe-1,1,0.00006,389978,24.98134,1561077
21047,chengfengpiaopiao,1,0.00006,389979,24.98141,1561077
21048,chengqian0504,1,0.00006,389980,24.98147,1561077
21049,chengssir,1,0.00006,389981,24.98154,1561077
21050,Chenguoqing2008,1,0.00006,389982,24.98160,1561077
21051,chengzime,1,0.00006,389983,24.98166,1561077
21052,chenlong220192,1,0.00006,389984,24.98173,1561077
21053,chenrizhi,1,0.00006,389985,24.98179,1561077
21054,chenrulongmaster,1,0.00006,389986,24.98186,1561077
21055,chenshap,1,0.00006,389987,24.98192,1561077
21056,cheny-fortinet,1,0.00006,389988,24.98198,1561077
21057,CheoWalker,1,0.00006,389989,24.98205,1561077
21058,cherkovskiyandrey,1,0.00006,389990,24.98211,1561077
21059,cherryred5959,1,0.00006,389991,24.98218,1561077
21060,cherubrock,1,0.00006,389992,24.98224,1561077
21061,Cherum,1,0.00006,389993,24.98230,1561077
21062,cheryPeng,1,0.00006,389994,24.98237,1561077
21063,cheshi-mantu,1,0.00006,389995,24.98243,1561077
21064,chetanddesai,1,0.00006,389996,24.98250,1561077
21065,CheukLeung,1,0.00006,389997,24.98256,1561077
21066,chevdor,1,0.00006,389998,24.98262,1561077
21067,chewting99,1,0.00006,389999,24.98269,1561077
21068,chhatbarjignesh,1,0.00006,390000,24.98275,1561077
21069,chiaen,1,0.00006,390001,24.98282,1561077
21070,chickenbeef,1,0.00006,390002,24.98288,1561077
21071,chickenland,1,0.00006,390003,24.98294,1561077
21072,chi-ding,1,0.00006,390004,24.98301,1561077
21073,chiducaff,1,0.00006,390005,24.98307,1561077
21074,chief-tyrol,1,0.00006,390006,24.98314,1561077
21075,chiefzor,1,0.00006,390007,24.98320,1561077
21076,chiencai,1,0.00006,390008,24.98326,1561077
21077,chihchenghuang,1,0.00006,390009,24.98333,1561077
21078,chikitulfo,1,0.00006,390010,24.98339,1561077
21079,Chimouma,1,0.00006,390011,24.98346,1561077
21080,chinhapi,1,0.00006,390012,24.98352,1561077
21081,chinmay90kulkarni,1,0.00006,390013,24.98359,1561077
21082,chinmaysahoo19,1,0.00006,390014,24.98365,1561077
21083,chintan-synapse,1,0.00006,390015,24.98371,1561077
21084,chintu481,1,0.00006,390016,24.98378,1561077
21085,ChioSoCo,1,0.00006,390017,24.98384,1561077
21086,chipcop106,1,0.00006,390018,24.98391,1561077
21087,chiqomar,1,0.00006,390019,24.98397,1561077
21088,chiragg6,1,0.00006,390020,24.98403,1561077
21089,chiralsoftware,1,0.00006,390021,24.98410,1561077
21090,chiranjitghosh85,1,0.00006,390022,24.98416,1561077
21091,chitran96,1,0.00006,390023,24.98423,1561077
21092,ch-kbergauer,1,0.00006,390024,24.98429,1561077
21093,chkelly,1,0.00006,390025,24.98435,1561077
21094,chocholand,1,0.00006,390026,24.98442,1561077
21095,choosy,1,0.00006,390027,24.98448,1561077
21096,Choppalakshmidevi2,1,0.00006,390028,24.98455,1561077
21097,chowsGh,1,0.00006,390029,24.98461,1561077
21098,chris1248,1,0.00006,390030,24.98467,1561077
21099,ChrisAnn,1,0.00006,390031,24.98474,1561077
21100,chrisberryfanclub,1,0.00006,390032,24.98480,1561077
21101,Chris-Boyle,1,0.00006,390033,24.98487,1561077
21102,chrisdmartinuk,1,0.00006,390034,24.98493,1561077
21103,ChrisDoddGit,1,0.00006,390035,24.98499,1561077
21104,chris-edwards-pub,1,0.00006,390036,24.98506,1561077
21105,chris-envas,1,0.00006,390037,24.98512,1561077
21106,chrisfair,1,0.00006,390038,24.98519,1561077
21107,ChrisF-Mavens,1,0.00006,390039,24.98525,1561077
21108,chrisgavin,1,0.00006,390040,24.98531,1561077
21109,chrisj-au,1,0.00006,390041,24.98538,1561077
21110,chrisjomaron,1,0.00006,390042,24.98544,1561077
21111,chrisjunlee,1,0.00006,390043,24.98551,1561077
21112,chriskennedydev,1,0.00006,390044,24.98557,1561077
21113,Chrislja,1,0.00006,390045,24.98563,1561077
21114,ChrisLMerrill,1,0.00006,390046,24.98570,1561077
21115,ChrisMaddock,1,0.00006,390047,24.98576,1561077
21116,chris-malloy-mri,1,0.00006,390048,24.98583,1561077
21117,chris-ney,1,0.00006,390049,24.98589,1561077
21118,chrisribble,1,0.00006,390050,24.98596,1561077
21119,chris-salemove,1,0.00006,390051,24.98602,1561077
21120,chris-str-cst,1,0.00006,390052,24.98608,1561077
21121,Chris-Tan,1,0.00006,390053,24.98615,1561077
21122,christau,1,0.00006,390054,24.98621,1561077
21123,christemple,1,0.00006,390055,24.98628,1561077
21124,ChristianBecker,1,0.00006,390056,24.98634,1561077
21125,christian-boesch-srf,1,0.00006,390057,24.98640,1561077
21126,Christian-dev-ops,1,0.00006,390058,24.98647,1561077
21127,christianharke,1,0.00006,390059,24.98653,1561077
21128,christianparpart,1,0.00006,390060,24.98660,1561077
21129,ChristianTackeGSI,1,0.00006,390061,24.98666,1561077
21130,christian-weiss,1,0.00006,390062,24.98672,1561077
21131,christieyang,1,0.00006,390063,24.98679,1561077
21132,christophegrall,1,0.00006,390064,24.98685,1561077
21133,Christopher-Chappell,1,0.00006,390065,24.98692,1561077
21134,christopherjbaker,1,0.00006,390066,24.98698,1561077
21135,christophersavory,1,0.00006,390067,24.98704,1561077
21136,chrisuj,1,0.00006,390068,24.98711,1561077
21137,chrisvanbreeden,1,0.00006,390069,24.98717,1561077
21138,chriswahl,1,0.00006,390070,24.98724,1561077
21139,chriswalters,1,0.00006,390071,24.98730,1561077
21140,chrizchow,1,0.00006,390072,24.98736,1561077
21141,chrono2002,1,0.00006,390073,24.98743,1561077
21142,chrouzz,1,0.00006,390074,24.98749,1561077
21143,chth,1,0.00006,390075,24.98756,1561077
21144,chtitoon,1,0.00006,390076,24.98762,1561077
21145,chuckwondo,1,0.00006,390077,24.98768,1561077
21146,chudamanip,1,0.00006,390078,24.98775,1561077
21147,chumachums,1,0.00006,390079,24.98781,1561077
21148,chumaltd,1,0.00006,390080,24.98788,1561077
21149,chuong-dao,1,0.00006,390081,24.98794,1561077
21150,cialx,1,0.00006,390082,24.98801,1561077
21151,cibergarri,1,0.00006,390083,24.98807,1561077
21152,cicd-breqwatr,1,0.00006,390084,24.98813,1561077
21153,CICDSimplified,1,0.00006,390085,24.98820,1561077
21154,cigam,1,0.00006,390086,24.98826,1561077
21155,Cigizmoond-Vyhuholev,1,0.00006,390087,24.98833,1561077
21156,ciizz,1,0.00006,390088,24.98839,1561077
21157,cimenator,1,0.00006,390089,24.98845,1561077
21158,cimi,1,0.00006,390090,24.98852,1561077
21159,Cinderhaze,1,0.00006,390091,24.98858,1561077
21160,cipo7741,1,0.00006,390092,24.98865,1561077
21161,ciprianflow,1,0.00006,390093,24.98871,1561077
21162,ciprianvintea,1,0.00006,390094,24.98877,1561077
21163,cireme,1,0.00006,390095,24.98884,1561077
21164,ciricc,1,0.00006,390096,24.98890,1561077
21165,ciszewsj,1,0.00006,390097,24.98897,1561077
21166,citestra2,1,0.00006,390098,24.98903,1561077
21167,citywander,1,0.00006,390099,24.98909,1561077
21168,ciwarren,1,0.00006,390100,24.98916,1561077
21169,cj4777,1,0.00006,390101,24.98922,1561077
21170,cjbrowne,1,0.00006,390102,24.98929,1561077
21171,cjcdoomed,1,0.00006,390103,24.98935,1561077
21172,cjfq,1,0.00006,390104,24.98941,1561077
21173,cjmachado,1,0.00006,390105,24.98948,1561077
21174,cjoyv,1,0.00006,390106,24.98954,1561077
21175,cjperusse,1,0.00006,390107,24.98961,1561077
21176,ck3mp3r,1,0.00006,390108,24.98967,1561077
21177,ckaserer,1,0.00006,390109,24.98973,1561077
21178,ckatzorke,1,0.00006,390110,24.98980,1561077
21179,ckcrowe,1,0.00006,390111,24.98986,1561077
21180,ckelner,1,0.00006,390112,24.98993,1561077
21181,ckhelifi,1,0.00006,390113,24.98999,1561077
21182,ckho-wkcda,1,0.00006,390114,24.99005,1561077
21183,ckime-ibm,1,0.00006,390115,24.99012,1561077
21184,cklosowski,1,0.00006,390116,24.99018,1561077
21185,ckrams,1,0.00006,390117,24.99025,1561077
21186,ckvtvm-arch,1,0.00006,390118,24.99031,1561077
21187,cl04ker,1,0.00006,390119,24.99038,1561077
21188,clairegallesio1a,1,0.00006,390120,24.99044,1561077
21189,clannon,1,0.00006,390121,24.99050,1561077
21190,clanstyles,1,0.00006,390122,24.99057,1561077
21191,clarkdo,1,0.00006,390123,24.99063,1561077
21192,clarkie82,1,0.00006,390124,24.99070,1561077
21193,clarkstuth,1,0.00006,390125,24.99076,1561077
21194,claudemamo,1,0.00006,390126,24.99082,1561077
21195,claudio-viola,1,0.00006,390127,24.99089,1561077
21196,ClaytonHughes,1,0.00006,390128,24.99095,1561077
21197,clemcvlcs,1,0.00006,390129,24.99102,1561077
21198,ClementDEBOOS,1,0.00006,390130,24.99108,1561077
21199,clems4ever,1,0.00006,390131,24.99114,1561077
21200,clemSeveillac,1,0.00006,390132,24.99121,1561077
21201,clev2k,1,0.00006,390133,24.99127,1561077
21202,clhpoole,1,0.00006,390134,24.99134,1561077
21203,Click2Cloud-electron,1,0.00006,390135,24.99140,1561077
21204,clickjohndahl,1,0.00006,390136,24.99146,1561077
21205,clickonchris,1,0.00006,390137,24.99153,1561077
21206,clintharrison,1,0.00006,390138,24.99159,1561077
21207,clintmod,1,0.00006,390139,24.99166,1561077
21208,clnyt,1,0.00006,390140,24.99172,1561077
21209,clockrun,1,0.00006,390141,24.99178,1561077
21210,clockwiser,1,0.00006,390142,24.99185,1561077
21211,cloderic,1,0.00006,390143,24.99191,1561077
21212,clok,1,0.00006,390144,24.99198,1561077
21213,cloos,1,0.00006,390145,24.99204,1561077
21214,closconsultancy,1,0.00006,390146,24.99210,1561077
21215,cloudarchitectaws,1,0.00006,390147,24.99217,1561077
21216,cloudbluedigital,1,0.00006,390148,24.99223,1561077
21217,Cloudehard,1,0.00006,390149,24.99230,1561077
21218,cloudifyer,1,0.00006,390150,24.99236,1561077
21219,cloudinary-misha,1,0.00006,390151,24.99243,1561077
21220,cloudlady911,1,0.00006,390152,24.99249,1561077
21221,CloudWarGit,1,0.00006,390153,24.99255,1561077
21222,clover1983,1,0.00006,390154,24.99262,1561077
21223,CluEleSsUK,1,0.00006,390155,24.99268,1561077
21224,ClueOrc,1,0.00006,390156,24.99275,1561077
21225,clutcher,1,0.00006,390157,24.99281,1561077
21226,ClutchRadio,1,0.00006,390158,24.99287,1561077
21227,clydetealium,1,0.00006,390159,24.99294,1561077
21228,cmacgreg,1,0.00006,390160,24.99300,1561077
21229,cmamigonian,1,0.00006,390161,24.99307,1561077
21230,cmarcelk,1,0.00006,390162,24.99313,1561077
21231,cmattson22,1,0.00006,390163,24.99319,1561077
21232,cmayne-r7,1,0.00006,390164,24.99326,1561077
21233,cmbasnett,1,0.00006,390165,24.99332,1561077
21234,cmcga1125,1,0.00006,390166,24.99339,1561077
21235,cmcgrath13,1,0.00006,390167,24.99345,1561077
21236,c-mckenzie,1,0.00006,390168,24.99351,1561077
21237,cmdrclueless,1,0.00006,390169,24.99358,1561077
21238,cmfp2018,1,0.00006,390170,24.99364,1561077
21239,cmichallek,1,0.00006,390171,24.99371,1561077
21240,cmlara,1,0.00006,390172,24.99377,1561077
21241,cmoore-threatmetrix,1,0.00006,390173,24.99383,1561077
21242,cmordue,1,0.00006,390174,24.99390,1561077
21243,CMRsolutions,1,0.00006,390175,24.99396,1561077
21244,CMTaylor,1,0.00006,390176,24.99403,1561077
21245,c-mu,1,0.00006,390177,24.99409,1561077
21246,cmucgit,1,0.00006,390178,24.99415,1561077
21247,cmukhopadhyay-rms,1,0.00006,390179,24.99422,1561077
21248,cmuller,1,0.00006,390180,24.99428,1561077
21249,cnantch,1,0.00006,390181,24.99435,1561077
21250,cncal,1,0.00006,390182,24.99441,1561077
21251,cnewkirk78,1,0.00006,390183,24.99447,1561077
21252,cnico,1,0.00006,390184,24.99454,1561077
21253,cnrleemkh,1,0.00006,390185,24.99460,1561077
21254,cns4jenkins,1,0.00006,390186,24.99467,1561077
21255,cntasios,1,0.00006,390187,24.99473,1561077
21256,cnuland,1,0.00006,390188,24.99480,1561077
21257,cochiseruhulessin,1,0.00006,390189,24.99486,1561077
21258,cockroach,1,0.00006,390190,24.99492,1561077
21259,cocorossello,1,0.00006,390191,24.99499,1561077
21260,code4j-chen,1,0.00006,390192,24.99505,1561077
21261,codeadict,1,0.00006,390193,24.99512,1561077
21262,codedev900,1,0.00006,390194,24.99518,1561077
21263,Code-Ebullient,1,0.00006,390195,24.99524,1561077
21264,codefromthecrypt,1,0.00006,390196,24.99531,1561077
21265,code-master24,1,0.00006,390197,24.99537,1561077
21266,codeocelot,1,0.00006,390198,24.99544,1561077
21267,codependent,1,0.00006,390199,24.99550,1561077
21268,codepoet80,1,0.00006,390200,24.99556,1561077
21269,codepython,1,0.00006,390201,24.99563,1561077
21270,coderbyheart,1,0.00006,390202,24.99569,1561077
21271,coderyzun,1,0.00006,390203,24.99576,1561077
21272,codeSapience,1,0.00006,390204,24.99582,1561077
21273,codeshaw,1,0.00006,390205,24.99588,1561077
21274,codesqueak,1,0.00006,390206,24.99595,1561077
21275,codewithsaurav,1,0.00006,390207,24.99601,1561077
21276,codinginfraviolet,1,0.00006,390208,24.99608,1561077
21277,codingphil,1,0.00006,390209,24.99614,1561077
21278,codingrodent,1,0.00006,390210,24.99620,1561077
21279,CodingSpiderFox,1,0.00006,390211,24.99627,1561077
21280,codiyapa,1,0.00006,390212,24.99633,1561077
21281,codrcodz,1,0.00006,390213,24.99640,1561077
21282,codrinbucur,1,0.00006,390214,24.99646,1561077
21283,Cody0713,1,0.00006,390215,24.99652,1561077
21284,cody-pope,1,0.00006,390216,24.99659,1561077
21285,CODY-RAY,1,0.00006,390217,24.99665,1561077
21286,cogell,1,0.00006,390218,24.99672,1561077
21287,cogren1,1,0.00006,390219,24.99678,1561077
21288,cojack,1,0.00006,390220,24.99685,1561077
21289,cojennin,1,0.00006,390221,24.99691,1561077
21290,ColaciPhotography,1,0.00006,390222,24.99697,1561077
21291,coladarci,1,0.00006,390223,24.99704,1561077
21292,colbygk,1,0.00006,390224,24.99710,1561077
21293,coldmarble,1,0.00006,390225,24.99717,1561077
21294,colinbjohnson,1,0.00006,390226,24.99723,1561077
21295,colinjcahill,1,0.00006,390227,24.99729,1561077
21296,colinleefish,1,0.00006,390228,24.99736,1561077
21297,ColinWlodkowski,1,0.00006,390229,24.99742,1561077
21298,coliva,1,0.00006,390230,24.99749,1561077
21299,CollinLeishman,1,0.00006,390231,24.99755,1561077
21300,coltonw,1,0.00006,390232,24.99761,1561077
21301,comeaujoseph,1,0.00006,390233,24.99768,1561077
21302,comeonjy,1,0.00006,390234,24.99774,1561077
21303,commana,1,0.00006,390235,24.99781,1561077
21304,CommanderPrS,1,0.00006,390236,24.99787,1561077
21305,ComplyOnline,1,0.00006,390237,24.99793,1561077
21306,concrete-ricardo-silva,1,0.00006,390238,24.99800,1561077
21307,coney,1,0.00006,390239,24.99806,1561077
21308,connorh23,1,0.00006,390240,24.99813,1561077
21309,ConnorWGarvey,1,0.00006,390241,24.99819,1561077
21310,conoyes,1,0.00006,390242,24.99825,1561077
21311,conradoc,1,0.00006,390243,24.99832,1561077
21312,ConSeannery,1,0.00006,390244,24.99838,1561077
21313,ConstantineYurevich,1,0.00006,390245,24.99845,1561077
21314,Constantinul,1,0.00006,390246,24.99851,1561077
21315,consulion,1,0.00006,390247,24.99857,1561077
21316,contacttapan,1,0.00006,390248,24.99864,1561077
21317,continuousintegrationaccount,1,0.00006,390249,24.99870,1561077
21318,continuum-sunil-ailsinghani,1,0.00006,390250,24.99877,1561077
21319,coolder,1,0.00006,390251,24.99883,1561077
21320,CoolDuke,1,0.00006,390252,24.99889,1561077
21321,coolersport,1,0.00006,390253,24.99896,1561077
21322,coolgooze,1,0.00006,390254,24.99902,1561077
21323,coolhead,1,0.00006,390255,24.99909,1561077
21324,coolops-cn,1,0.00006,390256,24.99915,1561077
21325,copoka5,1,0.00006,390257,24.99922,1561077
21326,Coral-Liu,1,0.00006,390258,24.99928,1561077
21327,corby,1,0.00006,390259,24.99934,1561077
21328,CorentinSoen,1,0.00006,390260,24.99941,1561077
21329,CornetS28,1,0.00006,390261,24.99947,1561077
21330,corwinon,1,0.00006,390262,24.99954,1561077
21331,CoryARamirez,1,0.00006,390263,24.99960,1561077
21332,Cosaquee,1,0.00006,390264,24.99966,1561077
21333,cosi1,1,0.00006,390265,24.99973,1561077
21334,CosmicLoungeAutomatedUser,1,0.00006,390266,24.99979,1561077
21335,cosminrentea,1,0.00006,390267,24.99986,1561077
21336,CosminSterie,1,0.00006,390268,24.99992,1561077
21337,cosmopetrich,1,0.00006,390269,24.99998,1561077
21338,cosmotejenkinsx,1,0.00006,390270,25.00005,1561077
21339,cosmoteJenkinsX,1,0.00006,390271,25.00011,1561077
21340,cotarelo2,1,0.00006,390272,25.00018,1561077
21341,cotvictor,1,0.00006,390273,25.00024,1561077
21342,coulCod,1,0.00006,390274,25.00030,1561077
21343,counsellors,1,0.00006,390275,25.00037,1561077
21344,covid82,1,0.00006,390276,25.00043,1561077
21345,cow0w,1,0.00006,390277,25.00050,1561077
21346,cozappz,1,0.00006,390278,25.00056,1561077
21347,cpdevws,1,0.00006,390279,25.00062,1561077
21348,cperezprieto,1,0.00006,390280,25.00069,1561077
21349,CPinhoK,1,0.00006,390281,25.00075,1561077
21350,cpottiers,1,0.00006,390282,25.00082,1561077
21351,cptguy,1,0.00006,390283,25.00088,1561077
21352,CptLemming,1,0.00006,390284,25.00094,1561077
21353,cquintana305,1,0.00006,390285,25.00101,1561077
21354,cr1tiqu3,1,0.00006,390286,25.00107,1561077
21355,craigbye,1,0.00006,390287,25.00114,1561077
21356,CraigJPerry,1,0.00006,390288,25.00120,1561077
21357,cralexns,1,0.00006,390289,25.00127,1561077
21358,cramaker,1,0.00006,390290,25.00133,1561077
21359,crathjen,1,0.00006,390291,25.00139,1561077
21360,crazed,1,0.00006,390292,25.00146,1561077
21361,crcibordeaux,1,0.00006,390293,25.00152,1561077
21362,createchange,1,0.00006,390294,25.00159,1561077
21363,criley10,1,0.00006,390295,25.00165,1561077
21364,criley-eagle,1,0.00006,390296,25.00171,1561077
21365,cringdahl,1,0.00006,390297,25.00178,1561077
21366,cristem-cloud,1,0.00006,390298,25.00184,1561077
21367,cristi1979,1,0.00006,390299,25.00191,1561077
21368,cristian-aldea,1,0.00006,390300,25.00197,1561077
21369,cristianokbc,1,0.00006,390301,25.00203,1561077
21370,cristina-grosu,1,0.00006,390302,25.00210,1561077
21371,cristina-pizzagalli,1,0.00006,390303,25.00216,1561077
21372,cristobal-tello,1,0.00006,390304,25.00223,1561077
21373,crittersdkbuild,1,0.00006,390305,25.00229,1561077
21374,cromat,1,0.00006,390306,25.00235,1561077
21375,cr-omermazig,1,0.00006,390307,25.00242,1561077
21376,CroModder,1,0.00006,390308,25.00248,1561077
21377,cronnoss,1,0.00006,390309,25.00255,1561077
21378,cropalato,1,0.00006,390310,25.00261,1561077
21379,crosswind27,1,0.00006,390311,25.00267,1561077
21380,cr-ron-balter,1,0.00006,390312,25.00274,1561077
21381,CRuD117,1,0.00006,390313,25.00280,1561077
21382,crudo1f,1,0.00006,390314,25.00287,1561077
21383,crunchyjohn,1,0.00006,390315,25.00293,1561077
21384,crusoexia,1,0.00006,390316,25.00299,1561077
21385,Crydust,1,0.00006,390317,25.00306,1561077
21386,cryptk,1,0.00006,390318,25.00312,1561077
21387,cryptographrix,1,0.00006,390319,25.00319,1561077
21388,cryptolukas,1,0.00006,390320,25.00325,1561077
21389,CryptoMoveKDD,1,0.00006,390321,25.00332,1561077
21390,crystalbyte,1,0.00006,390322,25.00338,1561077
21391,CryStal-W6,1,0.00006,390323,25.00344,1561077
21392,crytome1995,1,0.00006,390324,25.00351,1561077
21393,cs278,1,0.00006,390325,25.00357,1561077
21394,csaska,1,0.00006,390326,25.00364,1561077
21395,csbuild-c7ks7s,1,0.00006,390327,25.00370,1561077
21396,cSchubes,1,0.00006,390328,25.00376,1561077
21397,CsDenes,1,0.00006,390329,25.00383,1561077
21398,csdz,1,0.00006,390330,25.00389,1561077
21399,csgibson,1,0.00006,390331,25.00396,1561077
21400,csgitharness,1,0.00006,390332,25.00402,1561077
21401,csgruenebe,1,0.00006,390333,25.00408,1561077
21402,csirou,1,0.00006,390334,25.00415,1561077
21403,csizmazia,1,0.00006,390335,25.00421,1561077
21404,csknns,1,0.00006,390336,25.00428,1561077
21405,cslutgen,1,0.00006,390337,25.00434,1561077
21406,cs-mahmoud-khateeb,1,0.00006,390338,25.00440,1561077
21407,csnyder78,1,0.00006,390339,25.00447,1561077
21408,CSobol,1,0.00006,390340,25.00453,1561077
21409,csorbazoli,1,0.00006,390341,25.00460,1561077
21410,cspider,1,0.00006,390342,25.00466,1561077
21411,csrichter,1,0.00006,390343,25.00472,1561077
21412,csskinner25,1,0.00006,390344,25.00479,1561077
21413,ctacke,1,0.00006,390345,25.00485,1561077
21414,ctanoue,1,0.00006,390346,25.00492,1561077
21415,cthiebault,1,0.00006,390347,25.00498,1561077
21416,ctmcisco,1,0.00006,390348,25.00504,1561077
21417,ctogay-uludag,1,0.00006,390349,25.00511,1561077
21418,CtxCharleskn,1,0.00006,390350,25.00517,1561077
21419,cubanp3te,1,0.00006,390351,25.00524,1561077
21420,cubeee,1,0.00006,390352,25.00530,1561077
21421,cubistico,1,0.00006,390353,25.00536,1561077
21422,cuiyangyang,1,0.00006,390354,25.00543,1561077
21423,cukal,1,0.00006,390355,25.00549,1561077
21424,cukiernick,1,0.00006,390356,25.00556,1561077
21425,cullenp,1,0.00006,390357,25.00562,1561077
21426,cul-util,1,0.00006,390358,25.00569,1561077
21427,cumal,1,0.00006,390359,25.00575,1561077
21428,cumtzhangqijie,1,0.00006,390360,25.00581,1561077
21429,cuongnguyen2190,1,0.00006,390361,25.00588,1561077
21430,cure,1,0.00006,390362,25.00594,1561077
21431,curi1119,1,0.00006,390363,25.00601,1561077
21432,currentlib,1,0.00006,390364,25.00607,1561077
21433,CuteErica,1,0.00006,390365,25.00613,1561077
21434,cutik,1,0.00006,390366,25.00620,1561077
21435,cutty201,1,0.00006,390367,25.00626,1561077
21436,cw-ashutoshsharma,1,0.00006,390368,25.00633,1561077
21437,cwitthaus,1,0.00006,390369,25.00639,1561077
21438,CWJoseph,1,0.00006,390370,25.00645,1561077
21439,cwolfinger,1,0.00006,390371,25.00652,1561077
21440,cwtuan,1,0.00006,390372,25.00658,1561077
21441,cwyark,1,0.00006,390373,25.00665,1561077
21442,cxmcc,1,0.00006,390374,25.00671,1561077
21443,cxq,1,0.00006,390375,25.00677,1561077
21444,cyberbemon,1,0.00006,390376,25.00684,1561077
21445,CyberJimbo,1,0.00006,390377,25.00690,1561077
21446,CyberLine,1,0.00006,390378,25.00697,1561077
21447,cybertk,1,0.00006,390379,25.00703,1561077
21448,CyclopsOx,1,0.00006,390380,25.00709,1561077
21449,cyface,1,0.00006,390381,25.00716,1561077
21450,cyrilgdn,1,0.00006,390382,25.00722,1561077
21451,cyrilschmitt,1,0.00006,390383,25.00729,1561077
21452,CyrilSiman,1,0.00006,390384,25.00735,1561077
21453,cyrilzh,1,0.00006,390385,25.00741,1561077
21454,cyrinux,1,0.00006,390386,25.00748,1561077
21455,czalidis,1,0.00006,390387,25.00754,1561077
21456,Czar-Ec,1,0.00006,390388,25.00761,1561077
21457,D1987,1,0.00006,390389,25.00767,1561077
21458,d1nsh,1,0.00006,390390,25.00774,1561077
21459,d2a-raudenaerde,1,0.00006,390391,25.00780,1561077
21460,d35t1201,1,0.00006,390392,25.00786,1561077
21461,D4FR3NCH,1,0.00006,390393,25.00793,1561077
21462,d4nj1,1,0.00006,390394,25.00799,1561077
21463,D4rkPa5senger,1,0.00006,390395,25.00806,1561077
21464,dable-mj111,1,0.00006,390396,25.00812,1561077
21465,dabperceptive,1,0.00006,390397,25.00818,1561077
21466,dabrahams,1,0.00006,390398,25.00825,1561077
21467,dach384,1,0.00006,390399,25.00831,1561077
21468,dacodas,1,0.00006,390400,25.00838,1561077
21469,dado3310,1,0.00006,390401,25.00844,1561077
21470,DadroIT,1,0.00006,390402,25.00850,1561077
21471,DaDummy,1,0.00006,390403,25.00857,1561077
21472,daedelus-j,1,0.00006,390404,25.00863,1561077
21473,Daegalus,1,0.00006,390405,25.00870,1561077
21474,daevski,1,0.00006,390406,25.00876,1561077
21475,dafesmith,1,0.00006,390407,25.00882,1561077
21476,DaFoot,1,0.00006,390408,25.00889,1561077
21477,DafuSHI,1,0.00006,390409,25.00895,1561077
21478,daiduongvo18,1,0.00006,390410,25.00902,1561077
21479,daikaixian,1,0.00006,390411,25.00908,1561077
21480,dailytabs,1,0.00006,390412,25.00914,1561077
21481,dainiax,1,0.00006,390413,25.00921,1561077
21482,daira,1,0.00006,390414,25.00927,1561077
21483,daixijun,1,0.00006,390415,25.00934,1561077
21484,daiyun169,1,0.00006,390416,25.00940,1561077
21485,dajoh16,1,0.00006,390417,25.00946,1561077
21486,dajose,1,0.00006,390418,25.00953,1561077
21487,dakky,1,0.00006,390419,25.00959,1561077
21488,daks,1,0.00006,390420,25.00966,1561077
21489,dakshin2021,1,0.00006,390421,25.00972,1561077
21490,Dakta,1,0.00006,390422,25.00978,1561077
21491,dalbrx,1,0.00006,390423,25.00985,1561077
21492,DaleBetts,1,0.00006,390424,25.00991,1561077
21493,dallasclouddev,1,0.00006,390425,25.00998,1561077
21494,damaarten,1,0.00006,390426,25.01004,1561077
21495,damentz,1,0.00006,390427,25.01011,1561077
21496,damianslee,1,0.00006,390428,25.01017,1561077
21497,damiendurant,1,0.00006,390429,25.01023,1561077
21498,DamirCiganovic-Jankovic,1,0.00006,390430,25.01030,1561077
21499,damiscoulibaly,1,0.00006,390431,25.01036,1561077
21500,damned,1,0.00006,390432,25.01043,1561077
21501,damontgomery,1,0.00006,390433,25.01049,1561077
21502,damontic,1,0.00006,390434,25.01055,1561077
21503,damonZDM,1,0.00006,390435,25.01062,1561077
21504,damusix,1,0.00006,390436,25.01068,1561077
21505,Danack,1,0.00006,390437,25.01075,1561077
21506,DanaGoyette,1,0.00006,390438,25.01081,1561077
21507,danaltemyr,1,0.00006,390439,25.01087,1561077
21508,danbam123,1,0.00006,390440,25.01094,1561077
21509,DanBenHa,1,0.00006,390441,25.01100,1561077
21510,danbim,1,0.00006,390442,25.01107,1561077
21511,danbulant,1,0.00006,390443,25.01113,1561077
21512,dancmox,1,0.00006,390444,25.01119,1561077
21513,dancret,1,0.00006,390445,25.01126,1561077
21514,dan-drew,1,0.00006,390446,25.01132,1561077
21515,danduff,1,0.00006,390447,25.01139,1561077
21516,DanEble,1,0.00006,390448,25.01145,1561077
21517,danehammer,1,0.00006,390449,25.01151,1561077
21518,Danepic,1,0.00006,390450,25.01158,1561077
21519,dan-greene-vgh,1,0.00006,390451,25.01164,1561077
21520,dangvv-teko,1,0.00006,390452,25.01171,1561077
21521,danhiris,1,0.00006,390453,25.01177,1561077
21522,daniadias,1,0.00006,390454,25.01183,1561077
21523,daniel1608,1,0.00006,390455,25.01190,1561077
21524,daniel301991,1,0.00006,390456,25.01196,1561077
21525,danielbcorreia,1,0.00006,390457,25.01203,1561077
21526,danielbischoff,1,0.00006,390458,25.01209,1561077
21527,DanielBruzualRW,1,0.00006,390459,25.01216,1561077
21528,danielcb,1,0.00006,390460,25.01222,1561077
21529,DanielChuDC,1,0.00006,390461,25.01228,1561077
21530,danielcompton,1,0.00006,390462,25.01235,1561077
21531,danielcovington,1,0.00006,390463,25.01241,1561077
21532,danielcwc,1,0.00006,390464,25.01248,1561077
21533,danieldenbraven,1,0.00006,390465,25.01254,1561077
21534,danieldides,1,0.00006,390466,25.01260,1561077
21535,DanielDraus,1,0.00006,390467,25.01267,1561077
21536,danielecr,1,0.00006,390468,25.01273,1561077
21537,danielemontesi,1,0.00006,390469,25.01280,1561077
21538,danielescattaglia,1,0.00006,390470,25.01286,1561077
21539,DanieleSky,1,0.00006,390471,25.01292,1561077
21540,daniel-gomes-sociomantic,1,0.00006,390472,25.01299,1561077
21541,danielhoult,1,0.00006,390473,25.01305,1561077
21542,daniel-jeznach-imgtec,1,0.00006,390474,25.01312,1561077
21543,DanielKoehler,1,0.00006,390475,25.01318,1561077
21544,daniel-lang,1,0.00006,390476,25.01324,1561077
21545,danielllek,1,0.00006,390477,25.01331,1561077
21546,daniellwu,1,0.00006,390478,25.01337,1561077
21547,danielmagnussons,1,0.00006,390479,25.01344,1561077
21548,DanielMunch,1,0.00006,390480,25.01350,1561077
21549,DanielO,1,0.00006,390481,25.01356,1561077
21550,danielolsonah,1,0.00006,390482,25.01363,1561077
21551,daniel-otcxn,1,0.00006,390483,25.01369,1561077
21552,daniel-pfeiffer,1,0.00006,390484,25.01376,1561077
21553,daniel-pilot,1,0.00006,390485,25.01382,1561077
21554,danielpsf,1,0.00006,390486,25.01388,1561077
21555,danielrussellLA,1,0.00006,390487,25.01395,1561077
21556,danielrvt,1,0.00006,390488,25.01401,1561077
21557,danielsaf,1,0.00006,390489,25.01408,1561077
21558,danielsiwiec,1,0.00006,390490,25.01414,1561077
21559,danielstoian,1,0.00006,390491,25.01420,1561077
21560,danieltrator,1,0.00006,390492,25.01427,1561077
21561,danielunderwood,1,0.00006,390493,25.01433,1561077
21562,Dani-Google,1,0.00006,390494,25.01440,1561077
21563,daniilyar,1,0.00006,390495,25.01446,1561077
21564,danilobuerger,1,0.00006,390496,25.01453,1561077
21565,DaniloGT,1,0.00006,390497,25.01459,1561077
21566,danishkamili,1,0.00006,390498,25.01465,1561077
21567,danjasmin,1,0.00006,390499,25.01472,1561077
21568,danjellesma,1,0.00006,390500,25.01478,1561077
21569,danjor,1,0.00006,390501,25.01485,1561077
21570,dan-kirberger,1,0.00006,390502,25.01491,1561077
21571,danlsgiga,1,0.00006,390503,25.01497,1561077
21572,danmademe,1,0.00006,390504,25.01504,1561077
21573,danmandle,1,0.00006,390505,25.01510,1561077
21574,dannascimento,1,0.00006,390506,25.01517,1561077
21575,dannykansas,1,0.00006,390507,25.01523,1561077
21576,dannykitchen,1,0.00006,390508,25.01529,1561077
21577,DannyMassa,1,0.00006,390509,25.01536,1561077
21578,dannyroy22,1,0.00006,390510,25.01542,1561077
21579,dannyviti,1,0.00006,390511,25.01549,1561077
21580,danotrax,1,0.00006,390512,25.01555,1561077
21581,danpfe,1,0.00006,390513,25.01561,1561077
21582,danPowell52,1,0.00006,390514,25.01568,1561077
21583,danqiao,1,0.00006,390515,25.01574,1561077
21584,dansajner,1,0.00006,390516,25.01581,1561077
21585,dansali,1,0.00006,390517,25.01587,1561077
21586,dansheme,1,0.00006,390518,25.01593,1561077
21587,Danteeswararao,1,0.00006,390519,25.01600,1561077
21588,Danulb,1,0.00006,390520,25.01606,1561077
21589,DanVill29,1,0.00006,390521,25.01613,1561077
21590,dapage,1,0.00006,390522,25.01619,1561077
21591,daprog,1,0.00006,390523,25.01625,1561077
21592,darcyrush,1,0.00006,390524,25.01632,1561077
21593,darede-git,1,0.00006,390525,25.01638,1561077
21594,darenjacobstellic,1,0.00006,390526,25.01645,1561077
21595,DarienFord,1,0.00006,390527,25.01651,1561077
21596,darina-techery,1,0.00006,390528,25.01658,1561077
21597,dariodsa,1,0.00006,390529,25.01664,1561077
21598,Dark-Angel0813,1,0.00006,390530,25.01670,1561077
21599,dark-developer15,1,0.00006,390531,25.01677,1561077
21600,DarkGigaByte,1,0.00006,390532,25.01683,1561077
21601,DarkGraySun,1,0.00006,390533,25.01690,1561077
21602,darkingue,1,0.00006,390534,25.01696,1561077
21603,darkklin,1,0.00006,390535,25.01702,1561077
21604,DarkNormal,1,0.00006,390536,25.01709,1561077
21605,darkvertex,1,0.00006,390537,25.01715,1561077
21606,darlaker,1,0.00006,390538,25.01722,1561077
21607,daroczig,1,0.00006,390539,25.01728,1561077
21608,DarrenLo,1,0.00006,390540,25.01734,1561077
21609,DarrenRatcliffe,1,0.00006,390541,25.01741,1561077
21610,darrenweiner,1,0.00006,390542,25.01747,1561077
21611,darrylmelander,1,0.00006,390543,25.01754,1561077
21612,darshandzend,1,0.00006,390544,25.01760,1561077
21613,DarthBlair,1,0.00006,390545,25.01766,1561077
21614,darthkisling,1,0.00006,390546,25.01773,1561077
21615,darthsteven,1,0.00006,390547,25.01779,1561077
21616,darvein,1,0.00006,390548,25.01786,1561077
21617,Daryes,1,0.00006,390549,25.01792,1561077
21618,dasaro1415daw2,1,0.00006,390550,25.01798,1561077
21619,dasein,1,0.00006,390551,25.01805,1561077
21620,Dasmandr,1,0.00006,390552,25.01811,1561077
21621,da-snap,1,0.00006,390553,25.01818,1561077
21622,dastanko,1,0.00006,390554,25.01824,1561077
21623,data-henrik,1,0.00006,390555,25.01830,1561077
21624,datalogics-robb,1,0.00006,390556,25.01837,1561077
21625,datenzauberer,1,0.00006,390557,25.01843,1561077
21626,DatGizmo,1,0.00006,390558,25.01850,1561077
21627,dat-timfa,1,0.00006,390559,25.01856,1561077
21628,dattran929,1,0.00006,390560,25.01862,1561077
21629,DatzAtWork,1,0.00006,390561,25.01869,1561077
21630,daubman,1,0.00006,390562,25.01875,1561077
21631,DaveB93,1,0.00006,390563,25.01882,1561077
21632,davecarlson,1,0.00006,390564,25.01888,1561077
21633,davedomainx,1,0.00006,390565,25.01895,1561077
21634,DaveHewy,1,0.00006,390566,25.01901,1561077
21635,dave-kennedy,1,0.00006,390567,25.01907,1561077
21636,DaveKrieger,1,0.00006,390568,25.01914,1561077
21637,DaveNoth,1,0.00006,390569,25.01920,1561077
21638,davesade,1,0.00006,390570,25.01927,1561077
21639,davesave,1,0.00006,390571,25.01933,1561077
21640,davesliu,1,0.00006,390572,25.01939,1561077
21641,davewv31,1,0.00006,390573,25.01946,1561077
21642,daveysa,1,0.00006,390574,25.01952,1561077
21643,david942j,1,0.00006,390575,25.01959,1561077
21644,david972,1,0.00006,390576,25.01965,1561077
21645,David-Adams-RCI,1,0.00006,390577,25.01971,1561077
21646,davidberglund,1,0.00006,390578,25.01978,1561077
21647,davidc14,1,0.00006,390579,25.01984,1561077
21648,david-caro,1,0.00006,390580,25.01991,1561077
21649,daviddelannoy,1,0.00006,390581,25.01997,1561077
21650,daviddetorres,1,0.00006,390582,25.02003,1561077
21651,davidedimauro88,1,0.00006,390583,25.02010,1561077
21652,DavidEllis008,1,0.00006,390584,25.02016,1561077
21653,david-gonzalez-imatia,1,0.00006,390585,25.02023,1561077
21654,davidh87,1,0.00006,390586,25.02029,1561077
21655,DavidHe1127,1,0.00006,390587,25.02035,1561077
21656,davidjytang,1,0.00006,390588,25.02042,1561077
21657,DavidKuna,1,0.00006,390589,25.02048,1561077
21658,davidmackarill,1,0.00006,390590,25.02055,1561077
21659,davidmfg,1,0.00006,390591,25.02061,1561077
21660,davidmichaeli,1,0.00006,390592,25.02067,1561077
21661,davidmnoriega,1,0.00006,390593,25.02074,1561077
21662,davidmoralc,1,0.00006,390594,25.02080,1561077
21663,davidorlea,1,0.00006,390595,25.02087,1561077
21664,davidpelayo,1,0.00006,390596,25.02093,1561077
21665,DavidR91,1,0.00006,390597,25.02100,1561077
21666,davidritter,1,0.00006,390598,25.02106,1561077
21667,DavidSanchezAlvarez,1,0.00006,390599,25.02112,1561077
21668,davidschou,1,0.00006,390600,25.02119,1561077
21669,davidsiracusa,1,0.00006,390601,25.02125,1561077
21670,davidslee9-sme,1,0.00006,390602,25.02132,1561077
21671,davidsloan,1,0.00006,390603,25.02138,1561077
21672,davidstaheli,1,0.00006,390604,25.02144,1561077
21673,davidsuba,1,0.00006,390605,25.02151,1561077
21674,davidthong,1,0.00006,390606,25.02157,1561077
21675,davidx,1,0.00006,390607,25.02164,1561077
21676,davinod,1,0.00006,390608,25.02170,1561077
21677,davitol,1,0.00006,390609,25.02176,1561077
21678,davorpa,1,0.00006,390610,25.02183,1561077
21679,davutg,1,0.00006,390611,25.02189,1561077
21680,dawidbojarowicz,1,0.00006,390612,25.02196,1561077
21681,Dawn-Davenport,1,0.00006,390613,25.02202,1561077
21682,dayanamcc,1,0.00006,390614,25.02208,1561077
21683,dayanstef,1,0.00006,390615,25.02215,1561077
21684,daytonpa,1,0.00006,390616,25.02221,1561077
21685,dayvsonsales,1,0.00006,390617,25.02228,1561077
21686,dazzrpm,1,0.00006,390618,25.02234,1561077
21687,dbarnie,1,0.00006,390619,25.02240,1561077
21688,dbgrandi,1,0.00006,390620,25.02247,1561077
21689,dbirtch-va,1,0.00006,390621,25.02253,1561077
21690,dbitkowski,1,0.00006,390622,25.02260,1561077
21691,dblees,1,0.00006,390623,25.02266,1561077
21692,dbridger,1,0.00006,390624,25.02272,1561077
21693,dcasanova82,1,0.00006,390625,25.02279,1561077
21694,dcgregorya,1,0.00006,390626,25.02285,1561077
21695,dchau28,1,0.00006,390627,25.02292,1561077
21696,dchivescu-gpsw,1,0.00006,390628,25.02298,1561077
21697,dchsueh,1,0.00006,390629,25.02304,1561077
21698,dcrn,1,0.00006,390630,25.02311,1561077
21699,dcw329,1,0.00006,390631,25.02317,1561077
21700,dcworldwide,1,0.00006,390632,25.02324,1561077
21701,dcz-purism,1,0.00006,390633,25.02330,1561077
21702,ddevault,1,0.00006,390634,25.02337,1561077
21703,ddewhurst444,1,0.00006,390635,25.02343,1561077
21704,ddfreiling,1,0.00006,390636,25.02349,1561077
21705,ddubson,1,0.00006,390637,25.02356,1561077
21706,ddukbg,1,0.00006,390638,25.02362,1561077
21707,dduuch,1,0.00006,390639,25.02369,1561077
21708,ddzed15,1,0.00006,390640,25.02375,1561077
21709,De1taE1even,1,0.00006,390641,25.02381,1561077
21710,deadly-platypus,1,0.00006,390642,25.02388,1561077
21711,deadlysyn,1,0.00006,390643,25.02394,1561077
21712,deadman2000,1,0.00006,390644,25.02401,1561077
21713,DearBo7,1,0.00006,390645,25.02407,1561077
21714,debayanchatterjee,1,0.00006,390646,25.02413,1561077
21715,debfx,1,0.00006,390647,25.02420,1561077
21716,debu99,1,0.00006,390648,25.02426,1561077
21717,debug510,1,0.00006,390649,25.02433,1561077
21718,decibelhertz,1,0.00006,390650,25.02439,1561077
21719,deciian,1,0.00006,390651,25.02445,1561077
21720,deckerp,1,0.00006,390652,25.02452,1561077
21721,DecoyJoe,1,0.00006,390653,25.02458,1561077
21722,dedalusj,1,0.00006,390654,25.02465,1561077
21723,dedpnd,1,0.00006,390655,25.02471,1561077
21724,DedySamhaz,1,0.00006,390656,25.02477,1561077
21725,Deehoos,1,0.00006,390657,25.02484,1561077
21726,Deepa003,1,0.00006,390658,25.02490,1561077
21727,deepakdefender264,1,0.00006,390659,25.02497,1561077
21728,Deepak-Routray,1,0.00006,390660,25.02503,1561077
21729,DeepakSoora,1,0.00006,390661,25.02509,1561077
21730,deepan10,1,0.00006,390662,25.02516,1561077
21731,deepank-sharma,1,0.00006,390663,25.02522,1561077
21732,deepio-oc,1,0.00006,390664,25.02529,1561077
21733,deeptechs,1,0.00006,390665,25.02535,1561077
21734,deeptik2,1,0.00006,390666,25.02542,1561077
21735,deepu12,1,0.00006,390667,25.02548,1561077
21736,deepwaterdivernw,1,0.00006,390668,25.02554,1561077
21737,deerawan,1,0.00006,390669,25.02561,1561077
21738,deersilverstein,1,0.00006,390670,25.02567,1561077
21739,DeHecht,1,0.00006,390671,25.02574,1561077
21740,dejanmarich,1,0.00006,390672,25.02580,1561077
21741,dekimsey,1,0.00006,390673,25.02586,1561077
21742,Deklin,1,0.00006,390674,25.02593,1561077
21743,delgurth,1,0.00006,390675,25.02599,1561077
21744,delhora,1,0.00006,390676,25.02606,1561077
21745,delineaKrehl,1,0.00006,390677,25.02612,1561077
21746,delmartechdude,1,0.00006,390678,25.02618,1561077
21747,delned,1,0.00006,390679,25.02625,1561077
21748,DelusionalLogic,1,0.00006,390680,25.02631,1561077
21749,dematic-jason-deland,1,0.00006,390681,25.02638,1561077
21750,demee,1,0.00006,390682,25.02644,1561077
21751,DemenkovK,1,0.00006,390683,25.02650,1561077
21752,demett-brcm,1,0.00006,390684,25.02657,1561077
21753,demiangmz,1,0.00006,390685,25.02663,1561077
21754,demirole,1,0.00006,390686,25.02670,1561077
21755,Demmtop,1,0.00006,390687,25.02676,1561077
21756,demonkoryu,1,0.00006,390688,25.02682,1561077
21757,DemonTPx,1,0.00006,390689,25.02689,1561077
21758,DenesCs,1,0.00006,390690,25.02695,1561077
21759,denglitong,1,0.00006,390691,25.02702,1561077
21760,dengqingpei1990,1,0.00006,390692,25.02708,1561077
21761,denis111,1,0.00006,390693,25.02714,1561077
21762,denis-colliot,1,0.00006,390694,25.02721,1561077
21763,denis-platonov,1,0.00006,390695,25.02727,1561077
21764,Deniszen,1,0.00006,390696,25.02734,1561077
21765,denji,1,0.00006,390697,25.02740,1561077
21766,denkojonasz,1,0.00006,390698,25.02747,1561077
21767,dennis-behm,1,0.00006,390699,25.02753,1561077
21768,dennisfischer,1,0.00006,390700,25.02759,1561077
21769,dennisgranath,1,0.00006,390701,25.02766,1561077
21770,dennisjac,1,0.00006,390702,25.02772,1561077
21771,dennisjansen,1,0.00006,390703,25.02779,1561077
21772,dennisoehme,1,0.00006,390704,25.02785,1561077
21773,densanki,1,0.00006,390705,25.02791,1561077
21774,dentrifonov,1,0.00006,390706,25.02798,1561077
21775,Dentxinho,1,0.00006,390707,25.02804,1561077
21776,depay,1,0.00006,390708,25.02811,1561077
21777,dephee,1,0.00006,390709,25.02817,1561077
21778,deraffe,1,0.00006,390710,25.02823,1561077
21779,derbenevivan,1,0.00006,390711,25.02830,1561077
21780,derdour-r,1,0.00006,390712,25.02836,1561077
21781,dereckmartin,1,0.00006,390713,25.02843,1561077
21782,derekslenk,1,0.00006,390714,25.02849,1561077
21783,derekwilliamscrosswinds,1,0.00006,390715,25.02855,1561077
21784,dererk,1,0.00006,390716,25.02862,1561077
21785,Dergons,1,0.00006,390717,25.02868,1561077
21786,derholle,1,0.00006,390718,25.02875,1561077
21787,derKosi,1,0.00006,390719,25.02881,1561077
21788,derkyjadex,1,0.00006,390720,25.02887,1561077
21789,derliebemarcus,1,0.00006,390721,25.02894,1561077
21790,dermidgen,1,0.00006,390722,25.02900,1561077
21791,derphilipp,1,0.00006,390723,25.02907,1561077
21792,derqurps,1,0.00006,390724,25.02913,1561077
21793,derrickrc,1,0.00006,390725,25.02919,1561077
21794,derschatta,1,0.00006,390726,25.02926,1561077
21795,desaibhavik,1,0.00006,390727,25.02932,1561077
21796,deshab-sri,1,0.00006,390728,25.02939,1561077
21797,deshpande-adwait,1,0.00006,390729,25.02945,1561077
21798,desiby,1,0.00006,390730,25.02951,1561077
21799,designatevoid,1,0.00006,390731,25.02958,1561077
21800,desillusion,1,0.00006,390732,25.02964,1561077
21801,DesireWithin,1,0.00006,390733,25.02971,1561077
21802,desmondchen,1,0.00006,390734,25.02977,1561077
21803,desmondhume,1,0.00006,390735,25.02984,1561077
21804,desourav,1,0.00006,390736,25.02990,1561077
21805,DetlefSchuetz,1,0.00006,390737,25.02996,1561077
21806,deusnuno,1,0.00006,390738,25.03003,1561077
21807,deuterium,1,0.00006,390739,25.03009,1561077
21808,devakone,1,0.00006,390740,25.03016,1561077
21809,devantoine,1,0.00006,390741,25.03022,1561077
21810,devcharted,1,0.00006,390742,25.03028,1561077
21811,dev-chulbuji,1,0.00006,390743,25.03035,1561077
21812,devdev-dev,1,0.00006,390744,25.03041,1561077
21813,dev-divyansh,1,0.00006,390745,25.03048,1561077
21814,deveddev,1,0.00006,390746,25.03054,1561077
21815,developer-rockhs,1,0.00006,390747,25.03060,1561077
21816,DEvil0000,1,0.00006,390748,25.03067,1561077
21817,DevilHost069,1,0.00006,390749,25.03073,1561077
21818,DevilWAH,1,0.00006,390750,25.03080,1561077
21819,devingenx,1,0.00006,390751,25.03086,1561077
21820,devInteam,1,0.00006,390752,25.03092,1561077
21821,DevMandy,1,0.00006,390753,25.03099,1561077
21822,dev-medha-io,1,0.00006,390754,25.03105,1561077
21823,devmedlmobile,1,0.00006,390755,25.03112,1561077
21824,devminded,1,0.00006,390756,25.03118,1561077
21825,devng,1,0.00006,390757,25.03124,1561077
21826,devops-42,1,0.00006,390758,25.03131,1561077
21827,devopschn,1,0.00006,390759,25.03137,1561077
21828,devopsclasss2020,1,0.00006,390760,25.03144,1561077
21829,DevOps-group-2023,1,0.00006,390761,25.03150,1561077
21830,DevOpsInaBox,1,0.00006,390762,25.03156,1561077
21831,devopskartik,1,0.00006,390763,25.03163,1561077
21832,devopski,1,0.00006,390764,25.03169,1561077
21833,DevOpsMaestro,1,0.00006,390765,25.03176,1561077
21834,devopsmatt,1,0.00006,390766,25.03182,1561077
21835,devopsnote,1,0.00006,390767,25.03189,1561077
21836,devops-novice,1,0.00006,390768,25.03195,1561077
21837,devopspinar,1,0.00006,390769,25.03201,1561077
21838,devops-tavus,1,0.00006,390770,25.03208,1561077
21839,devopsy-ir,1,0.00006,390771,25.03214,1561077
21840,DEV-Pad,1,0.00006,390772,25.03221,1561077
21841,devsecops-pe,1,0.00006,390773,25.03227,1561077
21842,devster31,1,0.00006,390774,25.03233,1561077
21843,devstrat,1,0.00006,390775,25.03240,1561077
21844,devstuff,1,0.00006,390776,25.03246,1561077
21845,devwander,1,0.00006,390777,25.03253,1561077
21846,Deweytle,1,0.00006,390778,25.03259,1561077
21847,dexpota,1,0.00006,390779,25.03265,1561077
21848,deyanstoykov,1,0.00006,390780,25.03272,1561077
21849,Deyine,1,0.00006,390781,25.03278,1561077
21850,dgaffuri,1,0.00006,390782,25.03285,1561077
21851,dgarbus,1,0.00006,390783,25.03291,1561077
21852,DGarry82,1,0.00006,390784,25.03297,1561077
21853,dgenest65,1,0.00006,390785,25.03304,1561077
21854,dggs123,1,0.00006,390786,25.03310,1561077
21855,dgloeckner,1,0.00006,390787,25.03317,1561077
21856,dgoradia,1,0.00006,390788,25.03323,1561077
21857,dgpc,1,0.00006,390789,25.03329,1561077
21858,dguzmanSM,1,0.00006,390790,25.03336,1561077
21859,dhallam,1,0.00006,390791,25.03342,1561077
21860,dhanish2k,1,0.00006,390792,25.03349,1561077
21861,dharam01,1,0.00006,390793,25.03355,1561077
21862,dharam1,1,0.00006,390794,25.03361,1561077
21863,dharasis1993,1,0.00006,390795,25.03368,1561077
21864,dharkness,1,0.00006,390796,25.03374,1561077
21865,dharmendra-ctl,1,0.00006,390797,25.03381,1561077
21866,dhartwich1991,1,0.00006,390798,25.03387,1561077
21867,dhduvall,1,0.00006,390799,25.03393,1561077
21868,dhhuynh2,1,0.00006,390800,25.03400,1561077
21869,dhilbrin,1,0.00006,390801,25.03406,1561077
21870,dhiltonp,1,0.00006,390802,25.03413,1561077
21871,dhingraaditya,1,0.00006,390803,25.03419,1561077
21872,dhorskyi,1,0.00006,390804,25.03426,1561077
21873,Dhouti,1,0.00006,390805,25.03432,1561077
21874,DhruvitSoni,1,0.00006,390806,25.03438,1561077
21875,DhruvJ225,1,0.00006,390807,25.03445,1561077
21876,dhudomiet,1,0.00006,390808,25.03451,1561077
21877,dhufnagel,1,0.00006,390809,25.03458,1561077
21878,d-huynh,1,0.00006,390810,25.03464,1561077
21879,diamondT,1,0.00006,390811,25.03470,1561077
21880,diana-papajohns,1,0.00006,390812,25.03477,1561077
21881,dianazv,1,0.00006,390813,25.03483,1561077
21882,diandiankou,1,0.00006,390814,25.03490,1561077
21883,Dibakarroy1997,1,0.00006,390815,25.03496,1561077
21884,dibe84,1,0.00006,390816,25.03502,1561077
21885,dibegittest,1,0.00006,390817,25.03509,1561077
21886,dibits,1,0.00006,390818,25.03515,1561077
21887,dice14u,1,0.00006,390819,25.03522,1561077
21888,dictyo,1,0.00006,390820,25.03528,1561077
21889,DI-DaveGoodine,1,0.00006,390821,25.03534,1561077
21890,DidierFort,1,0.00006,390822,25.03541,1561077
21891,didiervb,1,0.00006,390823,25.03547,1561077
21892,diegobmd,1,0.00006,390824,25.03554,1561077
21893,DiegoCoronel,1,0.00006,390825,25.03560,1561077
21894,diegocr,1,0.00006,390826,25.03566,1561077
21895,diegograssato,1,0.00006,390827,25.03573,1561077
21896,diego-ojeda-binbash,1,0.00006,390828,25.03579,1561077
21897,diegorusso,1,0.00006,390829,25.03586,1561077
21898,diegosep,1,0.00006,390830,25.03592,1561077
21899,diethardsteiner,1,0.00006,390831,25.03598,1561077
21900,dietmarlenzenlx,1,0.00006,390832,25.03605,1561077
21901,dietmarmenges,1,0.00006,390833,25.03611,1561077
21902,dieu,1,0.00006,390834,25.03618,1561077
21903,diffalot,1,0.00006,390835,25.03624,1561077
21904,diffblue-code-assistant,1,0.00006,390836,25.03631,1561077
21905,difki,1,0.00006,390837,25.03637,1561077
21906,digennarot,1,0.00006,390838,25.03643,1561077
21907,digitalBush,1,0.00006,390839,25.03650,1561077
21908,digitaljedi2,1,0.00006,390840,25.03656,1561077
21909,digitalray,1,0.00006,390841,25.03663,1561077
21910,digolo,1,0.00006,390842,25.03669,1561077
21911,dihedron,1,0.00006,390843,25.03675,1561077
21912,DiJu519,1,0.00006,390844,25.03682,1561077
21913,dilawar,1,0.00006,390845,25.03688,1561077
21914,dileep626,1,0.00006,390846,25.03695,1561077
21915,dilinigunasena,1,0.00006,390847,25.03701,1561077
21916,dilip123k,1,0.00006,390848,25.03707,1561077
21917,dilip-desing,1,0.00006,390849,25.03714,1561077
21918,dilipdesing,1,0.00006,390850,25.03720,1561077
21919,dilipk8,1,0.00006,390851,25.03727,1561077
21920,Dilipnk,1,0.00006,390852,25.03733,1561077
21921,dilipts4u,1,0.00006,390853,25.03739,1561077
21922,DillonStreator,1,0.00006,390854,25.03746,1561077
21923,DillonWatts0x79,1,0.00006,390855,25.03752,1561077
21924,dimagr-arm,1,0.00006,390856,25.03759,1561077
21925,dimasmamot,1,0.00006,390857,25.03765,1561077
21926,DimaVartanian,1,0.00006,390858,25.03771,1561077
21927,dimitrez,1,0.00006,390859,25.03778,1561077
21928,dimitrijezivkovic,1,0.00006,390860,25.03784,1561077
21929,DimitrisFragos,1,0.00006,390861,25.03791,1561077
21930,dimul,1,0.00006,390862,25.03797,1561077
21931,DinaGamalMahmoud,1,0.00006,390863,25.03803,1561077
21932,dinagit2711,1,0.00006,390864,25.03810,1561077
21933,dineshdevopsshare,1,0.00006,390865,25.03816,1561077
21934,DineshGinwali,1,0.00006,390866,25.03823,1561077
21935,dineshgioe,1,0.00006,390867,25.03829,1561077
21936,dineshk8666,1,0.00006,390868,25.03835,1561077
21937,dineshtrivedi,1,0.00006,390869,25.03842,1561077
21938,dineshviswanath,1,0.00006,390870,25.03848,1561077
21939,dingguangjun,1,0.00006,390871,25.03855,1561077
21940,dinhanhhuy,1,0.00006,390872,25.03861,1561077
21941,dinu576,1,0.00006,390873,25.03868,1561077
21942,dinup24,1,0.00006,390874,25.03874,1561077
21943,diocles,1,0.00006,390875,25.03880,1561077
21944,diogocarleto,1,0.00006,390876,25.03887,1561077
21945,diogosimao,1,0.00006,390877,25.03893,1561077
21946,dioguerra,1,0.00006,390878,25.03900,1561077
21947,dionysiose,1,0.00006,390879,25.03906,1561077
21948,dipalpatel,1,0.00006,390880,25.03912,1561077
21949,dipesh017,1,0.00006,390881,25.03919,1561077
21950,dipjul,1,0.00006,390882,25.03925,1561077
21951,dipper-github-preprod,1,0.00006,390883,25.03932,1561077
21952,direction,1,0.00006,390884,25.03938,1561077
21953,dirk-leroux,1,0.00006,390885,25.03944,1561077
21954,divashdr,1,0.00006,390886,25.03951,1561077
21955,divivitaly,1,0.00006,390887,25.03957,1561077
21956,divjotsinghnanda,1,0.00006,390888,25.03964,1561077
21957,DivvyAndrew,1,0.00006,390889,25.03970,1561077
21958,divyank-gupta,1,0.00006,390890,25.03976,1561077
21959,DizzyThermal,1,0.00006,390891,25.03983,1561077
21960,djaisingh,1,0.00006,390892,25.03989,1561077
21961,djakielskiadesso,1,0.00006,390893,25.03996,1561077
21962,Djaler,1,0.00006,390894,25.04002,1561077
21963,djangofan,1,0.00006,390895,25.04008,1561077
21964,Djangofs,1,0.00006,390896,25.04015,1561077
21965,djarnis73,1,0.00006,390897,25.04021,1561077
21966,djb61,1,0.00006,390898,25.04028,1561077
21967,djbb7,1,0.00006,390899,25.04034,1561077
21968,djbender,1,0.00006,390900,25.04040,1561077
21969,djbrown92,1,0.00006,390901,25.04047,1561077
21970,djfdyuruiry,1,0.00006,390902,25.04053,1561077
21971,djholly123,1,0.00006,390903,25.04060,1561077
21972,djmille1,1,0.00006,390904,25.04066,1561077
21973,djnalluri,1,0.00006,390905,25.04073,1561077
21974,djsipe,1,0.00006,390906,25.04079,1561077
21975,DjTamotsu,1,0.00006,390907,25.04085,1561077
21976,djtfmartin,1,0.00006,390908,25.04092,1561077
21977,djverlinden,1,0.00006,390909,25.04098,1561077
21978,dkaplan-pivotal,1,0.00006,390910,25.04105,1561077
21979,dklostermann,1,0.00006,390911,25.04111,1561077
21980,dkoerner85,1,0.00006,390912,25.04117,1561077
21981,dkokic,1,0.00006,390913,25.04124,1561077
21982,dkpiesak,1,0.00006,390914,25.04130,1561077
21983,dksingla,1,0.00006,390915,25.04137,1561077
21984,dladi,1,0.00006,390916,25.04143,1561077
21985,dlakatos847,1,0.00006,390917,25.04149,1561077
21986,dlax,1,0.00006,390918,25.04156,1561077
21987,DLemberger,1,0.00006,390919,25.04162,1561077
21988,dlethin,1,0.00006,390920,25.04169,1561077
21989,dlidstrom,1,0.00006,390921,25.04175,1561077
21990,dlylei,1,0.00006,390922,25.04181,1561077
21991,dmabamboo,1,0.00006,390923,25.04188,1561077
21992,dmai-apixio,1,0.00006,390924,25.04194,1561077
21993,dmaljovec,1,0.00006,390925,25.04201,1561077
21994,dmanero,1,0.00006,390926,25.04207,1561077
21995,d-mankowski-samsung,1,0.00006,390927,25.04213,1561077
21996,dmartell-bp,1,0.00006,390928,25.04220,1561077
21997,dmatej,1,0.00006,390929,25.04226,1561077
21998,dmc5179,1,0.00006,390930,25.04233,1561077
21999,dmclean62,1,0.00006,390931,25.04239,1561077
22000,dmewadamobi,1,0.00006,390932,25.04245,1561077
22001,dmhursh,1,0.00006,390933,25.04252,1561077
22002,dmikhaylov,1,0.00006,390934,25.04258,1561077
22003,dmitrigrigoriev,1,0.00006,390935,25.04265,1561077
22004,dmitrii-dmnk,1,0.00006,390936,25.04271,1561077
22005,dmitrikudrenko,1,0.00006,390937,25.04277,1561077
22006,DmitriyEsin,1,0.00006,390938,25.04284,1561077
22007,dmitriykanarskiy,1,0.00006,390939,25.04290,1561077
22008,DmitryLazyuka,1,0.00006,390940,25.04297,1561077
22009,dmitrym0,1,0.00006,390941,25.04303,1561077
22010,dmitrynikolaev,1,0.00006,390942,25.04310,1561077
22011,dmk255,1,0.00006,390943,25.04316,1561077
22012,dmkuznetsov,1,0.00006,390944,25.04322,1561077
22013,dmm-iso,1,0.00006,390945,25.04329,1561077
22014,dmolesUC,1,0.00006,390946,25.04335,1561077
22015,dmonaco05,1,0.00006,390947,25.04342,1561077
22016,dmone90,1,0.00006,390948,25.04348,1561077
22017,dmonteiro-paddle,1,0.00006,390949,25.04354,1561077
22018,dmpe,1,0.00006,390950,25.04361,1561077
22019,dmtrustyourinbox,1,0.00006,390951,25.04367,1561077
22020,dmugtasimov,1,0.00006,390952,25.04374,1561077
22021,DmytroPazykov,1,0.00006,390953,25.04380,1561077
22022,dmzobel,1,0.00006,390954,25.04386,1561077
22023,dnatic09,1,0.00006,390955,25.04393,1561077
22024,dneduva-cisco,1,0.00006,390956,25.04399,1561077
22025,dnery,1,0.00006,390957,25.04406,1561077
22026,DNewt,1,0.00006,390958,25.04412,1561077
22027,dnguyenzd,1,0.00006,390959,25.04418,1561077
22028,dnlek,1,0.00006,390960,25.04425,1561077
22029,dnmag,1,0.00006,390961,25.04431,1561077
22030,dnnsjcbs,1,0.00006,390962,25.04438,1561077
22031,dnyamy,1,0.00006,390963,25.04444,1561077
22032,dnyanesh-nagre-blazerunner,1,0.00006,390964,25.04450,1561077
22033,doantranthanh,1,0.00006,390965,25.04457,1561077
22034,dockernewbie,1,0.00006,390966,25.04463,1561077
22035,dockeryun,1,0.00006,390967,25.04470,1561077
22036,doctaphred,1,0.00006,390968,25.04476,1561077
22037,doctau,1,0.00006,390969,25.04482,1561077
22038,doctorseus,1,0.00006,390970,25.04489,1561077
22039,DodgeCamaro,1,0.00006,390971,25.04495,1561077
22040,dogfooding-ozone,1,0.00006,390972,25.04502,1561077
22041,dohpaz42,1,0.00006,390973,25.04508,1561077
22042,dojones1,1,0.00006,390974,25.04515,1561077
22043,DoktorZ,1,0.00006,390975,25.04521,1561077
22044,dolevhadad,1,0.00006,390976,25.04527,1561077
22045,Dolimont,1,0.00006,390977,25.04534,1561077
22046,dolonm-mw,1,0.00006,390978,25.04540,1561077
22047,doloreszhang,1,0.00006,390979,25.04547,1561077
22048,domhdp,1,0.00006,390980,25.04553,1561077
22049,domi55,1,0.00006,390981,25.04559,1561077
22050,DominicTulley,1,0.00006,390982,25.04566,1561077
22051,DomiRusz24,1,0.00006,390983,25.04572,1561077
22052,domofactor,1,0.00006,390984,25.04579,1561077
22053,Domonlee,1,0.00006,390985,25.04585,1561077
22054,domq,1,0.00006,390986,25.04591,1561077
22055,donaladams,1,0.00006,390987,25.04598,1561077
22056,DonaldChan,1,0.00006,390988,25.04604,1561077
22057,DonConMan,1,0.00006,390989,25.04611,1561077
22058,dond00m,1,0.00006,390990,25.04617,1561077
22059,donggyu81,1,0.00006,390991,25.04623,1561077
22060,dongxurr123,1,0.00006,390992,25.04630,1561077
22061,donnellyk,1,0.00006,390993,25.04636,1561077
22062,doombubbles,1,0.00006,390994,25.04643,1561077
22063,doratias,1,0.00006,390995,25.04649,1561077
22064,dorgolan,1,0.00006,390996,25.04655,1561077
22065,dorocizna,1,0.00006,390997,25.04662,1561077
22066,Dorsosiv,1,0.00006,390998,25.04668,1561077
22067,doruchiulan,1,0.00006,390999,25.04675,1561077
22068,Dorvaryn,1,0.00006,391000,25.04681,1561077
22069,dossy,1,0.00006,391001,25.04687,1561077
22070,dot1q,1,0.00006,391002,25.04694,1561077
22071,dotressel,1,0.00006,391003,25.04700,1561077
22072,doubleo2,1,0.00006,391004,25.04707,1561077
22073,Double-Rabbits,1,0.00006,391005,25.04713,1561077
22074,doublesharp,1,0.00006,391006,25.04719,1561077
22075,doubles-ss,1,0.00006,391007,25.04726,1561077
22076,dougalg,1,0.00006,391008,25.04732,1561077
22077,doug-clari,1,0.00006,391009,25.04739,1561077
22078,dough29,1,0.00006,391010,25.04745,1561077
22079,DouglasRoyds,1,0.00006,391011,25.04752,1561077
22080,dougporter,1,0.00006,391012,25.04758,1561077
22081,dougtweedy,1,0.00006,391013,25.04764,1561077
22082,DouShaoxun,1,0.00006,391014,25.04771,1561077
22083,downfall109,1,0.00006,391015,25.04777,1561077
22084,dp80,1,0.00006,391016,25.04784,1561077
22085,dpaladhi,1,0.00006,391017,25.04790,1561077
22086,dpalomin,1,0.00006,391018,25.04796,1561077
22087,d-panas,1,0.00006,391019,25.04803,1561077
22088,dparker18,1,0.00006,391020,25.04809,1561077
22089,dparrish,1,0.00006,391021,25.04816,1561077
22090,dpateltech,1,0.00006,391022,25.04822,1561077
22091,dpb1,1,0.00006,391023,25.04828,1561077
22092,DPD-30,1,0.00006,391024,25.04835,1561077
22093,dperezroCT,1,0.00006,391025,25.04841,1561077
22094,dpetzel,1,0.00006,391026,25.04848,1561077
22095,dpkshetty,1,0.00006,391027,25.04854,1561077
22096,dpn982,1,0.00006,391028,25.04860,1561077
22097,dprangnell,1,0.00006,391029,25.04867,1561077
22098,dpreilan,1,0.00006,391030,25.04873,1561077
22099,Dpun,1,0.00006,391031,25.04880,1561077
22100,dracoyang802,1,0.00006,391032,25.04886,1561077
22101,dragomirtodorov,1,0.00006,391033,25.04892,1561077
22102,dragonpiper,1,0.00006,391034,25.04899,1561077
22103,drahcirD,1,0.00006,391035,25.04905,1561077
22104,Drakojin,1,0.00006,391036,25.04912,1561077
22105,DranonJoD,1,0.00006,391037,25.04918,1561077
22106,dratcliff,1,0.00006,391038,25.04924,1561077
22107,draugz,1,0.00006,391039,25.04931,1561077
22108,drautureau-sonarsource,1,0.00006,391040,25.04937,1561077
22109,dravos,1,0.00006,391041,25.04944,1561077
22110,dreadk2002,1,0.00006,391042,25.04950,1561077
22111,dreadknot,1,0.00006,391043,25.04957,1561077
22112,dreadwarrior,1,0.00006,391044,25.04963,1561077
22113,dream960727,1,0.00006,391045,25.04969,1561077
22114,Dream-Z,1,0.00006,391046,25.04976,1561077
22115,dremur,1,0.00006,391047,25.04982,1561077
22116,dreps350,1,0.00006,391048,25.04989,1561077
22117,drewherbst,1,0.00006,391049,25.04995,1561077
22118,drewrothstein,1,0.00006,391050,25.05001,1561077
22119,drewverlee,1,0.00006,391051,25.05008,1561077
22120,drexlert,1,0.00006,391052,25.05014,1561077
22121,drgarcia1986,1,0.00006,391053,25.05021,1561077
22122,DricomDragon,1,0.00006,391054,25.05027,1561077
22123,drimailorr,1,0.00006,391055,25.05033,1561077
22124,driouxg,1,0.00006,391056,25.05040,1561077
22125,drishti2497,1,0.00006,391057,25.05046,1561077
22126,drissamri,1,0.00006,391058,25.05053,1561077
22127,driv3r,1,0.00006,391059,25.05059,1561077
22128,drkunibar,1,0.00006,391060,25.05065,1561077
22129,DrMarkDunne,1,0.00006,391061,25.05072,1561077
22130,drndos,1,0.00006,391062,25.05078,1561077
22131,dron4ik86,1,0.00006,391063,25.05085,1561077
22132,dropPangolin,1,0.00006,391064,25.05091,1561077
22133,drspockbr,1,0.00006,391065,25.05097,1561077
22134,druss17,1,0.00006,391066,25.05104,1561077
22135,drvy,1,0.00006,391067,25.05110,1561077
22136,drwestt,1,0.00006,391068,25.05117,1561077
22137,dry923,1,0.00006,391069,25.05123,1561077
22138,dsanders23,1,0.00006,391070,25.05129,1561077
22139,dsariel,1,0.00006,391071,25.05136,1561077
22140,dscaravaggi,1,0.00006,391072,25.05142,1561077
22141,dschiller,1,0.00006,391073,25.05149,1561077
22142,dschnabel,1,0.00006,391074,25.05155,1561077
22143,dschu012,1,0.00006,391075,25.05162,1561077
22144,dscunkel,1,0.00006,391076,25.05168,1561077
22145,dsGCloud,1,0.00006,391077,25.05174,1561077
22146,dsgnr,1,0.00006,391078,25.05181,1561077
22147,dshamanthreddy,1,0.00006,391079,25.05187,1561077
22148,dsharma1310,1,0.00006,391080,25.05194,1561077
22149,dsielert,1,0.00006,391081,25.05200,1561077
22150,dsinang,1,0.00006,391082,25.05206,1561077
22151,dsiragusa,1,0.00006,391083,25.05213,1561077
22152,dsklyut,1,0.00006,391084,25.05219,1561077
22153,dslavets,1,0.00006,391085,25.05226,1561077
22154,dsolonenko,1,0.00006,391086,25.05232,1561077
22155,dsoudakov,1,0.00006,391087,25.05238,1561077
22156,dstainer,1,0.00006,391088,25.05245,1561077
22157,dstd,1,0.00006,391089,25.05251,1561077
22158,dsteinmo,1,0.00006,391090,25.05258,1561077
22159,dstraub,1,0.00006,391091,25.05264,1561077
22160,dtd379,1,0.00006,391092,25.05270,1561077
22161,DThrasher,1,0.00006,391093,25.05277,1561077
22162,dtkachenko,1,0.00006,391094,25.05283,1561077
22163,dtmland,1,0.00006,391095,25.05290,1561077
22164,DtpEJsaYXDU4GDH8dE4MyI9VrieF0UZpPZ0K76K,1,0.00006,391096,25.05296,1561077
22165,Dtsr,1,0.00006,391097,25.05302,1561077
22166,Duam,1,0.00006,391098,25.05309,1561077
22167,DuanYuePeng,1,0.00006,391099,25.05315,1561077
22168,duanyutong,1,0.00006,391100,25.05322,1561077
22169,duchuyctlk,1,0.00006,391101,25.05328,1561077
22170,duckpuppy,1,0.00006,391102,25.05334,1561077
22171,dud225,1,0.00006,391103,25.05341,1561077
22172,dudaco,1,0.00006,391104,25.05347,1561077
22173,dudaerich,1,0.00006,391105,25.05354,1561077
22174,dudicoco,1,0.00006,391106,25.05360,1561077
22175,dudil,1,0.00006,391107,25.05366,1561077
22176,duffsdev,1,0.00006,391108,25.05373,1561077
22177,duhanebel,1,0.00006,391109,25.05379,1561077
22178,duhuangwen,1,0.00006,391110,25.05386,1561077
22179,Dukecz,1,0.00006,391111,25.05392,1561077
22180,DukeHarris,1,0.00006,391112,25.05399,1561077
22181,dummy-amit,1,0.00006,391113,25.05405,1561077
22182,duncanhkc,1,0.00006,391114,25.05411,1561077
22183,dunespice,1,0.00006,391115,25.05418,1561077
22184,dungnt081191,1,0.00006,391116,25.05424,1561077
22185,dunhanson,1,0.00006,391117,25.05431,1561077
22186,dupatvj,1,0.00006,391118,25.05437,1561077
22187,duraki,1,0.00006,391119,25.05443,1561077
22188,durandx,1,0.00006,391120,25.05450,1561077
22189,durgasatyanarayana,1,0.00006,391121,25.05456,1561077
22190,durgesh7503,1,0.00006,391122,25.05463,1561077
22191,Duskol,1,0.00006,391123,25.05469,1561077
22192,dvankampen,1,0.00006,391124,25.05475,1561077
22193,DVassilev,1,0.00006,391125,25.05482,1561077
22194,dvdlevanon-sgh,1,0.00006,391126,25.05488,1561077
22195,dvdred,1,0.00006,391127,25.05495,1561077
22196,dvehar,1,0.00006,391128,25.05501,1561077
22197,dventurino,1,0.00006,391129,25.05507,1561077
22198,dvetto,1,0.00006,391130,25.05514,1561077
22199,dvicente72,1,0.00006,391131,25.05520,1561077
22200,dv-morais,1,0.00006,391132,25.05527,1561077
22201,dvsingh9,1,0.00006,391133,25.05533,1561077
22202,Dwaraka8,1,0.00006,391134,25.05539,1561077
22203,dwbruhn,1,0.00006,391135,25.05546,1561077
22204,dweggemans,1,0.00006,391136,25.05552,1561077
22205,dwells-ancoris,1,0.00006,391137,25.05559,1561077
22206,dwightford,1,0.00006,391138,25.05565,1561077
22207,dwijtsma,1,0.00006,391139,25.05571,1561077
22208,dwizzle204,1,0.00006,391140,25.05578,1561077
22209,dws,1,0.00006,391141,25.05584,1561077
22210,DXCPivotalSupport,1,0.00006,391142,25.05591,1561077
22211,DXTimer,1,0.00006,391143,25.05597,1561077
22212,dybran,1,0.00006,391144,25.05604,1561077
22213,dylanmaassen,1,0.00006,391145,25.05610,1561077
22214,dylanplecki,1,0.00006,391146,25.05616,1561077
22215,dylan-underwood,1,0.00006,391147,25.05623,1561077
22216,dylex,1,0.00006,391148,25.05629,1561077
22217,dyroffk,1,0.00006,391149,25.05636,1561077
22218,dyutis,1,0.00006,391150,25.05642,1561077
22219,dzawrotny,1,0.00006,391151,25.05648,1561077
22220,dzmitry-kankalovich,1,0.00006,391152,25.05655,1561077
22221,dzmitry-rudnouski,1,0.00006,391153,25.05661,1561077
22222,dzschille,1,0.00006,391154,25.05668,1561077
22223,dzsodzso63,1,0.00006,391155,25.05674,1561077
22224,e0003315,1,0.00006,391156,25.05680,1561077
22225,e36422,1,0.00006,391157,25.05687,1561077
22226,eabern2,1,0.00006,391158,25.05693,1561077
22227,eacdy,1,0.00006,391159,25.05700,1561077
22228,eagle79,1,0.00006,391160,25.05706,1561077
22229,eaibmz,1,0.00006,391161,25.05712,1561077
22230,ealbertoav,1,0.00006,391162,25.05719,1561077
22231,EamonZhang,1,0.00006,391163,25.05725,1561077
22232,EArbeitman,1,0.00006,391164,25.05732,1561077
22233,ear-dev,1,0.00006,391165,25.05738,1561077
22234,eastwd,1,0.00006,391166,25.05744,1561077
22235,easylite376,1,0.00006,391167,25.05751,1561077
22236,eaydogan,1,0.00006,391168,25.05757,1561077
22237,eazy-g,1,0.00006,391169,25.05764,1561077
22238,ebadilla10,1,0.00006,391170,25.05770,1561077
22239,ebarrera1211,1,0.00006,391171,25.05776,1561077
22240,ebenezarisaac,1,0.00006,391172,25.05783,1561077
22241,EbenZhang,1,0.00006,391173,25.05789,1561077
22242,eBeyond,1,0.00006,391174,25.05796,1561077
22243,ebickle,1,0.00006,391175,25.05802,1561077
22244,ebmmy,1,0.00006,391176,25.05808,1561077
22245,eborgbjerg,1,0.00006,391177,25.05815,1561077
22246,ebrentjones,1,0.00006,391178,25.05821,1561077
22247,ebutler-allies,1,0.00006,391179,25.05828,1561077
22248,ecavinat,1,0.00006,391180,25.05834,1561077
22249,Eccenux,1,0.00006,391181,25.05841,1561077
22250,eccox,1,0.00006,391182,25.05847,1561077
22251,echho34,1,0.00006,391183,25.05853,1561077
22252,echoleyo,1,0.00006,391184,25.05860,1561077
22253,eciancio,1,0.00006,391185,25.05866,1561077
22254,ecingel-mitek,1,0.00006,391186,25.05873,1561077
22255,eciramella,1,0.00006,391187,25.05879,1561077
22256,eciramella-r7,1,0.00006,391188,25.05885,1561077
22257,eclansky,1,0.00006,391189,25.05892,1561077
22258,ecmagalhaes,1,0.00006,391190,25.05898,1561077
22259,ecout,1,0.00006,391191,25.05905,1561077
22260,eczeek,1,0.00006,391192,25.05911,1561077
22261,edblackburn,1,0.00006,391193,25.05917,1561077
22262,eddiriarte,1,0.00006,391194,25.05924,1561077
22263,eDeviser,1,0.00006,391195,25.05930,1561077
22264,edgan,1,0.00006,391196,25.05937,1561077
22265,EdgarGuerreroObando,1,0.00006,391197,25.05943,1561077
22266,edgarklerks,1,0.00006,391198,25.05949,1561077
22267,EdgarsAvotins,1,0.00006,391199,25.05956,1561077
22268,edgecode,1,0.00006,391200,25.05962,1561077
22269,edgenetkube,1,0.00006,391201,25.05969,1561077
22270,edhar-k,1,0.00006,391202,25.05975,1561077
22271,EdHurtig,1,0.00006,391203,25.05981,1561077
22272,edinc,1,0.00006,391204,25.05988,1561077
22273,EdisonSu768,1,0.00006,391205,25.05994,1561077
22274,ediweissmann,1,0.00006,391206,25.06001,1561077
22275,edmarmb,1,0.00006,391207,25.06007,1561077
22276,edmeme,1,0.00006,391208,25.06013,1561077
22277,edmooneysh,1,0.00006,391209,25.06020,1561077
22278,edouardb,1,0.00006,391210,25.06026,1561077
22279,EdSalisbury,1,0.00006,391211,25.06033,1561077
22280,eduaranega,1,0.00006,391212,25.06039,1561077
22281,eduardo-banuelos-by,1,0.00006,391213,25.06046,1561077
22282,eduardorn,1,0.00006,391214,25.06052,1561077
22283,edubacco,1,0.00006,391215,25.06058,1561077
22284,edubois10,1,0.00006,391216,25.06065,1561077
22285,edumco,1,0.00006,391217,25.06071,1561077
22286,edumgui,1,0.00006,391218,25.06078,1561077
22287,edupo,1,0.00006,391219,25.06084,1561077
22288,edwardmeshuris,1,0.00006,391220,25.06090,1561077
22289,Edwardskor,1,0.00006,391221,25.06097,1561077
22290,EdwardSokolovsky,1,0.00006,391222,25.06103,1561077
22291,EdwardW2,1,0.00006,391223,25.06110,1561077
22292,edwardwe7,1,0.00006,391224,25.06116,1561077
22293,EdwinPhilip,1,0.00006,391225,25.06122,1561077
22294,Edwin-van-der-Klaauw,1,0.00006,391226,25.06129,1561077
22295,eestolano,1,0.00006,391227,25.06135,1561077
22296,efeat,1,0.00006,391228,25.06142,1561077
22297,efenglu,1,0.00006,391229,25.06148,1561077
22298,effectivecui,1,0.00006,391230,25.06154,1561077
22299,efficks,1,0.00006,391231,25.06161,1561077
22300,efg770,1,0.00006,391232,25.06167,1561077
22301,efim-a-efim,1,0.00006,391233,25.06174,1561077
22302,eflamoe,1,0.00006,391234,25.06180,1561077
22303,efontana,1,0.00006,391235,25.06186,1561077
22304,efpato,1,0.00006,391236,25.06193,1561077
22305,efrangul,1,0.00006,391237,25.06199,1561077
22306,egarkavy,1,0.00006,391238,25.06206,1561077
22307,egaudet-casa,1,0.00006,391239,25.06212,1561077
22308,egbertzeng,1,0.00006,391240,25.06218,1561077
22309,egeerardyn,1,0.00006,391241,25.06225,1561077
22310,eggsy84,1,0.00006,391242,25.06231,1561077
22311,egomez99,1,0.00006,391243,25.06238,1561077
22312,egoncearuc,1,0.00006,391244,25.06244,1561077
22313,egormasalitin,1,0.00006,391245,25.06250,1561077
22314,ehab180hb,1,0.00006,391246,25.06257,1561077
22315,EhsanMirzaei,1,0.00006,391247,25.06263,1561077
22316,eht16,1,0.00006,391248,25.06270,1561077
22317,eiapopeia,1,0.00006,391249,25.06276,1561077
22318,eikermann,1,0.00006,391250,25.06283,1561077
22319,eikkaj,1,0.00006,391251,25.06289,1561077
22320,einarf,1,0.00006,391252,25.06295,1561077
22321,eirriel,1,0.00006,391253,25.06302,1561077
22322,eis,1,0.00006,391254,25.06308,1561077
22323,eisjcormier,1,0.00006,391255,25.06315,1561077
22324,EitanBe,1,0.00006,391256,25.06321,1561077
22325,eivindlm,1,0.00006,391257,25.06327,1561077
22326,ejohansson,1,0.00006,391258,25.06334,1561077
22327,ekalin,1,0.00006,391259,25.06340,1561077
22328,EkardNT,1,0.00006,391260,25.06347,1561077
22329,ekayserili,1,0.00006,391261,25.06353,1561077
22330,EkiGui,1,0.00006,391262,25.06359,1561077
22331,ekimia,1,0.00006,391263,25.06366,1561077
22332,ekkaphoom,1,0.00006,391264,25.06372,1561077
22333,ektavaswani,1,0.00006,391265,25.06379,1561077
22334,ekurer,1,0.00006,391266,25.06385,1561077
22335,elad-via,1,0.00006,391267,25.06391,1561077
22336,eLafo,1,0.00006,391268,25.06398,1561077
22337,elainewu03,1,0.00006,391269,25.06404,1561077
22338,elamre,1,0.00006,391270,25.06411,1561077
22339,elarrarte,1,0.00006,391271,25.06417,1561077
22340,elazo89,1,0.00006,391272,25.06423,1561077
22341,ELBNSty,1,0.00006,391273,25.06430,1561077
22342,elchtestAtBosch,1,0.00006,391274,25.06436,1561077
22343,elcolto,1,0.00006,391275,25.06443,1561077
22344,eldarc,1,0.00006,391276,25.06449,1561077
22345,eldavido,1,0.00006,391277,25.06455,1561077
22346,eldermoraes,1,0.00006,391278,25.06462,1561077
22347,Elderry,1,0.00006,391279,25.06468,1561077
22348,eldoranstars,1,0.00006,391280,25.06475,1561077
22349,electricmime,1,0.00006,391281,25.06481,1561077
22350,elehuitouze,1,0.00006,391282,25.06488,1561077
22351,ElenaForester,1,0.00006,391283,25.06494,1561077
22352,elfotografo007,1,0.00006,391284,25.06500,1561077
22353,eliassal,1,0.00006,391285,25.06507,1561077
22354,eliaumiller,1,0.00006,391286,25.06513,1561077
22355,ElibarikiJ,1,0.00006,391287,25.06520,1561077
22356,elibroftw,1,0.00006,391288,25.06526,1561077
22357,elico,1,0.00006,391289,25.06532,1561077
22358,EliFinkelshteyn,1,0.00006,391290,25.06539,1561077
22359,Elijah158,1,0.00006,391291,25.06545,1561077
22360,elingg,1,0.00006,391292,25.06552,1561077
22361,eliorm32,1,0.00006,391293,25.06558,1561077
22362,eliran-hackeru,1,0.00006,391294,25.06564,1561077
22363,elizabethwait,1,0.00006,391295,25.06571,1561077
22364,elizazhang,1,0.00006,391296,25.06577,1561077
22365,elizehavi,1,0.00006,391297,25.06584,1561077
22366,eljabberino,1,0.00006,391298,25.06590,1561077
22367,eljenso,1,0.00006,391299,25.06596,1561077
22368,eljo,1,0.00006,391300,25.06603,1561077
22369,elleninnit,1,0.00006,391301,25.06609,1561077
22370,ElleonorK,1,0.00006,391302,25.06616,1561077
22371,elloty,1,0.00006,391303,25.06622,1561077
22372,Ellpeck,1,0.00006,391304,25.06628,1561077
22373,elluvium,1,0.00006,391305,25.06635,1561077
22374,elmanoneto,1,0.00006,391306,25.06641,1561077
22375,Eloo,1,0.00006,391307,25.06648,1561077
22376,el-psycho,1,0.00006,391308,25.06654,1561077
22377,elrondwong,1,0.00006,391309,25.06660,1561077
22378,eltoru,1,0.00006,391310,25.06667,1561077
22379,elvinlucero,1,0.00006,391311,25.06673,1561077
22380,Elwin00,1,0.00006,391312,25.06680,1561077
22381,elwood218,1,0.00006,391313,25.06686,1561077
22382,elzenar,1,0.00006,391314,25.06692,1561077
22383,emangual,1,0.00006,391315,25.06699,1561077
22384,embee1981,1,0.00006,391316,25.06705,1561077
22385,emborg,1,0.00006,391317,25.06712,1561077
22386,emc2,1,0.00006,391318,25.06718,1561077
22387,emchobg,1,0.00006,391319,25.06725,1561077
22388,emerout,1,0.00006,391320,25.06731,1561077
22389,emerssso,1,0.00006,391321,25.06737,1561077
22390,eMerzh,1,0.00006,391322,25.06744,1561077
22391,emilegg,1,0.00006,391323,25.06750,1561077
22392,emilianofs,1,0.00006,391324,25.06757,1561077
22393,emilkostadinov,1,0.00006,391325,25.06763,1561077
22394,emilybache,1,0.00006,391326,25.06769,1561077
22395,eminmugla09,1,0.00006,391327,25.06776,1561077
22396,em-jones,1,0.00006,391328,25.06782,1561077
22397,emkidwell,1,0.00006,391329,25.06789,1561077
22398,Emma-Black,1,0.00006,391330,25.06795,1561077
22399,Emmilong1,1,0.00006,391331,25.06801,1561077
22400,Emmy-github-webdev,1,0.00006,391332,25.06808,1561077
22401,emnioj,1,0.00006,391333,25.06814,1561077
22402,emopti-jrufer,1,0.00006,391334,25.06821,1561077
22403,empyrean987,1,0.00006,391335,25.06827,1561077
22404,emreakcan,1,0.00006,391336,25.06833,1561077
22405,emu42,1,0.00006,391337,25.06840,1561077
22406,emyes,1,0.00006,391338,25.06846,1561077
22407,enachi,1,0.00006,391339,25.06853,1561077
22408,enaess,1,0.00006,391340,25.06859,1561077
22409,enaserianhanzaei,1,0.00006,391341,25.06865,1561077
22410,eNBeWe,1,0.00006,391342,25.06872,1561077
22411,encodeering,1,0.00006,391343,25.06878,1561077
22412,endakelly,1,0.00006,391344,25.06885,1561077
22413,Endareth,1,0.00006,391345,25.06891,1561077
22414,endowzoner,1,0.00006,391346,25.06897,1561077
22415,Enere,1,0.00006,391347,25.06904,1561077
22416,eneslanpir,1,0.00006,391348,25.06910,1561077
22417,engineforce,1,0.00006,391349,25.06917,1561077
22418,engRick18,1,0.00006,391350,25.06923,1561077
22419,EniariGames,1,0.00006,391351,25.06930,1561077
22420,Enigmaderockz,1,0.00006,391352,25.06936,1561077
22421,enndubyu,1,0.00006,391353,25.06942,1561077
22422,EnolMG,1,0.00006,391354,25.06949,1561077
22423,ensofter,1,0.00006,391355,25.06955,1561077
22424,Entea,1,0.00006,391356,25.06962,1561077
22425,entfrickler,1,0.00006,391357,25.06968,1561077
22426,Entreco,1,0.00006,391358,25.06974,1561077
22427,entuland,1,0.00006,391359,25.06981,1561077
22428,enummela,1,0.00006,391360,25.06987,1561077
22429,enutrofff,1,0.00006,391361,25.06994,1561077
22430,enyone,1,0.00006,391362,25.07000,1561077
22431,enzo-dechaene,1,0.00006,391363,25.07006,1561077
22432,enzonet13,1,0.00006,391364,25.07013,1561077
22433,eoghanino,1,0.00006,391365,25.07019,1561077
22434,eoinbyr,1,0.00006,391366,25.07026,1561077
22435,eoin-oconghaile,1,0.00006,391367,25.07032,1561077
22436,eoinverling,1,0.00006,391368,25.07038,1561077
22437,eoneoff,1,0.00006,391369,25.07045,1561077
22438,eonezhang,1,0.00006,391370,25.07051,1561077
22439,epage,1,0.00006,391371,25.07058,1561077
22440,epic9x,1,0.00006,391372,25.07064,1561077
22441,epike,1,0.00006,391373,25.07070,1561077
22442,epileptic-fish,1,0.00006,391374,25.07077,1561077
22443,epkabeg,1,0.00006,391375,25.07083,1561077
22444,epmccormick,1,0.00006,391376,25.07090,1561077
22445,eprats,1,0.00006,391377,25.07096,1561077
22446,epuertat,1,0.00006,391378,25.07102,1561077
22447,EQuincerot,1,0.00006,391379,25.07109,1561077
22448,eran-,1,0.00006,391380,25.07115,1561077
22449,eranshapira,1,0.00006,391381,25.07122,1561077
22450,erarunkumar,1,0.00006,391382,25.07128,1561077
22451,erasmolpa,1,0.00006,391383,25.07134,1561077
22452,erasmussen39,1,0.00006,391384,25.07141,1561077
22453,ercanales,1,0.00006,391385,25.07147,1561077
22454,ercanertan,1,0.00006,391386,25.07154,1561077
22455,ercliou,1,0.00006,391387,25.07160,1561077
22456,erdelyizsolt,1,0.00006,391388,25.07167,1561077
22457,erdoganonur,1,0.00006,391389,25.07173,1561077
22458,erebel55,1,0.00006,391390,25.07179,1561077
22459,ErenKizilay,1,0.00006,391391,25.07186,1561077
22460,erez-dome9,1,0.00006,391392,25.07192,1561077
22461,erezgilron,1,0.00006,391393,25.07199,1561077
22462,erezlotan,1,0.00006,391394,25.07205,1561077
22463,erfanahmed1990,1,0.00006,391395,25.07211,1561077
22464,erginipekci7,1,0.00006,391396,25.07218,1561077
22465,eric79,1,0.00006,391397,25.07224,1561077
22466,ericbrumfield,1,0.00006,391398,25.07231,1561077
22467,EricDales,1,0.00006,391399,25.07237,1561077
22468,ericdriggs,1,0.00006,391400,25.07243,1561077
22469,ericfaure007,1,0.00006,391401,25.07250,1561077
22470,ericfunktxgroup,1,0.00006,391402,25.07256,1561077
22471,eric-gagnon,1,0.00006,391403,25.07263,1561077
22472,ericgrysko,1,0.00006,391404,25.07269,1561077
22473,erichelgeson,1,0.00006,391405,25.07275,1561077
22474,eric-huang2,1,0.00006,391406,25.07282,1561077
22475,ericklindemannetcom,1,0.00006,391407,25.07288,1561077
22476,EricKnecht,1,0.00006,391408,25.07295,1561077
22477,erickortemaxar,1,0.00006,391409,25.07301,1561077
22478,ericLemanissier,1,0.00006,391410,25.07307,1561077
22479,ericn-clover,1,0.00006,391411,25.07314,1561077
22480,ericndunn,1,0.00006,391412,25.07320,1561077
22481,EricRabil,1,0.00006,391413,25.07327,1561077
22482,EricRibeiro,1,0.00006,391414,25.07333,1561077
22483,Ericson2314,1,0.00006,391415,25.07339,1561077
22484,erictsai53,1,0.00006,391416,25.07346,1561077
22485,ericweikl,1,0.00006,391417,25.07352,1561077
22486,ericwengelking,1,0.00006,391418,25.07359,1561077
22487,ericworkandco,1,0.00006,391419,25.07365,1561077
22488,EricXiao,1,0.00006,391420,25.07372,1561077
22489,erikjohnston,1,0.00006,391421,25.07378,1561077
22490,erikpaulmiller,1,0.00006,391422,25.07384,1561077
22491,erikpb,1,0.00006,391423,25.07391,1561077
22492,erikthorselius,1,0.00006,391424,25.07397,1561077
22493,erinz,1,0.00006,391425,25.07404,1561077
22494,eriweb,1,0.00006,391426,25.07410,1561077
22495,erkalicious,1,0.00006,391427,25.07416,1561077
22496,erkerb4,1,0.00006,391428,25.07423,1561077
22497,erkkpankaj,1,0.00006,391429,25.07429,1561077
22498,erlendvollset,1,0.00006,391430,25.07436,1561077
22499,erloumiguel,1,0.00006,391431,25.07442,1561077
22500,ernado,1,0.00006,391432,25.07448,1561077
22501,erNail,1,0.00006,391433,25.07455,1561077
22502,ernestang98,1,0.00006,391434,25.07461,1561077
22503,ernitingarg09,1,0.00006,391435,25.07468,1561077
22504,ernsheong,1,0.00006,391436,25.07474,1561077
22505,erodriguez10,1,0.00006,391437,25.07480,1561077
22506,Er-rajsingh,1,0.00006,391438,25.07487,1561077
22507,errogaht,1,0.00006,391439,25.07493,1561077
22508,erselbst,1,0.00006,391440,25.07500,1561077
22509,ervikrant06,1,0.00006,391441,25.07506,1561077
22510,erwinwolff,1,0.00006,391442,25.07512,1561077
22511,es89247,1,0.00006,391443,25.07519,1561077
22512,esaborg,1,0.00006,391444,25.07525,1561077
22513,esafronova,1,0.00006,391445,25.07532,1561077
22514,esalberg,1,0.00006,391446,25.07538,1561077
22515,escapedcat,1,0.00006,391447,25.07544,1561077
22516,eschleining,1,0.00006,391448,25.07551,1561077
22517,escouvois,1,0.00006,391449,25.07557,1561077
22518,esevland,1,0.00006,391450,25.07564,1561077
22519,esevland-chwy,1,0.00006,391451,25.07570,1561077
22520,EshaBangar,1,0.00006,391452,25.07577,1561077
22521,esierrapena,1,0.00006,391453,25.07583,1561077
22522,esmiles,1,0.00006,391454,25.07589,1561077
22523,espinm2,1,0.00006,391455,25.07596,1561077
22524,esprehn,1,0.00006,391456,25.07602,1561077
22525,esramirez,1,0.00006,391457,25.07609,1561077
22526,esseti,1,0.00006,391458,25.07615,1561077
22527,estebanbouza,1,0.00006,391459,25.07621,1561077
22528,estebanporcelli,1,0.00006,391460,25.07628,1561077
22529,estein9825,1,0.00006,391461,25.07634,1561077
22530,estein-de,1,0.00006,391462,25.07641,1561077
22531,estelabalboa,1,0.00006,391463,25.07647,1561077
22532,estelop,1,0.00006,391464,25.07653,1561077
22533,esterkin,1,0.00006,391465,25.07660,1561077
22534,esutton,1,0.00006,391466,25.07666,1561077
22535,eswets,1,0.00006,391467,25.07673,1561077
22536,etashsingh,1,0.00006,391468,25.07679,1561077
22537,eternam2,1,0.00006,391469,25.07685,1561077
22538,ethanis,1,0.00006,391470,25.07692,1561077
22539,ethanpilot,1,0.00006,391471,25.07698,1561077
22540,ethansommer,1,0.00006,391472,25.07705,1561077
22541,EthanZillinger,1,0.00006,391473,25.07711,1561077
22542,ethemcemozkan,1,0.00006,391474,25.07717,1561077
22543,ethteck,1,0.00006,391475,25.07724,1561077
22544,etiaxie,1,0.00006,391476,25.07730,1561077
22545,EtizazKhan,1,0.00006,391477,25.07737,1561077
22546,etSingh,1,0.00006,391478,25.07743,1561077
22547,eugeneievlev,1,0.00006,391479,25.07749,1561077
22548,eugenekainara,1,0.00006,391480,25.07756,1561077
22549,EugeneLugovtsov,1,0.00006,391481,25.07762,1561077
22550,eugenesenchenko,1,0.00006,391482,25.07769,1561077
22551,EulogySnowfall,1,0.00006,391483,25.07775,1561077
22552,eunikolsky,1,0.00006,391484,25.07781,1561077
22553,euprogramador,1,0.00006,391485,25.07788,1561077
22554,euthuppan,1,0.00006,391486,25.07794,1561077
22555,evagonz,1,0.00006,391487,25.07801,1561077
22556,evberrypi,1,0.00006,391488,25.07807,1561077
22557,evemarvin,1,0.00006,391489,25.07814,1561077
22558,Evengard,1,0.00006,391490,25.07820,1561077
22559,evenme,1,0.00006,391491,25.07826,1561077
22560,EverardoCamacho,1,0.00006,391492,25.07833,1561077
22561,Evertras,1,0.00006,391493,25.07839,1561077
22562,evfurman,1,0.00006,391494,25.07846,1561077
22563,evgenia-semenova,1,0.00006,391495,25.07852,1561077
22564,evgeniyQAA,1,0.00006,391496,25.07858,1561077
22565,evgenynacu,1,0.00006,391497,25.07865,1561077
22566,evgeny-sem,1,0.00006,391498,25.07871,1561077
22567,evilop,1,0.00006,391499,25.07878,1561077
22568,evinel,1,0.00006,391500,25.07884,1561077
22569,evisar,1,0.00006,391501,25.07890,1561077
22570,evisdrenova,1,0.00006,391502,25.07897,1561077
22571,Evyatar-WM,1,0.00006,391503,25.07903,1561077
22572,evyros,1,0.00006,391504,25.07910,1561077
22573,ewasos,1,0.00006,391505,25.07916,1561077
22574,ewhauser,1,0.00006,391506,25.07922,1561077
22575,Ewynne,1,0.00006,391507,25.07929,1561077
22576,ewypych,1,0.00006,391508,25.07935,1561077
22577,ex3me0,1,0.00006,391509,25.07942,1561077
22578,exabrial,1,0.00006,391510,25.07948,1561077
22579,exawon,1,0.00006,391511,25.07954,1561077
22580,ExBleaK,1,0.00006,391512,25.07961,1561077
22581,exmatrikulator,1,0.00006,391513,25.07967,1561077
22582,expeepit,1,0.00006,391514,25.07974,1561077
22583,eXpire163,1,0.00006,391515,25.07980,1561077
22584,Ext3h,1,0.00006,391516,25.07986,1561077
22585,eXtenZy,1,0.00006,391517,25.07993,1561077
22586,externl,1,0.00006,391518,25.07999,1561077
22587,ext-johan-eriksson-king,1,0.00006,391519,25.08006,1561077
22588,Extracreative,1,0.00006,391520,25.08012,1561077
22589,EyadA,1,0.00006,391521,25.08019,1561077
22590,eyal0,1,0.00006,391522,25.08025,1561077
22591,eyal919,1,0.00006,391523,25.08031,1561077
22592,eyalg1972,1,0.00006,391524,25.08038,1561077
22593,eyalperlm,1,0.00006,391525,25.08044,1561077
22594,eyalzf,1,0.00006,391526,25.08051,1561077
22595,EyalZilberblum,1,0.00006,391527,25.08057,1561077
22596,eyphka,1,0.00006,391528,25.08063,1561077
22597,EyuelMathewos,1,0.00006,391529,25.08070,1561077
22598,ezeokami,1,0.00006,391530,25.08076,1561077
22599,ezequiels,1,0.00006,391531,25.08083,1561077
22600,e-zhang,1,0.00006,391532,25.08089,1561077
22601,EZtheOG,1,0.00006,391533,25.08095,1561077
22602,f0zz,1,0.00006,391534,25.08102,1561077
22603,f1mishutka,1,0.00006,391535,25.08108,1561077
22604,f1nger,1,0.00006,391536,25.08115,1561077
22605,f2rozen541,1,0.00006,391537,25.08121,1561077
22606,F2X,1,0.00006,391538,25.08127,1561077
22607,f4184f,1,0.00006,391539,25.08134,1561077
22608,F43RY,1,0.00006,391540,25.08140,1561077
22609,fabianoamorim,1,0.00006,391541,25.08147,1561077
22610,fabiants,1,0.00006,391542,25.08153,1561077
22611,FabianWilms,1,0.00006,391543,25.08159,1561077
22612,fabio-baia,1,0.00006,391544,25.08166,1561077
22613,fabricioferreira,1,0.00006,391545,25.08172,1561077
22614,fabytta,1,0.00006,391546,25.08179,1561077
22615,faceleg,1,0.00006,391547,25.08185,1561077
22616,faceless7171,1,0.00006,391548,25.08191,1561077
22617,facundovictor,1,0.00006,391549,25.08198,1561077
22618,facuparedes-litebox,1,0.00006,391550,25.08204,1561077
22619,faddat,1,0.00006,391551,25.08211,1561077
22620,fadzril,1,0.00006,391552,25.08217,1561077
22621,fahadhussain444,1,0.00006,391553,25.08223,1561077
22622,faheemjmi,1,0.00006,391554,25.08230,1561077
22623,faithlinpaul,1,0.00006,391555,25.08236,1561077
22624,faithlucid,1,0.00006,391556,25.08243,1561077
22625,faizan002,1,0.00006,391557,25.08249,1561077
22626,faizan2131993,1,0.00006,391558,25.08256,1561077
22627,fajpunk,1,0.00006,391559,25.08262,1561077
22628,falaksevak,1,0.00006,391560,25.08268,1561077
22629,fallenworld1,1,0.00006,391561,25.08275,1561077
22630,FallibleFlyer,1,0.00006,391562,25.08281,1561077
22631,faminepq,1,0.00006,391563,25.08288,1561077
22632,fanatl,1,0.00006,391564,25.08294,1561077
22633,fancyboynet,1,0.00006,391565,25.08300,1561077
22634,fangjianwei,1,0.00006,391566,25.08307,1561077
22635,fangyulong253711,1,0.00006,391567,25.08313,1561077
22636,fanlix,1,0.00006,391568,25.08320,1561077
22637,fannw,1,0.00006,391569,25.08326,1561077
22638,FaraSeer,1,0.00006,391570,25.08332,1561077
22639,farhadkzm,1,0.00006,391571,25.08339,1561077
22640,farhan-sauce,1,0.00006,391572,25.08345,1561077
22641,Farkya,1,0.00006,391573,25.08352,1561077
22642,farman022,1,0.00006,391574,25.08358,1561077
22643,farmboi,1,0.00006,391575,25.08364,1561077
22644,farrakh-saeed,1,0.00006,391576,25.08371,1561077
22645,farrisbar,1,0.00006,391577,25.08377,1561077
22646,fasolens,1,0.00006,391578,25.08384,1561077
22647,FastDev88,1,0.00006,391579,25.08390,1561077
22648,Fasten90,1,0.00006,391580,25.08396,1561077
22649,fastsieg,1,0.00006,391581,25.08403,1561077
22650,fatal-exception,1,0.00006,391582,25.08409,1561077
22651,fatganz,1,0.00006,391583,25.08416,1561077
22652,fatjyc,1,0.00006,391584,25.08422,1561077
22653,fatkun,1,0.00006,391585,25.08428,1561077
22654,fattouchsquall,1,0.00006,391586,25.08435,1561077
22655,fautpasycraindre,1,0.00006,391587,25.08441,1561077
22656,fauzan-n,1,0.00006,391588,25.08448,1561077
22657,favourjuwe,1,0.00006,391589,25.08454,1561077
22658,FayeGibbins,1,0.00006,391590,25.08461,1561077
22659,fazy,1,0.00006,391591,25.08467,1561077
22660,fbaiodias,1,0.00006,391592,25.08473,1561077
22661,fbauzac,1,0.00006,391593,25.08480,1561077
22662,fbeeper,1,0.00006,391594,25.08486,1561077
22663,FBNitro,1,0.00006,391595,25.08493,1561077
22664,fbucci1,1,0.00006,391596,25.08499,1561077
22665,fcalvez,1,0.00006,391597,25.08505,1561077
22666,FCamborda,1,0.00006,391598,25.08512,1561077
22667,fcampinho,1,0.00006,391599,25.08518,1561077
22668,fcano,1,0.00006,391600,25.08525,1561077
22669,fcatacut,1,0.00006,391601,25.08531,1561077
22670,FC-jan,1,0.00006,391602,25.08537,1561077
22671,fckbo,1,0.00006,391603,25.08544,1561077
22672,f-cramer,1,0.00006,391604,25.08550,1561077
22673,fdandavino-ubicquia,1,0.00006,391605,25.08557,1561077
22674,fdhub,1,0.00006,391606,25.08563,1561077
22675,fdolsky321,1,0.00006,391607,25.08569,1561077
22676,fdrueke,1,0.00006,391608,25.08576,1561077
22677,FdseLab,1,0.00006,391609,25.08582,1561077
22678,FDU-SE-LAB,1,0.00006,391610,25.08589,1561077
22679,fdx321,1,0.00006,391611,25.08595,1561077
22680,fe80,1,0.00006,391612,25.08601,1561077
22681,feanor777,1,0.00006,391613,25.08608,1561077
22682,FearlessHyena,1,0.00006,391614,25.08614,1561077
22683,fearnycompknowhow,1,0.00006,391615,25.08621,1561077
22684,febi881,1,0.00006,391616,25.08627,1561077
22685,fedefiorini,1,0.00006,391617,25.08633,1561077
22686,fedevegili,1,0.00006,391618,25.08640,1561077
22687,FeengQi,1,0.00006,391619,25.08646,1561077
22688,FelikZ,1,0.00006,391620,25.08653,1561077
22689,felimartina,1,0.00006,391621,25.08659,1561077
22690,felipebn,1,0.00006,391622,25.08665,1561077
22691,felipebz,1,0.00006,391623,25.08672,1561077
22692,felipeloha,1,0.00006,391624,25.08678,1561077
22693,feliperoos,1,0.00006,391625,25.08685,1561077
22694,felixk,1,0.00006,391626,25.08691,1561077
22695,FelixKelm,1,0.00006,391627,25.08698,1561077
22696,Felixoid,1,0.00006,391628,25.08704,1561077
22697,felixtran39,1,0.00006,391629,25.08710,1561077
22698,FellTarsier,1,0.00006,391630,25.08717,1561077
22699,felrib,1,0.00006,391631,25.08723,1561077
22700,felyppers,1,0.00006,391632,25.08730,1561077
22701,felzilber,1,0.00006,391633,25.08736,1561077
22702,fengguangke,1,0.00006,391634,25.08742,1561077
22703,feng-zh,1,0.00006,391635,25.08749,1561077
22704,fengzhou,1,0.00006,391636,25.08755,1561077
22705,Fenrikur,1,0.00006,391637,25.08762,1561077
22706,fenske,1,0.00006,391638,25.08768,1561077
22707,fenwk0,1,0.00006,391639,25.08774,1561077
22708,fen-x,1,0.00006,391640,25.08781,1561077
22709,feraudet,1,0.00006,391641,25.08787,1561077
22710,ferdef,1,0.00006,391642,25.08794,1561077
22711,fergie,1,0.00006,391643,25.08800,1561077
22712,fernandogarh,1,0.00006,391644,25.08806,1561077
22713,fernandokarnagi,1,0.00006,391645,25.08813,1561077
22714,fernandorubbo,1,0.00006,391646,25.08819,1561077
22715,fernando-silva,1,0.00006,391647,25.08826,1561077
22716,ferozsk409,1,0.00006,391648,25.08832,1561077
22717,ferrandinand,1,0.00006,391649,25.08838,1561077
22718,ferratello,1,0.00006,391650,25.08845,1561077
22719,fertroya,1,0.00006,391651,25.08851,1561077
22720,fetzerch,1,0.00006,391652,25.08858,1561077
22721,feuillemorte,1,0.00006,391653,25.08864,1561077
22722,ffangliu,1,0.00006,391654,25.08870,1561077
22723,ffazendeiro,1,0.00006,391655,25.08877,1561077
22724,ffougere,1,0.00006,391656,25.08883,1561077
22725,ffrizzo,1,0.00006,391657,25.08890,1561077
22726,fftorres,1,0.00006,391658,25.08896,1561077
22727,ffurrer2,1,0.00006,391659,25.08903,1561077
22728,fg123,1,0.00006,391660,25.08909,1561077
22729,fgendc,1,0.00006,391661,25.08915,1561077
22730,fgiust,1,0.00006,391662,25.08922,1561077
22731,fgsahoward,1,0.00006,391663,25.08928,1561077
22732,FGtatsuroWork,1,0.00006,391664,25.08935,1561077
22733,fhahn,1,0.00006,391665,25.08941,1561077
22734,fherbert,1,0.00006,391666,25.08947,1561077
22735,fhopf,1,0.00006,391667,25.08954,1561077
22736,fh-venkat,1,0.00006,391668,25.08960,1561077
22737,FibYar,1,0.00006,391669,25.08967,1561077
22738,fieldinrain,1,0.00006,391670,25.08973,1561077
22739,Fiesepille,1,0.00006,391671,25.08979,1561077
22740,figla12,1,0.00006,391672,25.08986,1561077
22741,fildaben,1,0.00006,391673,25.08992,1561077
22742,filfreire,1,0.00006,391674,25.08999,1561077
22743,filip-daca,1,0.00006,391675,25.09005,1561077
22744,filipecosta01,1,0.00006,391676,25.09011,1561077
22745,filipef9,1,0.00006,391677,25.09018,1561077
22746,filipjelev,1,0.00006,391678,25.09024,1561077
22747,filipowm,1,0.00006,391679,25.09031,1561077
22748,fin09pcap,1,0.00006,391680,25.09037,1561077
22749,finalman,1,0.00006,391681,25.09043,1561077
22750,finarfin,1,0.00006,391682,25.09050,1561077
22751,finchr,1,0.00006,391683,25.09056,1561077
22752,FineRedMist,1,0.00006,391684,25.09063,1561077
22753,finlaysawyer,1,0.00006,391685,25.09069,1561077
22754,fipp,1,0.00006,391686,25.09075,1561077
22755,fipsingdale,1,0.00006,391687,25.09082,1561077
22756,firebotQL,1,0.00006,391688,25.09088,1561077
22757,fireboy1919,1,0.00006,391689,25.09095,1561077
22758,FireBurn,1,0.00006,391690,25.09101,1561077
22759,fireflyhoo,1,0.00006,391691,25.09107,1561077
22760,firehooper,1,0.00006,391692,25.09114,1561077
22761,firephantomassasin,1,0.00006,391693,25.09120,1561077
22762,firsthour,1,0.00006,391694,25.09127,1561077
22763,FischerLGLN,1,0.00006,391695,25.09133,1561077
22764,fisgoneti,1,0.00006,391696,25.09140,1561077
22765,fishi0x01-gc,1,0.00006,391697,25.09146,1561077
22766,fishingfly,1,0.00006,391698,25.09152,1561077
22767,fishme,1,0.00006,391699,25.09159,1561077
22768,fitnesses,1,0.00006,391700,25.09165,1561077
22769,fivepapertigers,1,0.00006,391701,25.09172,1561077
22770,fjarenales,1,0.00006,391702,25.09178,1561077
22771,fjcrujeiras,1,0.00006,391703,25.09184,1561077
22772,fkawa-play,1,0.00006,391704,25.09191,1561077
22773,fkoebel-letsdev,1,0.00006,391705,25.09197,1561077
22774,fkpwolf,1,0.00006,391706,25.09204,1561077
22775,flagmanchris,1,0.00006,391707,25.09210,1561077
22776,flanagaj,1,0.00006,391708,25.09216,1561077
22777,FLasH3r,1,0.00006,391709,25.09223,1561077
22778,flaviocamilo,1,0.00006,391710,25.09229,1561077
22779,flaviodsr,1,0.00006,391711,25.09236,1561077
22780,flavius,1,0.00006,391712,25.09242,1561077
22781,flberger-work,1,0.00006,391713,25.09248,1561077
22782,flborn,1,0.00006,391714,25.09255,1561077
22783,flect-endo,1,0.00006,391715,25.09261,1561077
22784,flederwiesel,1,0.00006,391716,25.09268,1561077
22785,fleskesvor,1,0.00006,391717,25.09274,1561077
22786,flipnovidade,1,0.00006,391718,25.09280,1561077
22787,flocsy,1,0.00006,391719,25.09287,1561077
22788,floraachy,1,0.00006,391720,25.09293,1561077
22789,FlorentMetz,1,0.00006,391721,25.09300,1561077
22790,florentvaldelievre,1,0.00006,391722,25.09306,1561077
22791,FlorianBuchegger,1,0.00006,391723,25.09312,1561077
22792,floriankammermann,1,0.00006,391724,25.09319,1561077
22793,floriankick,1,0.00006,391725,25.09325,1561077
22794,FloriansGit,1,0.00006,391726,25.09332,1561077
22795,flostadler,1,0.00006,391727,25.09338,1561077
22796,flouis1,1,0.00006,391728,25.09345,1561077
22797,Floww,1,0.00006,391729,25.09351,1561077
22798,FlSc,1,0.00006,391730,25.09357,1561077
22799,fluffystalker,1,0.00006,391731,25.09364,1561077
22800,FluffyWeirdO,1,0.00006,391732,25.09370,1561077
22801,FlxPeters,1,0.00006,391733,25.09377,1561077
22802,fly2wind,1,0.00006,391734,25.09383,1561077
22803,FlyClover,1,0.00006,391735,25.09389,1561077
22804,Flyingmana,1,0.00006,391736,25.09396,1561077
22805,flymonkey00,1,0.00006,391737,25.09402,1561077
22806,flytocolors,1,0.00006,391738,25.09409,1561077
22807,flywin8,1,0.00006,391739,25.09415,1561077
22808,fm0195,1,0.00006,391740,25.09421,1561077
22809,fmaciask,1,0.00006,391741,25.09428,1561077
22810,fmazoyer,1,0.00006,391742,25.09434,1561077
22811,fmdaboville,1,0.00006,391743,25.09441,1561077
22812,fmehrdad,1,0.00006,391744,25.09447,1561077
22813,fmendezp,1,0.00006,391745,25.09453,1561077
22814,fmoezinia,1,0.00006,391746,25.09460,1561077
22815,fmorva,1,0.00006,391747,25.09466,1561077
22816,fmunozkantox,1,0.00006,391748,25.09473,1561077
22817,fnhchaiyin,1,0.00006,391749,25.09479,1561077
22818,fnichol,1,0.00006,391750,25.09485,1561077
22819,fnobilia,1,0.00006,391751,25.09492,1561077
22820,fo2rist,1,0.00006,391752,25.09498,1561077
22821,fo2w,1,0.00006,391753,25.09505,1561077
22822,foiseworth,1,0.00006,391754,25.09511,1561077
22823,foostan,1,0.00006,391755,25.09517,1561077
22824,foragerr,1,0.00006,391756,25.09524,1561077
22825,Forbzy,1,0.00006,391757,25.09530,1561077
22826,ForceConstant,1,0.00006,391758,25.09537,1561077
22827,fordagame,1,0.00006,391759,25.09543,1561077
22828,ford-matt-shine,1,0.00006,391760,25.09549,1561077
22829,forestfsl,1,0.00006,391761,25.09556,1561077
22830,foreverfaint,1,0.00006,391762,25.09562,1561077
22831,forhire,1,0.00006,391763,25.09569,1561077
22832,forluck2008,1,0.00006,391764,25.09575,1561077
22833,formerlyKurt,1,0.00006,391765,25.09582,1561077
22834,formero009,1,0.00006,391766,25.09588,1561077
22835,ForNeVeR,1,0.00006,391767,25.09594,1561077
22836,forrest79,1,0.00006,391768,25.09601,1561077
22837,forrestxm,1,0.00006,391769,25.09607,1561077
22838,forry,1,0.00006,391770,25.09614,1561077
22839,forsberg,1,0.00006,391771,25.09620,1561077
22840,FortifyStoryteller,1,0.00006,391772,25.09626,1561077
22841,fortunacio,1,0.00006,391773,25.09633,1561077
22842,foudelsalhi,1,0.00006,391774,25.09639,1561077
22843,foundatron,1,0.00006,391775,25.09646,1561077
22844,fourgates,1,0.00006,391776,25.09652,1561077
22845,fowlmouth,1,0.00006,391777,25.09658,1561077
22846,fox-md,1,0.00006,391778,25.09665,1561077
22847,fpelz,1,0.00006,391779,25.09671,1561077
22848,fpereyrap,1,0.00006,391780,25.09678,1561077
22849,fpga-tom,1,0.00006,391781,25.09684,1561077
22850,fpmosley,1,0.00006,391782,25.09690,1561077
22851,fpt-tuanta17,1,0.00006,391783,25.09697,1561077
22852,FQ400,1,0.00006,391784,25.09703,1561077
22853,fquinsol,1,0.00006,391785,25.09710,1561077
22854,fr0,1,0.00006,391786,25.09716,1561077
22855,fr4nkb3rt,1,0.00006,391787,25.09722,1561077
22856,fracarma,1,0.00006,391788,25.09729,1561077
22857,fragolinux,1,0.00006,391789,25.09735,1561077
22858,framegrace,1,0.00006,391790,25.09742,1561077
22859,FranAguiar,1,0.00006,391791,25.09748,1561077
22860,francisbolduc,1,0.00006,391792,25.09754,1561077
22861,franciscamunhoz,1,0.00006,391793,25.09761,1561077
22862,franck418,1,0.00006,391794,25.09767,1561077
22863,franck-fourel,1,0.00006,391795,25.09774,1561077
22864,FrancoCapraro,1,0.00006,391796,25.09780,1561077
22865,francoiscolombo,1,0.00006,391797,25.09787,1561077
22866,francoran,1,0.00006,391798,25.09793,1561077
22867,frandelgado,1,0.00006,391799,25.09799,1561077
22868,franeksaww,1,0.00006,391800,25.09806,1561077
22869,frank1iu,1,0.00006,391801,25.09812,1561077
22870,frank-aurich,1,0.00006,391802,25.09819,1561077
22871,frankbp,1,0.00006,391803,25.09825,1561077
22872,frankeddy-mrm,1,0.00006,391804,25.09831,1561077
22873,frankfarrell,1,0.00006,391805,25.09838,1561077
22874,FrankGNL,1,0.00006,391806,25.09844,1561077
22875,frankier,1,0.00006,391807,25.09851,1561077
22876,FrankMathis,1,0.00006,391808,25.09857,1561077
22877,frankonski,1,0.00006,391809,25.09863,1561077
22878,FrankReisenhofer,1,0.00006,391810,25.09870,1561077
22879,FrankZZ,1,0.00006,391811,25.09876,1561077
22880,franostanisicserato,1,0.00006,391812,25.09883,1561077
22881,franpilot,1,0.00006,391813,25.09889,1561077
22882,fransvanbuul,1,0.00006,391814,25.09895,1561077
22883,freafrea,1,0.00006,391815,25.09902,1561077
22884,freastro,1,0.00006,391816,25.09908,1561077
22885,Freddie-V4,1,0.00006,391817,25.09915,1561077
22886,freddy3004,1,0.00006,391818,25.09921,1561077
22887,FrederikCampagne,1,0.00006,391819,25.09927,1561077
22888,frederikd,1,0.00006,391820,25.09934,1561077
22889,fredkid123,1,0.00006,391821,25.09940,1561077
22890,fredkvogt,1,0.00006,391822,25.09947,1561077
22891,fredpalmer,1,0.00006,391823,25.09953,1561077
22892,FredRaw,1,0.00006,391824,25.09959,1561077
22893,fredrikbonander,1,0.00006,391825,25.09966,1561077
22894,Fredrik-Petersson,1,0.00006,391826,25.09972,1561077
22895,fredvalin,1,0.00006,391827,25.09979,1561077
22896,fredvogt,1,0.00006,391828,25.09985,1561077
22897,freedom0083,1,0.00006,391829,25.09991,1561077
22898,freeduck,1,0.00006,391830,25.09998,1561077
22899,freemwil,1,0.00006,391831,25.10004,1561077
22900,freeyoung,1,0.00006,391832,25.10011,1561077
22901,FreezB,1,0.00006,391833,25.10017,1561077
22902,Frejl,1,0.00006,391834,25.10024,1561077
22903,freme,1,0.00006,391835,25.10030,1561077
22904,f-renout,1,0.00006,391836,25.10036,1561077
22905,frenzymadness,1,0.00006,391837,25.10043,1561077
22906,freshollie,1,0.00006,391838,25.10049,1561077
22907,freshprinze,1,0.00006,391839,25.10056,1561077
22908,FreyLuis,1,0.00006,391840,25.10062,1561077
22909,FrigoCoder,1,0.00006,391841,25.10068,1561077
22910,fritaly,1,0.00006,391842,25.10075,1561077
22911,fr-kqkq,1,0.00006,391843,25.10081,1561077
22912,frluo,1,0.00006,391844,25.10088,1561077
22913,frodeanonsen,1,0.00006,391845,25.10094,1561077
22914,froismo,1,0.00006,391846,25.10100,1561077
22915,fromonesrc,1,0.00006,391847,25.10107,1561077
22916,frostmar,1,0.00006,391848,25.10113,1561077
22917,frostyslav,1,0.00006,391849,25.10120,1561077
22918,frozenfruits,1,0.00006,391850,25.10126,1561077
22919,frtelg,1,0.00006,391851,25.10132,1561077
22920,FrzMe,1,0.00006,391852,25.10139,1561077
22921,fsadykov,1,0.00006,391853,25.10145,1561077
22922,fsakget,1,0.00006,391854,25.10152,1561077
22923,fsamir,1,0.00006,391855,25.10158,1561077
22924,fseidler,1,0.00006,391856,25.10164,1561077
22925,fstradiotti,1,0.00006,391857,25.10171,1561077
22926,ftheomunhoz,1,0.00006,391858,25.10177,1561077
22927,ftom2,1,0.00006,391859,25.10184,1561077
22928,FuckingDeveloper,1,0.00006,391860,25.10190,1561077
22929,FuckingSsmile,1,0.00006,391861,25.10196,1561077
22930,fuero,1,0.00006,391862,25.10203,1561077
22931,fullofcaffeine,1,0.00006,391863,25.10209,1561077
22932,funkfunk,1,0.00006,391864,25.10216,1561077
22933,FunkyFab,1,0.00006,391865,25.10222,1561077
22934,Funtic,1,0.00006,391866,25.10229,1561077
22935,furduialex,1,0.00006,391867,25.10235,1561077
22936,FurkanInciroglu,1,0.00006,391868,25.10241,1561077
22937,fusiyuan2010,1,0.00006,391869,25.10248,1561077
22938,futahashi,1,0.00006,391870,25.10254,1561077
22939,futchas,1,0.00006,391871,25.10261,1561077
22940,fuzecheng,1,0.00006,391872,25.10267,1561077
22941,fuzza,1,0.00006,391873,25.10273,1561077
22942,fverbist,1,0.00006,391874,25.10280,1561077
22943,fv-ian,1,0.00006,391875,25.10286,1561077
22944,fx2y,1,0.00006,391876,25.10293,1561077
22945,FxNion,1,0.00006,391877,25.10299,1561077
22946,fy976061258,1,0.00006,391878,25.10305,1561077
22947,g0t4,1,0.00006,391879,25.10312,1561077
22948,g3p3nk,1,0.00006,391880,25.10318,1561077
22949,gabel0287,1,0.00006,391881,25.10325,1561077
22950,gabordugov,1,0.00006,391882,25.10331,1561077
22951,gaborvass,1,0.00006,391883,25.10337,1561077
22952,GabrielBB,1,0.00006,391884,25.10344,1561077
22953,gabrielcsapo,1,0.00006,391885,25.10350,1561077
22954,gabrielhof,1,0.00006,391886,25.10357,1561077
22955,gabrielke,1,0.00006,391887,25.10363,1561077
22956,GabrielLasso,1,0.00006,391888,25.10369,1561077
22957,GabrielleBreeze,1,0.00006,391889,25.10376,1561077
22958,GabrielRivera21,1,0.00006,391890,25.10382,1561077
22959,gaddavi,1,0.00006,391891,25.10389,1561077
22960,GadgetFreakUK,1,0.00006,391892,25.10395,1561077
22961,gagarinfan,1,0.00006,391893,25.10401,1561077
22962,gai6948,1,0.00006,391894,25.10408,1561077
22963,gaida,1,0.00006,391895,25.10414,1561077
22964,gaiksaya,1,0.00006,391896,25.10421,1561077
22965,gailmarie,1,0.00006,391897,25.10427,1561077
22966,gajananrmahajan,1,0.00006,391898,25.10434,1561077
22967,galarragas,1,0.00006,391899,25.10440,1561077
22968,gallea01,1,0.00006,391900,25.10446,1561077
22969,gals-ma,1,0.00006,391901,25.10453,1561077
22970,galtzo,1,0.00006,391902,25.10459,1561077
22971,gambrose,1,0.00006,391903,25.10466,1561077
22972,ganapatirao,1,0.00006,391904,25.10472,1561077
22973,GandalfIX,1,0.00006,391905,25.10478,1561077
22974,gandrademello,1,0.00006,391906,25.10485,1561077
22975,ganesh3141,1,0.00006,391907,25.10491,1561077
22976,ganeshprasadr,1,0.00006,391908,25.10498,1561077
22977,ganesh-tavant,1,0.00006,391909,25.10504,1561077
22978,ganeshwankhede,1,0.00006,391910,25.10510,1561077
22979,gang89,1,0.00006,391911,25.10517,1561077
22980,gangchen03,1,0.00006,391912,25.10523,1561077
22981,ganguill,1,0.00006,391913,25.10530,1561077
22982,Ganiredi,1,0.00006,391914,25.10536,1561077
22983,ganjarpanji,1,0.00006,391915,25.10542,1561077
22984,ganncamp,1,0.00006,391916,25.10549,1561077
22985,gaoyajun01,1,0.00006,391917,25.10555,1561077
22986,gaoyanyu,1,0.00006,391918,25.10562,1561077
22987,Garagoth,1,0.00006,391919,25.10568,1561077
22988,garazdawi,1,0.00006,391920,25.10574,1561077
22989,gardengeek99,1,0.00006,391921,25.10581,1561077
22990,GargAnshu9468,1,0.00006,391922,25.10587,1561077
22991,gargaroff,1,0.00006,391923,25.10594,1561077
22992,garguedas,1,0.00006,391924,25.10600,1561077
22993,Garima748,1,0.00006,391925,25.10606,1561077
22994,garimadialpad,1,0.00006,391926,25.10613,1561077
22995,garrynewman,1,0.00006,391927,25.10619,1561077
22996,garsondeploy,1,0.00006,391928,25.10626,1561077
22997,garumaru,1,0.00006,391929,25.10632,1561077
22998,garunski,1,0.00006,391930,25.10638,1561077
22999,GaryAult,1,0.00006,391931,25.10645,1561077
23000,garyavery,1,0.00006,391932,25.10651,1561077
23001,garychappell,1,0.00006,391933,25.10658,1561077
23002,garykb8,1,0.00006,391934,25.10664,1561077
23003,garymoon,1,0.00006,391935,25.10671,1561077
23004,garypigeon,1,0.00006,391936,25.10677,1561077
23005,garyritchie,1,0.00006,391937,25.10683,1561077
23006,garysturgeon,1,0.00006,391938,25.10690,1561077
23007,gastiuru,1,0.00006,391939,25.10696,1561077
23008,gaudah,1,0.00006,391940,25.10703,1561077
23009,gauee,1,0.00006,391941,25.10709,1561077
23010,Gaurav2Github,1,0.00006,391942,25.10715,1561077
23011,gauravarora,1,0.00006,391943,25.10722,1561077
23012,gauravgemalto,1,0.00006,391944,25.10728,1561077
23013,gauravjain59,1,0.00006,391945,25.10735,1561077
23014,GauravJShah,1,0.00006,391946,25.10741,1561077
23015,gauravkr19,1,0.00006,391947,25.10747,1561077
23016,gauravnavgire,1,0.00006,391948,25.10754,1561077
23017,gauravsrivastav,1,0.00006,391949,25.10760,1561077
23018,gauthierm,1,0.00006,391950,25.10767,1561077
23019,gavinc1980,1,0.00006,391951,25.10773,1561077
23020,GayatriHimthani,1,0.00006,391952,25.10779,1561077
23021,gazataeon,1,0.00006,391953,25.10786,1561077
23022,Gazzonyx,1,0.00006,391954,25.10792,1561077
23023,gbavoz1,1,0.00006,391955,25.10799,1561077
23024,GBernard314,1,0.00006,391956,25.10805,1561077
23025,gbloquel,1,0.00006,391957,25.10811,1561077
23026,gboddin,1,0.00006,391958,25.10818,1561077
23027,gbohra,1,0.00006,391959,25.10824,1561077
23028,gbolivar,1,0.00006,391960,25.10831,1561077
23029,gbonk,1,0.00006,391961,25.10837,1561077
23030,gbwey9,1,0.00006,391962,25.10843,1561077
23031,gbyukg,1,0.00006,391963,25.10850,1561077
23032,gcaccia,1,0.00006,391964,25.10856,1561077
23033,gcarnell,1,0.00006,391965,25.10863,1561077
23034,gcarter-comcast,1,0.00006,391966,25.10869,1561077
23035,gcase,1,0.00006,391967,25.10876,1561077
23036,gcharters,1,0.00006,391968,25.10882,1561077
23037,gcinar,1,0.00006,391969,25.10888,1561077
23038,gd46,1,0.00006,391970,25.10895,1561077
23039,gdancerx,1,0.00006,391971,25.10901,1561077
23040,gdgate,1,0.00006,391972,25.10908,1561077
23041,gdombchik,1,0.00006,391973,25.10914,1561077
23042,ge0ffrey,1,0.00006,391974,25.10920,1561077
23043,geak,1,0.00006,391975,25.10927,1561077
23044,GearoidCollins,1,0.00006,391976,25.10933,1561077
23045,Gee19,1,0.00006,391977,25.10940,1561077
23046,geek,1,0.00006,391978,25.10946,1561077
23047,geekmug,1,0.00006,391979,25.10952,1561077
23048,geekvikas,1,0.00006,391980,25.10959,1561077
23049,geetanjalikamble-jade,1,0.00006,391981,25.10965,1561077
23050,GegeFR,1,0.00006,391982,25.10972,1561077
23051,gegulati,1,0.00006,391983,25.10978,1561077
23052,GehanPanapitiya,1,0.00006,391984,25.10984,1561077
23053,geissonator,1,0.00006,391985,25.10991,1561077
23054,gejiawen,1,0.00006,391986,25.10997,1561077
23055,gek-mcfh,1,0.00006,391987,25.11004,1561077
23056,Gektorian,1,0.00006,391988,25.11010,1561077
23057,gelblars,1,0.00006,391989,25.11016,1561077
23058,geldim,1,0.00006,391990,25.11023,1561077
23059,geminicaprograms,1,0.00006,391991,25.11029,1561077
23060,GenaANTG,1,0.00006,391992,25.11036,1561077
23061,genehynson,1,0.00006,391993,25.11042,1561077
23062,generalredneck,1,0.00006,391994,25.11048,1561077
23063,generatz,1,0.00006,391995,25.11055,1561077
23064,geniousphp,1,0.00006,391996,25.11061,1561077
23065,gentitope,1,0.00006,391997,25.11068,1561077
23066,GentleJan,1,0.00006,391998,25.11074,1561077
23067,Gentleman1983,1,0.00006,391999,25.11080,1561077
23068,Geo87,1,0.00006,392000,25.11087,1561077
23069,geogeocutcut,1,0.00006,392001,25.11093,1561077
23070,geoger,1,0.00006,392002,25.11100,1561077
23071,georgblumenschein,1,0.00006,392003,25.11106,1561077
23072,George02,1,0.00006,392004,25.11113,1561077
23073,Georgegriff,1,0.00006,392005,25.11119,1561077
23074,georgejoel,1,0.00006,392006,25.11125,1561077
23075,GeorgeLopes,1,0.00006,392007,25.11132,1561077
23076,georgemihalcea,1,0.00006,392008,25.11138,1561077
23077,GeorgeSealy,1,0.00006,392009,25.11145,1561077
23078,georgioupanayiotis,1,0.00006,392010,25.11151,1561077
23079,GeorgiPachov,1,0.00006,392011,25.11157,1561077
23080,georg-koch,1,0.00006,392012,25.11164,1561077
23081,gepandz,1,0.00006,392013,25.11170,1561077
23082,Gephorian,1,0.00006,392014,25.11177,1561077
23083,geraldikusuma,1,0.00006,392015,25.11183,1561077
23084,gerald-skydio,1,0.00006,392016,25.11189,1561077
23085,geranim0,1,0.00006,392017,25.11196,1561077
23086,gerbrand,1,0.00006,392018,25.11202,1561077
23087,germandavid85,1,0.00006,392019,25.11209,1561077
23088,gerritforge-ltd,1,0.00006,392020,25.11215,1561077
23089,gerrywd,1,0.00006,392021,25.11221,1561077
23090,gesangtome,1,0.00006,392022,25.11228,1561077
23091,gessnerfl,1,0.00006,392023,25.11234,1561077
23092,Gestahlt,1,0.00006,392024,25.11241,1561077
23093,GeVa2072,1,0.00006,392025,25.11247,1561077
23094,gevertex,1,0.00006,392026,25.11253,1561077
23095,gevial,1,0.00006,392027,25.11260,1561077
23096,gf59ru,1,0.00006,392028,25.11266,1561077
23097,gf-atebbe,1,0.00006,392029,25.11273,1561077
23098,gfoligna-nyshex,1,0.00006,392030,25.11279,1561077
23099,g-foster,1,0.00006,392031,25.11285,1561077
23100,gfrntz,1,0.00006,392032,25.11292,1561077
23101,gfroid79,1,0.00006,392033,25.11298,1561077
23102,gganapathyvzm,1,0.00006,392034,25.11305,1561077
23103,ggetv,1,0.00006,392035,25.11311,1561077
23104,ggilley,1,0.00006,392036,25.11318,1561077
23105,ggolawski,1,0.00006,392037,25.11324,1561077
23106,ggowins,1,0.00006,392038,25.11330,1561077
23107,gguillotin,1,0.00006,392039,25.11337,1561077
23108,Gh0stWalk3r,1,0.00006,392040,25.11343,1561077
23109,ghadimani21,1,0.00006,392041,25.11350,1561077
23110,ghandim,1,0.00006,392042,25.11356,1561077
23111,gharcombe-minson,1,0.00006,392043,25.11362,1561077
23112,GhaTMA,1,0.00006,392044,25.11369,1561077
23113,gheine,1,0.00006,392045,25.11375,1561077
23114,ghhenry,1,0.00006,392046,25.11382,1561077
23115,ghongadi,1,0.00006,392047,25.11388,1561077
23116,Ghost-Programmer,1,0.00006,392048,25.11394,1561077
23117,ghostsf,1,0.00006,392049,25.11401,1561077
23118,Gia90,1,0.00006,392050,25.11407,1561077
23119,gianniskap3,1,0.00006,392051,25.11414,1561077
23120,gianpaj,1,0.00006,392052,25.11420,1561077
23121,gibbsju,1,0.00006,392053,25.11426,1561077
23122,Gibby,1,0.00006,392054,25.11433,1561077
23123,gideonaina,1,0.00006,392055,25.11439,1561077
23124,gigaga,1,0.00006,392056,25.11446,1561077
23125,gijo919,1,0.00006,392057,25.11452,1561077
23126,giladsh1,1,0.00006,392058,25.11458,1561077
23127,gilberttu,1,0.00006,392059,25.11465,1561077
23128,Gildon,1,0.00006,392060,25.11471,1561077
23129,gilesrapkinb,1,0.00006,392061,25.11478,1561077
23130,GiLfr,1,0.00006,392062,25.11484,1561077
23131,gill-0,1,0.00006,392063,25.11490,1561077
23132,gilramir,1,0.00006,392064,25.11497,1561077
23133,gilsheps,1,0.00006,392065,25.11503,1561077
23134,giltime,1,0.00006,392066,25.11510,1561077
23135,giltron,1,0.00006,392067,25.11516,1561077
23136,GingaNinja,1,0.00006,392068,25.11522,1561077
23137,gin-nader,1,0.00006,392069,25.11529,1561077
23138,giordy,1,0.00006,392070,25.11535,1561077
23139,giorgenes,1,0.00006,392071,25.11542,1561077
23140,gippimania,1,0.00006,392072,25.11548,1561077
23141,girardc79,1,0.00006,392073,25.11555,1561077
23142,giriatblockchange,1,0.00006,392074,25.11561,1561077
23143,girichinna27,1,0.00006,392075,25.11567,1561077
23144,girisha-g,1,0.00006,392076,25.11574,1561077
23145,girish-netskope,1,0.00006,392077,25.11580,1561077
23146,girishrd2004,1,0.00006,392078,25.11587,1561077
23147,gitAllender,1,0.00006,392079,25.11593,1561077
23148,Githraine,1,0.00006,392080,25.11599,1561077
23149,github1,1,0.00006,392081,25.11606,1561077
23150,githubert,1,0.00006,392082,25.11612,1561077
23151,githubist16,1,0.00006,392083,25.11619,1561077
23152,github-reader,1,0.00006,392084,25.11625,1561077
23153,GitHubWesley,1,0.00006,392085,25.11631,1561077
23154,githubzjx2016,1,0.00006,392086,25.11638,1561077
23155,gitops-unbxd,1,0.00006,392087,25.11644,1561077
23156,gitstart,1,0.00006,392088,25.11651,1561077
23157,GitterKim,1,0.00006,392089,25.11657,1561077
23158,gizabutler,1,0.00006,392090,25.11663,1561077
23159,gjarms,1,0.00006,392091,25.11670,1561077
23160,gjonespf,1,0.00006,392092,25.11676,1561077
23161,gjoris,1,0.00006,392093,25.11683,1561077
23162,gjoseph,1,0.00006,392094,25.11689,1561077
23163,gkdevops,1,0.00006,392095,25.11695,1561077
23164,gkiszczak,1,0.00006,392096,25.11702,1561077
23165,gkovelman-levl,1,0.00006,392097,25.11708,1561077
23166,gl328518397,1,0.00006,392098,25.11715,1561077
23167,gladenjoy,1,0.00006,392099,25.11721,1561077
23168,glauber-experian,1,0.00006,392100,25.11727,1561077
23169,glaucoaq,1,0.00006,392101,25.11734,1561077
23170,gleam-ru,1,0.00006,392102,25.11740,1561077
23171,glebk,1,0.00006,392103,25.11747,1561077
23172,Glennzo,1,0.00006,392104,25.11753,1561077
23173,glenpike,1,0.00006,392105,25.11760,1561077
23174,glenritchie,1,0.00006,392106,25.11766,1561077
23175,glensteroni,1,0.00006,392107,25.11772,1561077
23176,glessit,1,0.00006,392108,25.11779,1561077
23177,glick,1,0.00006,392109,25.11785,1561077
23178,glivon,1,0.00006,392110,25.11792,1561077
23179,glmnet,1,0.00006,392111,25.11798,1561077
23180,globocs,1,0.00006,392112,25.11804,1561077
23181,gmatroskin,1,0.00006,392113,25.11811,1561077
23182,gmcnaughton,1,0.00006,392114,25.11817,1561077
23183,gmuecke,1,0.00006,392115,25.11824,1561077
23184,gnauHekiM,1,0.00006,392116,25.11830,1561077
23185,gnin-slack,1,0.00006,392117,25.11836,1561077
23186,gnuchu,1,0.00006,392118,25.11843,1561077
23187,gnydick,1,0.00006,392119,25.11849,1561077
23188,goatherder,1,0.00006,392120,25.11856,1561077
23189,goatsy,1,0.00006,392121,25.11862,1561077
23190,gobos,1,0.00006,392122,25.11868,1561077
23191,goekhanm,1,0.00006,392123,25.11875,1561077
23192,goffinf,1,0.00006,392124,25.11881,1561077
23193,goir,1,0.00006,392125,25.11888,1561077
23194,gokuney,1,0.00006,392126,25.11894,1561077
23195,goldiee36,1,0.00006,392127,25.11900,1561077
23196,goldspin,1,0.00006,392128,25.11907,1561077
23197,goldyliang,1,0.00006,392129,25.11913,1561077
23198,golkonda,1,0.00006,392130,25.11920,1561077
23199,goloroden,1,0.00006,392131,25.11926,1561077
23200,goncharenkov,1,0.00006,392132,25.11932,1561077
23201,gongled,1,0.00006,392133,25.11939,1561077
23202,gongzelong,1,0.00006,392134,25.11945,1561077
23203,gongzelong0718,1,0.00006,392135,25.11952,1561077
23204,gongzili456,1,0.00006,392136,25.11958,1561077
23205,GonzalezAndrew,1,0.00006,392137,25.11964,1561077
23206,goodwinb99,1,0.00006,392138,25.11971,1561077
23207,goody9807,1,0.00006,392139,25.11977,1561077
23208,goofyahead,1,0.00006,392140,25.11984,1561077
23209,GooseYArd,1,0.00006,392141,25.11990,1561077
23210,gopal-gemini,1,0.00006,392142,25.11997,1561077
23211,gopannabd,1,0.00006,392143,25.12003,1561077
23212,gopi-devops1,1,0.00006,392144,25.12009,1561077
23213,goraxe,1,0.00006,392145,25.12016,1561077
23214,gordonshieh94,1,0.00006,392146,25.12022,1561077
23215,goriparthi,1,0.00006,392147,25.12029,1561077
23216,gossnj,1,0.00006,392148,25.12035,1561077
23217,gosub3000,1,0.00006,392149,25.12041,1561077
23218,gothrek22,1,0.00006,392150,25.12048,1561077
23219,gotlin,1,0.00006,392151,25.12054,1561077
23220,gotviserion,1,0.00006,392152,25.12061,1561077
23221,goughy000,1,0.00006,392153,25.12067,1561077
23222,gouthamep,1,0.00006,392154,25.12073,1561077
23223,gowrigirish,1,0.00006,392155,25.12080,1561077
23224,gowthamchinna,1,0.00006,392156,25.12086,1561077
23225,goyan,1,0.00006,392157,25.12093,1561077
23226,gpankaj,1,0.00006,392158,25.12099,1561077
23227,gpetrousov,1,0.00006,392159,25.12105,1561077
23228,gpiper14,1,0.00006,392160,25.12112,1561077
23229,gpkirk,1,0.00006,392161,25.12118,1561077
23230,gpmidi,1,0.00006,392162,25.12125,1561077
23231,gpongelli,1,0.00006,392163,25.12131,1561077
23232,grabcocque,1,0.00006,392164,25.12137,1561077
23233,gracechensd,1,0.00006,392165,25.12144,1561077
23234,GraemeLo,1,0.00006,392166,25.12150,1561077
23235,grafenam,1,0.00006,392167,25.12157,1561077
23236,grahammkelly,1,0.00006,392168,25.12163,1561077
23237,grahampfau,1,0.00006,392169,25.12169,1561077
23238,Grandrath,1,0.00006,392170,25.12176,1561077
23239,grav,1,0.00006,392171,25.12182,1561077
23240,gravcat,1,0.00006,392172,25.12189,1561077
23241,graycrock,1,0.00006,392173,25.12195,1561077
23242,GrayGoose,1,0.00006,392174,25.12202,1561077
23243,graylancome,1,0.00006,392175,25.12208,1561077
23244,grb19,1,0.00006,392176,25.12214,1561077
23245,Greatlemer,1,0.00006,392177,25.12221,1561077
23246,GRebner,1,0.00006,392178,25.12227,1561077
23247,greenrobot,1,0.00006,392179,25.12234,1561077
23248,gregallen,1,0.00006,392180,25.12240,1561077
23249,gregamb,1,0.00006,392181,25.12246,1561077
23250,gregbeecroft-taulia,1,0.00006,392182,25.12253,1561077
23251,gregdaybreak,1,0.00006,392183,25.12259,1561077
23252,greghall76,1,0.00006,392184,25.12266,1561077
23253,greghmerrill,1,0.00006,392185,25.12272,1561077
23254,greg-intel,1,0.00006,392186,25.12278,1561077
23255,greg-junkietech,1,0.00006,392187,25.12285,1561077
23256,gregoryduckworth,1,0.00006,392188,25.12291,1561077
23257,gregpflaum,1,0.00006,392189,25.12298,1561077
23258,GregSharpe1,1,0.00006,392190,25.12304,1561077
23259,Greg-Smulko,1,0.00006,392191,25.12310,1561077
23260,gregsomers,1,0.00006,392192,25.12317,1561077
23261,Gregy,1,0.00006,392193,25.12323,1561077
23262,grfullerton,1,0.00006,392194,25.12330,1561077
23263,grickit,1,0.00006,392195,25.12336,1561077
23264,GridxFuJun,1,0.00006,392196,25.12342,1561077
23265,grigaci,1,0.00006,392197,25.12349,1561077
23266,grigorbarseghyan,1,0.00006,392198,25.12355,1561077
23267,grigorev-lm,1,0.00006,392199,25.12362,1561077
23268,grigouze,1,0.00006,392200,25.12368,1561077
23269,grimpy,1,0.00006,392201,25.12374,1561077
23270,grinnellian,1,0.00006,392202,25.12381,1561077
23271,grische,1,0.00006,392203,25.12387,1561077
23272,grizzlyecollege,1,0.00006,392204,25.12394,1561077
23273,Grizzlyt,1,0.00006,392205,25.12400,1561077
23274,grmpfhmbl,1,0.00006,392206,25.12406,1561077
23275,grndvl1,1,0.00006,392207,25.12413,1561077
23276,grochoge,1,0.00006,392208,25.12419,1561077
23277,grohan2002,1,0.00006,392209,25.12426,1561077
23278,grolfcry,1,0.00006,392210,25.12432,1561077
23279,groliffe,1,0.00006,392211,25.12439,1561077
23280,gromhit,1,0.00006,392212,25.12445,1561077
23281,gromittm,1,0.00006,392213,25.12451,1561077
23282,gronico,1,0.00006,392214,25.12458,1561077
23283,grossiello-netspinlab,1,0.00006,392215,25.12464,1561077
23284,gr-raphlau,1,0.00006,392216,25.12471,1561077
23285,grtessman,1,0.00006,392217,25.12477,1561077
23286,grybykm,1,0.00006,392218,25.12483,1561077
23287,grytrn,1,0.00006,392219,25.12490,1561077
23288,grzegorz-dubicki,1,0.00006,392220,25.12496,1561077
23289,grzegorz-tarnowski,1,0.00006,392221,25.12503,1561077
23290,grzn,1,0.00006,392222,25.12509,1561077
23291,gsapozhn,1,0.00006,392223,25.12515,1561077
23292,gsarrica,1,0.00006,392224,25.12522,1561077
23293,gs-byte,1,0.00006,392225,25.12528,1561077
23294,gschwienbacher,1,0.00006,392226,25.12535,1561077
23295,gserre,1,0.00006,392227,25.12541,1561077
23296,gshakhn,1,0.00006,392228,25.12547,1561077
23297,gshefer,1,0.00006,392229,25.12554,1561077
23298,gskrscm,1,0.00006,392230,25.12560,1561077
23299,gsouza-newstore,1,0.00006,392231,25.12567,1561077
23300,g-s-v,1,0.00006,392232,25.12573,1561077
23301,Gthevampire,1,0.00006,392233,25.12579,1561077
23302,gthicks,1,0.00006,392234,25.12586,1561077
23303,gtmanfred,1,0.00006,392235,25.12592,1561077
23304,gtorka,1,0.00006,392236,25.12599,1561077
23305,gtrafimenkov,1,0.00006,392237,25.12605,1561077
23306,gtron,1,0.00006,392238,25.12611,1561077
23307,gtseres-workable,1,0.00006,392239,25.12618,1561077
23308,guanwei,1,0.00006,392240,25.12624,1561077
23309,Gudio,1,0.00006,392241,25.12631,1561077
23310,guguxfr,1,0.00006,392242,25.12637,1561077
23311,gui-don,1,0.00006,392243,25.12644,1561077
23312,guilhermecgs,1,0.00006,392244,25.12650,1561077
23313,guilhermelabigalini,1,0.00006,392245,25.12656,1561077
23314,guilhermemotadock,1,0.00006,392246,25.12663,1561077
23315,guillaume-alliander,1,0.00006,392247,25.12669,1561077
23316,guillaume-eb,1,0.00006,392248,25.12676,1561077
23317,GuillaumeExia,1,0.00006,392249,25.12682,1561077
23318,guillaumefgn,1,0.00006,392250,25.12688,1561077
23319,GuiSim,1,0.00006,392251,25.12695,1561077
23320,gui-sousa,1,0.00006,392252,25.12701,1561077
23321,gulecroc,1,0.00006,392253,25.12708,1561077
23322,gumerman,1,0.00006,392254,25.12714,1561077
23323,gumshoes,1,0.00006,392255,25.12720,1561077
23324,gunesmes,1,0.00006,392256,25.12727,1561077
23325,gungorerhan,1,0.00006,392257,25.12733,1561077
23326,gungorugur,1,0.00006,392258,25.12740,1561077
23327,gunhu,1,0.00006,392259,25.12746,1561077
23328,Guo-astro,1,0.00006,392260,25.12752,1561077
23329,GuoDapeng,1,0.00006,392261,25.12759,1561077
23330,guohainan,1,0.00006,392262,25.12765,1561077
23331,guoshuaiping,1,0.00006,392263,25.12772,1561077
23332,guptaakhil,1,0.00006,392264,25.12778,1561077
23333,gurchik,1,0.00006,392265,25.12784,1561077
23334,gurpal2000,1,0.00006,392266,25.12791,1561077
23335,guru905,1,0.00006,392267,25.12797,1561077
23336,guruantree,1,0.00006,392268,25.12804,1561077
23337,guruks2004,1,0.00006,392269,25.12810,1561077
23338,guruvamsichintala5,1,0.00006,392270,25.12816,1561077
23339,Gurvan-MycomOsi,1,0.00006,392271,25.12823,1561077
23340,gusdevops,1,0.00006,392272,25.12829,1561077
23341,Guss4241,1,0.00006,392273,25.12836,1561077
23342,Gusymochis,1,0.00006,392274,25.12842,1561077
23343,gutoandreollo,1,0.00006,392275,25.12849,1561077
23344,guy9050,1,0.00006,392276,25.12855,1561077
23345,GuyCatz,1,0.00006,392277,25.12861,1561077
23346,guygiat,1,0.00006,392278,25.12868,1561077
23347,GuyHPE,1,0.00006,392279,25.12874,1561077
23348,guyomog78,1,0.00006,392280,25.12881,1561077
23349,guyos,1,0.00006,392281,25.12887,1561077
23350,guyzsarun,1,0.00006,392282,25.12893,1561077
23351,guzy0324,1,0.00006,392283,25.12900,1561077
23352,gvasanka,1,0.00006,392284,25.12906,1561077
23353,gvashchenkolineate,1,0.00006,392285,25.12913,1561077
23354,gvaughan-lbi,1,0.00006,392286,25.12919,1561077
23355,gvfnix,1,0.00006,392287,25.12925,1561077
23356,gvinicius,1,0.00006,392288,25.12932,1561077
23357,gvirtuoso,1,0.00006,392289,25.12938,1561077
23358,gwaldvogel,1,0.00006,392290,25.12945,1561077
23359,gwasky,1,0.00006,392291,25.12951,1561077
23360,gypark,1,0.00006,392292,25.12957,1561077
23361,gyurovb,1,0.00006,392293,25.12964,1561077
23362,gyzpunk,1,0.00006,392294,25.12970,1561077
23363,h1manshu98,1,0.00006,392295,25.12977,1561077
23364,H2wk,1,0.00006,392296,25.12983,1561077
23365,habelson,1,0.00006,392297,25.12989,1561077
23366,hablislim,1,0.00006,392298,25.12996,1561077
23367,hachi,1,0.00006,392299,25.13002,1561077
23368,hacker112,1,0.00006,392300,25.13009,1561077
23369,hackmann,1,0.00006,392301,25.13015,1561077
23370,hackmd-deploy,1,0.00006,392302,25.13021,1561077
23371,hacrot3000,1,0.00006,392303,25.13028,1561077
23372,HaddadJoe,1,0.00006,392304,25.13034,1561077
23373,hadirsa,1,0.00006,392305,25.13041,1561077
23374,hadmut,1,0.00006,392306,25.13047,1561077
23375,hadogenes,1,0.00006,392307,25.13053,1561077
23376,hadrianjmnz90,1,0.00006,392308,25.13060,1561077
23377,hadv,1,0.00006,392309,25.13066,1561077
23378,haegar,1,0.00006,392310,25.13073,1561077
23379,haeto,1,0.00006,392311,25.13079,1561077
23380,hafixo,1,0.00006,392312,25.13086,1561077
23381,haikubox,1,0.00006,392313,25.13092,1561077
23382,haiouwa,1,0.00006,392314,25.13098,1561077
23383,hairesis,1,0.00006,392315,25.13105,1561077
23384,haitaoyao,1,0.00006,392316,25.13111,1561077
23385,haiya512,1,0.00006,392317,25.13118,1561077
23386,hakamairi,1,0.00006,392318,25.13124,1561077
23387,hakonhall,1,0.00006,392319,25.13130,1561077
23388,Haleymiranda79,1,0.00006,392320,25.13137,1561077
23389,halfengineer07,1,0.00006,392321,25.13143,1561077
23390,hallm4,1,0.00006,392322,25.13150,1561077
23391,haluz,1,0.00006,392323,25.13156,1561077
23392,halvorboe,1,0.00006,392324,25.13162,1561077
23393,hamab92235,1,0.00006,392325,25.13169,1561077
23394,hameddanesh67,1,0.00006,392326,25.13175,1561077
23395,hamiel,1,0.00006,392327,25.13182,1561077
23396,hammadirshad,1,0.00006,392328,25.13188,1561077
23397,hammadismae,1,0.00006,392329,25.13194,1561077
23398,HamzaaKhattabi,1,0.00006,392330,25.13201,1561077
23399,hamzah-efi,1,0.00006,392331,25.13207,1561077
23400,hanaa-abdelgawad,1,0.00006,392332,25.13214,1561077
23401,hanabishi-se,1,0.00006,392333,25.13220,1561077
23402,hanank8,1,0.00006,392334,25.13226,1561077
23403,handschriftenportal-dev,1,0.00006,392335,25.13233,1561077
23404,hangdong,1,0.00006,392336,25.13239,1561077
23405,hanikhan,1,0.00006,392337,25.13246,1561077
23406,hankzhao-zp,1,0.00006,392338,25.13252,1561077
23407,hanleyt,1,0.00006,392339,25.13258,1561077
23408,hannesdejager,1,0.00006,392340,25.13265,1561077
23409,hansanghoon,1,0.00006,392341,25.13271,1561077
23410,hansh0801,1,0.00006,392342,25.13278,1561077
23411,hanzala1234,1,0.00006,392343,25.13284,1561077
23412,haohaofan,1,0.00006,392344,25.13291,1561077
23413,haohetao,1,0.00006,392345,25.13297,1561077
23414,haoliangyu,1,0.00006,392346,25.13303,1561077
23415,HaoTanAtMLB,1,0.00006,392347,25.13310,1561077
23416,hapeka72,1,0.00006,392348,25.13316,1561077
23417,happidad,1,0.00006,392349,25.13323,1561077
23418,harakka,1,0.00006,392350,25.13329,1561077
23419,haraldreingruber,1,0.00006,392351,25.13335,1561077
23420,HardHero,1,0.00006,392352,25.13342,1561077
23421,hardieas,1,0.00006,392353,25.13348,1561077
23422,hardik05051987,1,0.00006,392354,25.13355,1561077
23423,HardikaDoshi,1,0.00006,392355,25.13361,1561077
23424,HardikAnghan,1,0.00006,392356,25.13367,1561077
23425,hardyxia2018,1,0.00006,392357,25.13374,1561077
23426,HariharaSudhan0998,1,0.00006,392358,25.13380,1561077
23427,harik8,1,0.00006,392359,25.13387,1561077
23428,HariomSaini,1,0.00006,392360,25.13393,1561077
23429,harishatk,1,0.00006,392361,25.13399,1561077
23430,harishkolanu235,1,0.00006,392362,25.13406,1561077
23431,harish-kumar-garg,1,0.00006,392363,25.13412,1561077
23432,Harithaa-C,1,0.00006,392364,25.13419,1561077
23433,HarithaAnu,1,0.00006,392365,25.13425,1561077
23434,hariz22,1,0.00006,392366,25.13431,1561077
23435,harlam357,1,0.00006,392367,25.13438,1561077
23436,harleyhooper1,1,0.00006,392368,25.13444,1561077
23437,harmanbirdi,1,0.00006,392369,25.13451,1561077
23438,HarriesChen,1,0.00006,392370,25.13457,1561077
23439,harrijaakkola,1,0.00006,392371,25.13463,1561077
23440,HarrisHan,1,0.00006,392372,25.13470,1561077
23441,Harry-Chen,1,0.00006,392373,25.13476,1561077
23442,HarryGogonis,1,0.00006,392374,25.13483,1561077
23443,harschware,1,0.00006,392375,25.13489,1561077
23444,Harshil-Jani,1,0.00006,392376,25.13495,1561077
23445,harshlancer,1,0.00006,392377,25.13502,1561077
23446,Harsh-Singh-Rajput,1,0.00006,392378,25.13508,1561077
23447,hartar9,1,0.00006,392379,25.13515,1561077
23448,Hartorn,1,0.00006,392380,25.13521,1561077
23449,haruka98,1,0.00006,392381,25.13528,1561077
23450,HarveyJie,1,0.00006,392382,25.13534,1561077
23451,harveyr,1,0.00006,392383,25.13540,1561077
23452,hasaiki123,1,0.00006,392384,25.13547,1561077
23453,hasan356,1,0.00006,392385,25.13553,1561077
23454,hashimamin,1,0.00006,392386,25.13560,1561077
23455,Hasjamesn,1,0.00006,392387,25.13566,1561077
23456,hasKidanekal,1,0.00006,392388,25.13572,1561077
23457,hassanrazakhalid,1,0.00006,392389,25.13579,1561077
23458,Hassnain-Raza-Alvi,1,0.00006,392390,25.13585,1561077
23459,hatotaka,1,0.00006,392391,25.13592,1561077
23460,hatusyoki,1,0.00006,392392,25.13598,1561077
23461,hatzibod,1,0.00006,392393,25.13604,1561077
23462,havocx42,1,0.00006,392394,25.13611,1561077
23463,hawaiik,1,0.00006,392395,25.13617,1561077
23464,hawknewton,1,0.00006,392396,25.13624,1561077
23465,haydarAlaeddin,1,0.00006,392397,25.13630,1561077
23466,haydaralrikabi,1,0.00006,392398,25.13636,1561077
23467,Hayden,1,0.00006,392399,25.13643,1561077
23468,haytham-salhi,1,0.00006,392400,25.13649,1561077
23469,hazem700,1,0.00006,392401,25.13656,1561077
23470,HaziFlorinMarian,1,0.00006,392402,25.13662,1561077
23471,Hazok,1,0.00006,392403,25.13668,1561077
23472,hbarshak,1,0.00006,392404,25.13675,1561077
23473,hbfernandes,1,0.00006,392405,25.13681,1561077
23474,hblok,1,0.00006,392406,25.13688,1561077
23475,hbsascha,1,0.00006,392407,25.13694,1561077
23476,hcldan,1,0.00006,392408,25.13700,1561077
23477,HD534,1,0.00006,392409,25.13707,1561077
23478,HDatPaddle,1,0.00006,392410,25.13713,1561077
23479,hdt91,1,0.00006,392411,25.13720,1561077
23480,He5,1,0.00006,392412,25.13726,1561077
23481,headsail1,1,0.00006,392413,25.13733,1561077
23482,headsha,1,0.00006,392414,25.13739,1561077
23483,heamaral,1,0.00006,392415,25.13745,1561077
23484,hearace1,1,0.00006,392416,25.13752,1561077
23485,heartpandora,1,0.00006,392417,25.13758,1561077
23486,heartyguy,1,0.00006,392418,25.13765,1561077
23487,heaseny,1,0.00006,392419,25.13771,1561077
23488,hebah4change,1,0.00006,392420,25.13777,1561077
23489,hebestreit,1,0.00006,392421,25.13784,1561077
23490,hebrewd,1,0.00006,392422,25.13790,1561077
23491,hectcastro,1,0.00006,392423,25.13797,1561077
23492,hedchain,1,0.00006,392424,25.13803,1561077
23493,Hedede,1,0.00006,392425,25.13809,1561077
23494,hedefalk,1,0.00006,392426,25.13816,1561077
23495,HeEAaD,1,0.00006,392427,25.13822,1561077
23496,heenasharma11,1,0.00006,392428,25.13829,1561077
23497,heggrik,1,0.00006,392429,25.13835,1561077
23498,HegrJan,1,0.00006,392430,25.13841,1561077
23499,hehaoqian,1,0.00006,392431,25.13848,1561077
23500,heidi123,1,0.00006,392432,25.13854,1561077
23501,HeinanCA,1,0.00006,392433,25.13861,1561077
23502,heiqs,1,0.00006,392434,25.13867,1561077
23503,hejianchun,1,0.00006,392435,25.13873,1561077
23504,helal86,1,0.00006,392436,25.13880,1561077
23505,helenlevich,1,0.00006,392437,25.13886,1561077
23506,Helenmichel,1,0.00006,392438,25.13893,1561077
23507,helhindi,1,0.00006,392439,25.13899,1561077
23508,HellaSolutions,1,0.00006,392440,25.13905,1561077
23509,hellbill,1,0.00006,392441,25.13912,1561077
23510,hellBoy333k,1,0.00006,392442,25.13918,1561077
23511,helletheone,1,0.00006,392443,25.13925,1561077
23512,hellolittlewei,1,0.00006,392444,25.13931,1561077
23513,helloPiers,1,0.00006,392445,25.13937,1561077
23514,helloqianqian,1,0.00006,392446,25.13944,1561077
23515,hellp21,1,0.00006,392447,25.13950,1561077
23516,helmlover,1,0.00006,392448,25.13957,1561077
23517,Helpstone,1,0.00006,392449,25.13963,1561077
23518,hemano,1,0.00006,392450,25.13970,1561077
23519,HemantaK,1,0.00006,392451,25.13976,1561077
23520,hemanthaSN,1,0.00006,392452,25.13982,1561077
23521,hemanth-dunzo,1,0.00006,392453,25.13989,1561077
23522,hemantrevankar,1,0.00006,392454,25.13995,1561077
23523,henbucuoshanghai,1,0.00006,392455,25.14002,1561077
23524,henderjm,1,0.00006,392456,25.14008,1561077
23525,hendrixjoseph,1,0.00006,392457,25.14014,1561077
23526,hendychua,1,0.00006,392458,25.14021,1561077
23527,HenkPoley,1,0.00006,392459,25.14027,1561077
23528,HenrikPilz,1,0.00006,392460,25.14034,1561077
23529,henriquesantos,1,0.00006,392461,25.14040,1561077
23530,henzef,1,0.00006,392462,25.14046,1561077
23531,heojay,1,0.00006,392463,25.14053,1561077
23532,heortizr,1,0.00006,392464,25.14059,1561077
23533,herbert-soares-ifood,1,0.00006,392465,25.14066,1561077
23534,herculeshssj,1,0.00006,392466,25.14072,1561077
23535,HereWeAreFromFrance,1,0.00006,392467,25.14078,1561077
23536,herlon214,1,0.00006,392468,25.14085,1561077
23537,hero0926,1,0.00006,392469,25.14091,1561077
23538,Hertog-PJ,1,0.00006,392470,25.14098,1561077
23539,herzogf,1,0.00006,392471,25.14104,1561077
23540,HeshamZwayyed22,1,0.00006,392472,25.14110,1561077
23541,hestrompa,1,0.00006,392473,25.14117,1561077
23542,hetian-github,1,0.00006,392474,25.14123,1561077
23543,hex0cter,1,0.00006,392475,25.14130,1561077
23544,hex43ver,1,0.00006,392476,25.14136,1561077
23545,hexadite-maxk,1,0.00006,392477,25.14142,1561077
23546,hexiaolong-coco,1,0.00006,392478,25.14149,1561077
23547,hexsel,1,0.00006,392479,25.14155,1561077
23548,HexTeto,1,0.00006,392480,25.14162,1561077
23549,heylong6551,1,0.00006,392481,25.14168,1561077
23550,heyMP,1,0.00006,392482,25.14175,1561077
23551,hfrazon,1,0.00006,392483,25.14181,1561077
23552,hg13190,1,0.00006,392484,25.14187,1561077
23553,hgajjar,1,0.00006,392485,25.14194,1561077
23554,hgd2018,1,0.00006,392486,25.14200,1561077
23555,hggh,1,0.00006,392487,25.14207,1561077
23556,hgiesenow,1,0.00006,392488,25.14213,1561077
23557,hgmart,1,0.00006,392489,25.14219,1561077
23558,hgontijo,1,0.00006,392490,25.14226,1561077
23559,hhellyer,1,0.00006,392491,25.14232,1561077
23560,hhimanshuvyass,1,0.00006,392492,25.14239,1561077
23561,hhy5861,1,0.00006,392493,25.14245,1561077
23562,hichamov,1,0.00006,392494,25.14251,1561077
23563,hidebear,1,0.00006,392495,25.14258,1561077
23564,Hienmaxpro,1,0.00006,392496,25.14264,1561077
23565,hientruongzalora,1,0.00006,392497,25.14271,1561077
23566,hieunguyen847,1,0.00006,392498,25.14277,1561077
23567,Highelr,1,0.00006,392499,25.14283,1561077
23568,hilaweinstok,1,0.00006,392500,25.14290,1561077
23569,hilkeheremans,1,0.00006,392501,25.14296,1561077
23570,himadrisingh001,1,0.00006,392502,25.14303,1561077
23571,HimanGamage,1,0.00006,392503,25.14309,1561077
23572,himanso,1,0.00006,392504,25.14315,1561077
23573,hindsc52,1,0.00006,392505,25.14322,1561077
23574,hirenoble,1,0.00006,392506,25.14328,1561077
23575,hirenpatel,1,0.00006,392507,25.14335,1561077
23576,hiriumi,1,0.00006,392508,25.14341,1561077
23577,hiroppy,1,0.00006,392509,25.14347,1561077
23578,hishamMounir,1,0.00006,392510,25.14354,1561077
23579,HitoTech,1,0.00006,392511,25.14360,1561077
23580,hitzi,1,0.00006,392512,25.14367,1561077
23581,hivl,1,0.00006,392513,25.14373,1561077
23582,hjoab,1,0.00006,392514,25.14379,1561077
23583,hjstorch,1,0.00006,392515,25.14386,1561077
23584,hjtianvip,1,0.00006,392516,25.14392,1561077
23585,hjubi,1,0.00006,392517,25.14399,1561077
23586,hjwk,1,0.00006,392518,25.14405,1561077
23587,hjzimmer,1,0.00006,392519,25.14412,1561077
23588,hkhan17,1,0.00006,392520,25.14418,1561077
23589,hks225,1,0.00006,392521,25.14424,1561077
23590,hlta,1,0.00006,392522,25.14431,1561077
23591,hmacias,1,0.00006,392523,25.14437,1561077
23592,hmardis,1,0.00006,392524,25.14444,1561077
23593,hmartins-solvay,1,0.00006,392525,25.14450,1561077
23594,hmgauthami,1,0.00006,392526,25.14456,1561077
23595,hmn,1,0.00006,392527,25.14463,1561077
23596,hmpargi,1,0.00006,392528,25.14469,1561077
23597,HMS-JJO,1,0.00006,392529,25.14476,1561077
23598,hnarimani,1,0.00006,392530,25.14482,1561077
23599,HNKNTA,1,0.00006,392531,25.14488,1561077
23600,hnovikov,1,0.00006,392532,25.14495,1561077
23601,hoangmnsd,1,0.00006,392533,25.14501,1561077
23602,Hochoban,1,0.00006,392534,25.14508,1561077
23603,hochraldo,1,0.00006,392535,25.14514,1561077
23604,hodaz,1,0.00006,392536,25.14520,1561077
23605,HodeiG,1,0.00006,392537,25.14527,1561077
23606,hodnajit,1,0.00006,392538,25.14533,1561077
23607,hoefling,1,0.00006,392539,25.14540,1561077
23608,Hoega,1,0.00006,392540,25.14546,1561077
23609,HoffiMuc,1,0.00006,392541,25.14552,1561077
23610,hoitsang,1,0.00006,392542,25.14559,1561077
23611,hoktong,1,0.00006,392543,25.14565,1561077
23612,hol430,1,0.00006,392544,25.14572,1561077
23613,hollowimage,1,0.00006,392545,25.14578,1561077
23614,holmesdindin,1,0.00006,392546,25.14584,1561077
23615,hom7,1,0.00006,392547,25.14591,1561077
23616,HomemBravo,1,0.00006,392548,25.14597,1561077
23617,Homopatrol,1,0.00006,392549,25.14604,1561077
23618,Homy,1,0.00006,392550,25.14610,1561077
23619,hongkongkiwi,1,0.00006,392551,25.14617,1561077
23620,hongliang5623,1,0.00006,392552,25.14623,1561077
23621,honglin6688,1,0.00006,392553,25.14629,1561077
23622,honratha,1,0.00006,392554,25.14636,1561077
23623,HontoNoRoger,1,0.00006,392555,25.14642,1561077
23624,HonzaMac,1,0.00006,392556,25.14649,1561077
23625,hooligan495,1,0.00006,392557,25.14655,1561077
23626,hoopy728,1,0.00006,392558,25.14661,1561077
23627,hooq77,1,0.00006,392559,25.14668,1561077
23628,horkyada,1,0.00006,392560,25.14674,1561077
23629,horoyoii,1,0.00006,392561,25.14681,1561077
23630,hotterd,1,0.00006,392562,25.14687,1561077
23631,houbena,1,0.00006,392563,25.14693,1561077
23632,howardhh,1,0.00006,392564,25.14700,1561077
23633,howardlyliao,1,0.00006,392565,25.14706,1561077
23634,howcroft,1,0.00006,392566,25.14713,1561077
23635,h-philipp,1,0.00006,392567,25.14719,1561077
23636,hppritcha,1,0.00006,392568,25.14725,1561077
23637,hrabosch,1,0.00006,392569,25.14732,1561077
23638,h-ravichandra,1,0.00006,392570,25.14738,1561077
23639,hrbocutti,1,0.00006,392571,25.14745,1561077
23640,hrkn,1,0.00006,392572,25.14751,1561077
23641,hrvwnd,1,0.00006,392573,25.14757,1561077
23642,hryan-ib,1,0.00006,392574,25.14764,1561077
23643,hrzlgnm,1,0.00006,392575,25.14770,1561077
23644,hsaito,1,0.00006,392576,25.14777,1561077
23645,hscesa,1,0.00006,392577,25.14783,1561077
23646,hseverinorev,1,0.00006,392578,25.14789,1561077
23647,hskendall,1,0.00006,392579,25.14796,1561077
23648,hsmiranda,1,0.00006,392580,25.14802,1561077
23649,hsnshn,1,0.00006,392581,25.14809,1561077
23650,hsowan,1,0.00006,392582,25.14815,1561077
23651,hspatel09,1,0.00006,392583,25.14821,1561077
23652,hsson,1,0.00006,392584,25.14828,1561077
23653,hthanhtoan,1,0.00006,392585,25.14834,1561077
23654,htolic,1,0.00006,392586,25.14841,1561077
23655,http-418,1,0.00006,392587,25.14847,1561077
23656,htzhang2,1,0.00006,392588,25.14854,1561077
23657,huangjiao511,1,0.00006,392589,25.14860,1561077
23658,huangluyu,1,0.00006,392590,25.14866,1561077
23659,huangsz1599,1,0.00006,392591,25.14873,1561077
23660,huapox,1,0.00006,392592,25.14879,1561077
23661,huayaoyue6,1,0.00006,392593,25.14886,1561077
23662,hubx,1,0.00006,392594,25.14892,1561077
23663,hudac,1,0.00006,392595,25.14898,1561077
23664,hudson-pierce,1,0.00006,392596,25.14905,1561077
23665,hugespoon,1,0.00006,392597,25.14911,1561077
23666,hu-haibo,1,0.00006,392598,25.14918,1561077
23667,hui-yang,1,0.00006,392599,25.14924,1561077
23668,HumanG33k,1,0.00006,392600,25.14930,1561077
23669,HumanifyTodRichards,1,0.00006,392601,25.14937,1561077
23670,humaruis,1,0.00006,392602,25.14943,1561077
23671,humbletyler,1,0.00006,392603,25.14950,1561077
23672,humroben,1,0.00006,392604,25.14956,1561077
23673,hungpham2202,1,0.00006,392605,25.14962,1561077
23674,hunkjun,1,0.00006,392606,25.14969,1561077
23675,hunner,1,0.00006,392607,25.14975,1561077
23676,hunsche,1,0.00006,392608,25.14982,1561077
23677,Hussain0520,1,0.00006,392609,25.14988,1561077
23678,HusseinKothari26,1,0.00006,392610,25.14994,1561077
23679,hussem1,1,0.00006,392611,25.15001,1561077
23680,hustfly,1,0.00006,392612,25.15007,1561077
23681,huychau,1,0.00006,392613,25.15014,1561077
23682,huydn234,1,0.00006,392614,25.15020,1561077
23683,huyhoang1990,1,0.00006,392615,25.15026,1561077
23684,huynhbach197,1,0.00006,392616,25.15033,1561077
23685,huynhsontung,1,0.00006,392617,25.15039,1561077
23686,huytn1219,1,0.00006,392618,25.15046,1561077
23687,hvisser,1,0.00006,392619,25.15052,1561077
23688,hwacookie,1,0.00006,392620,25.15059,1561077
23689,hwangct,1,0.00006,392621,25.15065,1561077
23690,hwdegroot,1,0.00006,392622,25.15071,1561077
23691,hwilson-r7,1,0.00006,392623,25.15078,1561077
23692,HW-Owl,1,0.00006,392624,25.15084,1561077
23693,hxysayhi,1,0.00006,392625,25.15091,1561077
23694,hydemei,1,0.00006,392626,25.15097,1561077
23695,hydrapolic,1,0.00006,392627,25.15103,1561077
23696,hyei,1,0.00006,392628,25.15110,1561077
23697,hyeonsangjeon,1,0.00006,392629,25.15116,1561077
23698,Hylke1982,1,0.00006,392630,25.15123,1561077
23699,hymn-fly,1,0.00006,392631,25.15129,1561077
23700,hyperatom,1,0.00006,392632,25.15135,1561077
23701,hyunuck,1,0.00006,392633,25.15142,1561077
23702,I12crash,1,0.00006,392634,25.15148,1561077
23703,iaasutosh,1,0.00006,392635,25.15155,1561077
23704,iadonkey,1,0.00006,392636,25.15161,1561077
23705,iainwo,1,0.00006,392637,25.15167,1561077
23706,iakovmarkov,1,0.00006,392638,25.15174,1561077
23707,iamacceptable-daffodil,1,0.00006,392639,25.15180,1561077
23708,iamamused,1,0.00006,392640,25.15187,1561077
23709,iamascript,1,0.00006,392641,25.15193,1561077
23710,iamcip,1,0.00006,392642,25.15199,1561077
23711,iam-decoder,1,0.00006,392643,25.15206,1561077
23712,iamfip,1,0.00006,392644,25.15212,1561077
23713,iamhsa,1,0.00006,392645,25.15219,1561077
23714,iamindradev,1,0.00006,392646,25.15225,1561077
23715,iamkhalidbashir,1,0.00006,392647,25.15231,1561077
23716,iamkobold,1,0.00006,392648,25.15238,1561077
23717,iamsrinivasa,1,0.00006,392649,25.15244,1561077
23718,iamtarunsinghal,1,0.00006,392650,25.15251,1561077
23719,iamtodor-fb,1,0.00006,392651,25.15257,1561077
23720,iamveritas,1,0.00006,392652,25.15264,1561077
23721,iamwyza,1,0.00006,392653,25.15270,1561077
23722,Iana-Kasimova-TR,1,0.00006,392654,25.15276,1561077
23723,ianand0204,1,0.00006,392655,25.15283,1561077
23724,Ianbing-wyy,1,0.00006,392656,25.15289,1561077
23725,iancullinane,1,0.00006,392657,25.15296,1561077
23726,IanKL,1,0.00006,392658,25.15302,1561077
23727,ianmartin,1,0.00006,392659,25.15308,1561077
23728,ianpascoe19,1,0.00006,392660,25.15315,1561077
23729,ianpward,1,0.00006,392661,25.15321,1561077
23730,ianwhite,1,0.00006,392662,25.15328,1561077
23731,iasinDev,1,0.00006,392663,25.15334,1561077
23732,iazt,1,0.00006,392664,25.15340,1561077
23733,ibaldonl,1,0.00006,392665,25.15347,1561077
23734,iBavtovich,1,0.00006,392666,25.15353,1561077
23735,ibbu121,1,0.00006,392667,25.15360,1561077
23736,ibrahimuysal,1,0.00006,392668,25.15366,1561077
23737,ibrf,1,0.00006,392669,25.15372,1561077
23738,ibrocodes7,1,0.00006,392670,25.15379,1561077
23739,icecreamtan,1,0.00006,392671,25.15385,1561077
23740,icewhite,1,0.00006,392672,25.15392,1561077
23741,ichtestemalwieder,1,0.00006,392673,25.15398,1561077
23742,icnocop,1,0.00006,392674,25.15404,1561077
23743,iconstorage,1,0.00006,392675,25.15411,1561077
23744,icormier,1,0.00006,392676,25.15417,1561077
23745,icpl-jatin-panchal,1,0.00006,392677,25.15424,1561077
23746,idan72,1,0.00006,392678,25.15430,1561077
23747,ideepika,1,0.00006,392679,25.15436,1561077
23748,idenisovs,1,0.00006,392680,25.15443,1561077
23749,idkCpp,1,0.00006,392681,25.15449,1561077
23750,idleyoungman,1,0.00006,392682,25.15456,1561077
23751,idoru78,1,0.00006,392683,25.15462,1561077
23752,IdosApplitools,1,0.00006,392684,25.15468,1561077
23753,idrisFoughali,1,0.00006,392685,25.15475,1561077
23754,idueppe,1,0.00006,392686,25.15481,1561077
23755,idv-Evgenii,1,0.00006,392687,25.15488,1561077
23756,ielshal,1,0.00006,392688,25.15494,1561077
23757,ifel,1,0.00006,392689,25.15501,1561077
23758,iffonox,1,0.00006,392690,25.15507,1561077
23759,iFlameing,1,0.00006,392691,25.15513,1561077
23760,IgalKorb,1,0.00006,392692,25.15520,1561077
23761,igalsin,1,0.00006,392693,25.15526,1561077
23762,igiu1988,1,0.00006,392694,25.15533,1561077
23763,Ignas,1,0.00006,392695,25.15539,1561077
23764,ignasr,1,0.00006,392696,25.15545,1561077
23765,ignatandrei,1,0.00006,392697,25.15552,1561077
23766,ignatiusdeepu,1,0.00006,392698,25.15558,1561077
23767,ignite1771,1,0.00006,392699,25.15565,1561077
23768,igoraj,1,0.00006,392700,25.15571,1561077
23769,IgorBM,1,0.00006,392701,25.15577,1561077
23770,igorek9191,1,0.00006,392702,25.15584,1561077
23771,igorfraa,1,0.00006,392703,25.15590,1561077
23772,IgorGerasimov,1,0.00006,392704,25.15597,1561077
23773,igormartimiano,1,0.00006,392705,25.15603,1561077
23774,igor-nikiforov,1,0.00006,392706,25.15609,1561077
23775,igoroshchenko,1,0.00006,392707,25.15616,1561077
23776,igorzamyslov,1,0.00006,392708,25.15622,1561077
23777,igostavro,1,0.00006,392709,25.15629,1561077
23778,igreg,1,0.00006,392710,25.15635,1561077
23779,igsys,1,0.00006,392711,25.15641,1561077
23780,igtsekov,1,0.00006,392712,25.15648,1561077
23781,iguyking,1,0.00006,392713,25.15654,1561077
23782,ihd2911,1,0.00006,392714,25.15661,1561077
23783,II-VSB-II,1,0.00006,392715,25.15667,1561077
23784,ijazm123,1,0.00006,392716,25.15673,1561077
23785,i-jk,1,0.00006,392717,25.15680,1561077
23786,ijrandom,1,0.00006,392718,25.15686,1561077
23787,ijsf,1,0.00006,392719,25.15693,1561077
23788,ijunes,1,0.00006,392720,25.15699,1561077
23789,ijyun,1,0.00006,392721,25.15706,1561077
23790,ikalyvas,1,0.00006,392722,25.15712,1561077
23791,iKeirNez,1,0.00006,392723,25.15718,1561077
23792,ikenneth,1,0.00006,392724,25.15725,1561077
23793,i-kit,1,0.00006,392725,25.15731,1561077
23794,iklimchuk,1,0.00006,392726,25.15738,1561077
23795,ikram-sufian,1,0.00006,392727,25.15744,1561077
23796,iKrushYou,1,0.00006,392728,25.15750,1561077
23797,iksana,1,0.00006,392729,25.15757,1561077
23798,ikunal922,1,0.00006,392730,25.15763,1561077
23799,il1yaz,1,0.00006,392731,25.15770,1561077
23800,i-laird,1,0.00006,392732,25.15776,1561077
23801,ilanni2460,1,0.00006,392733,25.15782,1561077
23802,ilansh,1,0.00006,392734,25.15789,1561077
23803,ilazebny,1,0.00006,392735,25.15795,1561077
23804,ilederman,1,0.00006,392736,25.15802,1561077
23805,ileitch,1,0.00006,392737,25.15808,1561077
23806,iLeViiSxL,1,0.00006,392738,25.15814,1561077
23807,ilFratus,1,0.00006,392739,25.15821,1561077
23808,IliaGe,1,0.00006,392740,25.15827,1561077
23809,iliesaithamouda,1,0.00006,392741,25.15834,1561077
23810,IliinaAlexa,1,0.00006,392742,25.15840,1561077
23811,iliis,1,0.00006,392743,25.15846,1561077
23812,ilker-demir,1,0.00006,392744,25.15853,1561077
23813,ilkka,1,0.00006,392745,25.15859,1561077
23814,ilkomiliev,1,0.00006,392746,25.15866,1561077
23815,illkurok,1,0.00006,392747,25.15872,1561077
23816,illumi,1,0.00006,392748,25.15878,1561077
23817,ilosaurus,1,0.00006,392749,25.15885,1561077
23818,iluha821,1,0.00006,392750,25.15891,1561077
23819,iluyx,1,0.00006,392751,25.15898,1561077
23820,ilyabalashov,1,0.00006,392752,25.15904,1561077
23821,ilyab-job,1,0.00006,392753,25.15910,1561077
23822,Ilya-BSU,1,0.00006,392754,25.15917,1561077
23823,IlyaKutergin,1,0.00006,392755,25.15923,1561077
23824,ilyalukyanov,1,0.00006,392756,25.15930,1561077
23825,IlyaShav,1,0.00006,392757,25.15936,1561077
23826,imaemo,1,0.00006,392758,25.15943,1561077
23827,iman4000,1,0.00006,392759,25.15949,1561077
23828,imapollo,1,0.00006,392760,25.15955,1561077
23829,imatlin,1,0.00006,392761,25.15962,1561077
23830,imcheck,1,0.00006,392762,25.15968,1561077
23831,imcoding4ever,1,0.00006,392763,25.15975,1561077
23832,imdpkj,1,0.00006,392764,25.15981,1561077
23833,iMerica,1,0.00006,392765,25.15987,1561077
23834,imikemo,1,0.00006,392766,25.15994,1561077
23835,iming0319,1,0.00006,392767,25.16000,1561077
23836,imjustabearrr,1,0.00006,392768,25.16007,1561077
23837,im-lcoupe,1,0.00006,392769,25.16013,1561077
23838,immortal-n,1,0.00006,392770,25.16019,1561077
23839,imohsenb,1,0.00006,392771,25.16026,1561077
23840,imos64,1,0.00006,392772,25.16032,1561077
23841,Imosthep,1,0.00006,392773,25.16039,1561077
23842,imp20052904,1,0.00006,392774,25.16045,1561077
23843,impeterp,1,0.00006,392775,25.16051,1561077
23844,imranansari,1,0.00006,392776,25.16058,1561077
23845,imrangit,1,0.00006,392777,25.16064,1561077
23846,imrankhan99,1,0.00006,392778,25.16071,1561077
23847,imsandli,1,0.00006,392779,25.16077,1561077
23848,imsathyakumar,1,0.00006,392780,25.16083,1561077
23849,imtapps,1,0.00006,392781,25.16090,1561077
23850,in8d3v,1,0.00006,392782,25.16096,1561077
23851,inakoll,1,0.00006,392783,25.16103,1561077
23852,i-naya,1,0.00006,392784,25.16109,1561077
23853,inblackhole,1,0.00006,392785,25.16115,1561077
23854,inbuilt-aura,1,0.00006,392786,25.16122,1561077
23855,incedo,1,0.00006,392787,25.16128,1561077
23856,Inchie,1,0.00006,392788,25.16135,1561077
23857,in-cloud-opensource,1,0.00006,392789,25.16141,1561077
23858,incogniro,1,0.00006,392790,25.16148,1561077
23859,IndieMagic,1,0.00006,392791,25.16154,1561077
23860,indigostar-kr,1,0.00006,392792,25.16160,1561077
23861,INDRANI777,1,0.00006,392793,25.16167,1561077
23862,indrgun,1,0.00006,392794,25.16173,1561077
23863,inesh-kumar,1,0.00006,392795,25.16180,1561077
23864,infa-rbliznet,1,0.00006,392796,25.16186,1561077
23865,InfiniteEcco,1,0.00006,392797,25.16192,1561077
23866,infinityredux,1,0.00006,392798,25.16199,1561077
23867,infl00p,1,0.00006,392799,25.16205,1561077
23868,infoatdfx,1,0.00006,392800,25.16212,1561077
23869,infra-cicd,1,0.00006,392801,25.16218,1561077
23870,ingdany,1,0.00006,392802,25.16224,1561077
23871,ingemar-hn,1,0.00006,392803,25.16231,1561077
23872,ingoman,1,0.00006,392804,25.16237,1561077
23873,ingramvyn,1,0.00006,392805,25.16244,1561077
23874,ingwinlu,1,0.00006,392806,25.16250,1561077
23875,InhexSTER,1,0.00006,392807,25.16256,1561077
23876,inickp,1,0.00006,392808,25.16263,1561077
23877,inmjava,1,0.00006,392809,25.16269,1561077
23878,INRIX-Mark-Gershaft,1,0.00006,392810,25.16276,1561077
23879,insoz,1,0.00006,392811,25.16282,1561077
23880,interasujwal,1,0.00006,392812,25.16288,1561077
23881,intractm,1,0.00006,392813,25.16295,1561077
23882,invartam,1,0.00006,392814,25.16301,1561077
23883,inversion,1,0.00006,392815,25.16308,1561077
23884,iojancode,1,0.00006,392816,25.16314,1561077
23885,ionir-cloud,1,0.00006,392817,25.16320,1561077
23886,ionstormadi,1,0.00006,392818,25.16327,1561077
23887,ionutale,1,0.00006,392819,25.16333,1561077
23888,ionutzaharia,1,0.00006,392820,25.16340,1561077
23889,ipmsteven,1,0.00006,392821,25.16346,1561077
23890,ipolyako,1,0.00006,392822,25.16352,1561077
23891,iponweb-github-admin,1,0.00006,392823,25.16359,1561077
23892,IPO-srh-sloan,1,0.00006,392824,25.16365,1561077
23893,IppX,1,0.00006,392825,25.16372,1561077
23894,ipranavpatel,1,0.00006,392826,25.16378,1561077
23895,ipulyahin,1,0.00006,392827,25.16385,1561077
23896,ipv1337,1,0.00006,392828,25.16391,1561077
23897,ipvinay,1,0.00006,392829,25.16397,1561077
23898,IqbalA2000,1,0.00006,392830,25.16404,1561077
23899,Ira-dovgyalo,1,0.00006,392831,25.16410,1561077
23900,irenazhekova-taulia,1,0.00006,392832,25.16417,1561077
23901,iridiculous,1,0.00006,392833,25.16423,1561077
23902,irishuahua,1,0.00006,392834,25.16429,1561077
23903,IrisPeres,1,0.00006,392835,25.16436,1561077
23904,iRobertas,1,0.00006,392836,25.16442,1561077
23905,IronLung7,1,0.00006,392837,25.16449,1561077
23906,irqus,1,0.00006,392838,25.16455,1561077
23907,irth,1,0.00006,392839,25.16461,1561077
23908,irublev,1,0.00006,392840,25.16468,1561077
23909,Iryna-,1,0.00006,392841,25.16474,1561077
23910,isaacma4,1,0.00006,392842,25.16481,1561077
23911,isairz,1,0.00006,392843,25.16487,1561077
23912,isanketsaha,1,0.00006,392844,25.16493,1561077
23913,isarkis,1,0.00006,392845,25.16500,1561077
23914,isarkisov,1,0.00006,392846,25.16506,1561077
23915,isbdnt,1,0.00006,392847,25.16513,1561077
23916,Ish1984,1,0.00006,392848,25.16519,1561077
23917,ish8758,1,0.00006,392849,25.16525,1561077
23918,IshanBhargava,1,0.00006,392850,25.16532,1561077
23919,ishanm120,1,0.00006,392851,25.16538,1561077
23920,ishara,1,0.00006,392852,25.16545,1561077
23921,IsharaRuchiranga,1,0.00006,392853,25.16551,1561077
23922,ishug86,1,0.00006,392854,25.16557,1561077
23923,ishwar1987,1,0.00006,392855,25.16564,1561077
23924,iSignal,1,0.00006,392856,25.16570,1561077
23925,iskigow,1,0.00006,392857,25.16577,1561077
23926,ISMAELMARTINEZ,1,0.00006,392858,25.16583,1561077
23927,ismarslomic,1,0.00006,392859,25.16590,1561077
23928,IsNoGood,1,0.00006,392860,25.16596,1561077
23929,isntall,1,0.00006,392861,25.16602,1561077
23930,isometry,1,0.00006,392862,25.16609,1561077
23931,isotes,1,0.00006,392863,25.16615,1561077
23932,ISPHOST,1,0.00006,392864,25.16622,1561077
23933,israel-santiago-praxis,1,0.00006,392865,25.16628,1561077
23934,iswing,1,0.00006,392866,25.16634,1561077
23935,it3xl,1,0.00006,392867,25.16641,1561077
23936,itaimalek,1,0.00006,392868,25.16647,1561077
23937,itc-ger,1,0.00006,392869,25.16654,1561077
23938,itdependsnetworks,1,0.00006,392870,25.16660,1561077
23939,iteaguy,1,0.00006,392871,25.16666,1561077
23940,itexto,1,0.00006,392872,25.16673,1561077
23941,itg-ddanielson,1,0.00006,392873,25.16679,1561077
23942,ithuhaiyang,1,0.00006,392874,25.16686,1561077
23943,Itishree143,1,0.00006,392875,25.16692,1561077
23944,Itja,1,0.00006,392876,25.16698,1561077
23945,ITKing80,1,0.00006,392877,25.16705,1561077
23946,it-mak,1,0.00006,392878,25.16711,1561077
23947,itninja-hue,1,0.00006,392879,25.16718,1561077
23948,itrice,1,0.00006,392880,25.16724,1561077
23949,itsmetommy,1,0.00006,392881,25.16730,1561077
23950,itsocialist,1,0.00006,392882,25.16737,1561077
23951,itsovereasy,1,0.00006,392883,25.16743,1561077
23952,itsvit-vlasov-y,1,0.00006,392884,25.16750,1561077
23953,ITSWYoo,1,0.00006,392885,25.16756,1561077
23954,ittner,1,0.00006,392886,25.16762,1561077
23955,iuli72an,1,0.00006,392887,25.16769,1561077
23956,iulian-stana-hs,1,0.00006,392888,25.16775,1561077
23957,iulicapra,1,0.00006,392889,25.16782,1561077
23958,Ivaka,1,0.00006,392890,25.16788,1561077
23959,ivalexey,1,0.00006,392891,25.16794,1561077
23960,ivan-californias,1,0.00006,392892,25.16801,1561077
23961,ivanekPL,1,0.00006,392893,25.16807,1561077
23962,ivan-gomes,1,0.00006,392894,25.16814,1561077
23963,IvanGrund,1,0.00006,392895,25.16820,1561077
23964,IvanJosipovic,1,0.00006,392896,25.16827,1561077
23965,ivankorn,1,0.00006,392897,25.16833,1561077
23966,IvanKostyuk,1,0.00006,392898,25.16839,1561077
23967,ivanovit,1,0.00006,392899,25.16846,1561077
23968,ivan-samartino,1,0.00006,392900,25.16852,1561077
23969,ivantichy,1,0.00006,392901,25.16859,1561077
23970,IVBakker,1,0.00006,392902,25.16865,1561077
23971,ivnet,1,0.00006,392903,25.16871,1561077
23972,ivoferro,1,0.00006,392904,25.16878,1561077
23973,ivorsliide,1,0.00006,392905,25.16884,1561077
23974,ivostoyanov-bc,1,0.00006,392906,25.16891,1561077
23975,ivy-cst,1,0.00006,392907,25.16897,1561077
23976,iwane-pl,1,0.00006,392908,25.16903,1561077
23977,iwelch82,1,0.00006,392909,25.16910,1561077
23978,ixmatus,1,0.00006,392910,25.16916,1561077
23979,iykmode,1,0.00006,392911,25.16923,1561077
23980,iyoucheng,1,0.00006,392912,25.16929,1561077
23981,iz4blue,1,0.00006,392913,25.16935,1561077
23982,izchaki,1,0.00006,392914,25.16942,1561077
23983,j005u,1,0.00006,392915,25.16948,1561077
23984,j123b567,1,0.00006,392916,25.16955,1561077
23985,j796160836,1,0.00006,392917,25.16961,1561077
23986,Jaakkonen,1,0.00006,392918,25.16967,1561077
23987,jaapio,1,0.00006,392919,25.16974,1561077
23988,jabowles,1,0.00006,392920,25.16980,1561077
23989,jacek-debowczyk,1,0.00006,392921,25.16987,1561077
23990,Jaceken,1,0.00006,392922,25.16993,1561077
23991,jacekmarzec,1,0.00006,392923,25.16999,1561077
23992,Jacek-Sniecikowski-A1,1,0.00006,392924,25.17006,1561077
23993,jachstet-sea,1,0.00006,392925,25.17012,1561077
23994,jackjia-ibm,1,0.00006,392926,25.17019,1561077
23995,jacky12,1,0.00006,392927,25.17025,1561077
23996,jackyim1123,1,0.00006,392928,25.17032,1561077
23997,jackyko1991,1,0.00006,392929,25.17038,1561077
23998,jacobbrozenick,1,0.00006,392930,25.17044,1561077
23999,jacobleecd,1,0.00006,392931,25.17051,1561077
24000,jacobnollette,1,0.00006,392932,25.17057,1561077
24001,jacobwoffenden,1,0.00006,392933,25.17064,1561077
24002,Jacq,1,0.00006,392934,25.17070,1561077
24003,jadepeng,1,0.00006,392935,25.17076,1561077
24004,jafartaghiyar,1,0.00006,392936,25.17083,1561077
24005,Jaff,1,0.00006,392937,25.17089,1561077
24006,jaffog,1,0.00006,392938,25.17096,1561077
24007,Jagadeesh213,1,0.00006,392939,25.17102,1561077
24008,jagatheesanr,1,0.00006,392940,25.17108,1561077
24009,jaggernod,1,0.00006,392941,25.17115,1561077
24010,jahanzaibasharat,1,0.00006,392942,25.17121,1561077
24011,jahidfazal,1,0.00006,392943,25.17128,1561077
24012,Jahidul2543,1,0.00006,392944,25.17134,1561077
24013,jaildigger,1,0.00006,392945,25.17140,1561077
24014,jaimemasson,1,0.00006,392946,25.17147,1561077
24015,JaimePata,1,0.00006,392947,25.17153,1561077
24016,jainankit,1,0.00006,392948,25.17160,1561077
24017,jainvikas088,1,0.00006,392949,25.17166,1561077
24018,jakeab,1,0.00006,392950,25.17172,1561077
24019,jakehelme,1,0.00006,392951,25.17179,1561077
24020,jakepetroules,1,0.00006,392952,25.17185,1561077
24021,jake-rh,1,0.00006,392953,25.17192,1561077
24022,jakern,1,0.00006,392954,25.17198,1561077
24023,Jakkob,1,0.00006,392955,25.17204,1561077
24024,jakovistuk,1,0.00006,392956,25.17211,1561077
24025,jakubmichalec,1,0.00006,392957,25.17217,1561077
24026,JakubMucha,1,0.00006,392958,25.17224,1561077
24027,jakubpawlowski,1,0.00006,392959,25.17230,1561077
24028,jakubriegel,1,0.00006,392960,25.17236,1561077
24029,jakwarrior,1,0.00006,392961,25.17243,1561077
24030,Jalict,1,0.00006,392962,25.17249,1561077
24031,jaltek,1,0.00006,392963,25.17256,1561077
24032,jamalkm,1,0.00006,392964,25.17262,1561077
24033,jamandbees,1,0.00006,392965,25.17269,1561077
24034,jamcel,1,0.00006,392966,25.17275,1561077
24035,james5233,1,0.00006,392967,25.17281,1561077
24036,james75,1,0.00006,392968,25.17288,1561077
24037,jamesamurr-bind,1,0.00006,392969,25.17294,1561077
24038,jameschingtelus,1,0.00006,392970,25.17301,1561077
24039,jamescrowley321,1,0.00006,392971,25.17307,1561077
24040,jamesdh,1,0.00006,392972,25.17313,1561077
24041,jamesdmorgan,1,0.00006,392973,25.17320,1561077
24042,JamesHesterJr,1,0.00006,392974,25.17326,1561077
24043,james-hobbs,1,0.00006,392975,25.17333,1561077
24044,jameshwc,1,0.00006,392976,25.17339,1561077
24045,jamesj2,1,0.00006,392977,25.17345,1561077
24046,jameslaspada,1,0.00006,392978,25.17352,1561077
24047,JamesLiAndroid,1,0.00006,392979,25.17358,1561077
24048,jamesliudotcc,1,0.00006,392980,25.17365,1561077
24049,JamesMc86,1,0.00006,392981,25.17371,1561077
24050,JamesMorDigi,1,0.00006,392982,25.17377,1561077
24051,jamesongithub,1,0.00006,392983,25.17384,1561077
24052,jamesonjlee,1,0.00006,392984,25.17390,1561077
24053,JamesRItchie88,1,0.00006,392985,25.17397,1561077
24054,jamesrobson-pio,1,0.00006,392986,25.17403,1561077
24055,JamesUoM,1,0.00006,392987,25.17409,1561077
24056,jamesvl,1,0.00006,392988,25.17416,1561077
24057,james-woods,1,0.00006,392989,25.17422,1561077
24058,jamesz2011,1,0.00006,392990,25.17429,1561077
24059,jameszz001,1,0.00006,392991,25.17435,1561077
24060,jamfdevops,1,0.00006,392992,25.17441,1561077
24061,jamgood96,1,0.00006,392993,25.17448,1561077
24062,jamie-sparked,1,0.00006,392994,25.17454,1561077
24063,jamiethermo,1,0.00006,392995,25.17461,1561077
24064,JamieWithofsPXL,1,0.00006,392996,25.17467,1561077
24065,jamischarles,1,0.00006,392997,25.17474,1561077
24066,Jamjardavies,1,0.00006,392998,25.17480,1561077
24067,jammiefbl,1,0.00006,392999,25.17486,1561077
24068,jammurp,1,0.00006,393000,25.17493,1561077
24069,janasrikanth,1,0.00006,393001,25.17499,1561077
24070,jandrad,1,0.00006,393002,25.17506,1561077
24071,jandry,1,0.00006,393003,25.17512,1561077
24072,janekbordo,1,0.00006,393004,25.17518,1561077
24073,jane-prowler,1,0.00006,393005,25.17525,1561077
24074,janerikcarlsen,1,0.00006,393006,25.17531,1561077
24075,JangGyeongSik,1,0.00006,393007,25.17538,1561077
24076,Janhouse,1,0.00006,393008,25.17544,1561077
24077,janhurst,1,0.00006,393009,25.17550,1561077
24078,janickr,1,0.00006,393010,25.17557,1561077
24079,jankatins,1,0.00006,393011,25.17563,1561077
24080,Janmm14,1,0.00006,393012,25.17570,1561077
24081,JanoschDeurer,1,0.00006,393013,25.17576,1561077
24082,janpolito,1,0.00006,393014,25.17582,1561077
24083,janschultze,1,0.00006,393015,25.17589,1561077
24084,janseeger,1,0.00006,393016,25.17595,1561077
24085,jan-sh,1,0.00006,393017,25.17602,1561077
24086,jan-stoltman-bolt,1,0.00006,393018,25.17608,1561077
24087,janwendt,1,0.00006,393019,25.17614,1561077
24088,jan-xyz,1,0.00006,393020,25.17621,1561077
24089,JAPRESSLEY,1,0.00006,393021,25.17627,1561077
24090,jarahul1209,1,0.00006,393022,25.17634,1561077
24091,jaraujoduarte,1,0.00006,393023,25.17640,1561077
24092,J-Are,1,0.00006,393024,25.17646,1561077
24093,Jared-Prime,1,0.00006,393025,25.17653,1561077
24094,jaredready,1,0.00006,393026,25.17659,1561077
24095,JarekFaruga,1,0.00006,393027,25.17666,1561077
24096,jarias-lfx,1,0.00006,393028,25.17672,1561077
24097,jarmo-kauko,1,0.00006,393029,25.17679,1561077
24098,jaronpeloton,1,0.00006,393030,25.17685,1561077
24099,jarrekk,1,0.00006,393031,25.17691,1561077
24100,jarrodspiga,1,0.00006,393032,25.17698,1561077
24101,jarst,1,0.00006,393033,25.17704,1561077
24102,jaryn,1,0.00006,393034,25.17711,1561077
24103,jasalmeron,1,0.00006,393035,25.17717,1561077
24104,jasek,1,0.00006,393036,25.17723,1561077
24105,jasel-lewis,1,0.00006,393037,25.17730,1561077
24106,jasgeo75,1,0.00006,393038,25.17736,1561077
24107,jasjeetkaur2211,1,0.00006,393039,25.17743,1561077
24108,jason69sinclaire,1,0.00006,393040,25.17749,1561077
24109,Jason733i,1,0.00006,393041,25.17755,1561077
24110,jasonaowen,1,0.00006,393042,25.17762,1561077
24111,jasonbking,1,0.00006,393043,25.17768,1561077
24112,jasonbrianhall,1,0.00006,393044,25.17775,1561077
24113,jasonchen2010,1,0.00006,393045,25.17781,1561077
24114,jasoncwa,1,0.00006,393046,25.17787,1561077
24115,jason-deland,1,0.00006,393047,25.17794,1561077
24116,Jasonf1977,1,0.00006,393048,25.17800,1561077
24117,jasonfield,1,0.00006,393049,25.17807,1561077
24118,JasonGowthorpe,1,0.00006,393050,25.17813,1561077
24119,JasonKDarby,1,0.00006,393051,25.17819,1561077
24120,jasonlee529,1,0.00006,393052,25.17826,1561077
24121,Jasonparrish,1,0.00006,393053,25.17832,1561077
24122,jasooonko,1,0.00006,393054,25.17839,1561077
24123,jasperla,1,0.00006,393055,25.17845,1561077
24124,jasquat,1,0.00006,393056,25.17851,1561077
24125,Jas-Script,1,0.00006,393057,25.17858,1561077
24126,jastabile,1,0.00006,393058,25.17864,1561077
24127,jaumard,1,0.00006,393059,25.17871,1561077
24128,jaunusa,1,0.00006,393060,25.17877,1561077
24129,Java1Guy,1,0.00006,393061,25.17883,1561077
24130,java4africa,1,0.00006,393062,25.17890,1561077
24131,Java4all,1,0.00006,393063,25.17896,1561077
24132,JavanEu,1,0.00006,393064,25.17903,1561077
24133,JavaUnchained,1,0.00006,393065,25.17909,1561077
24134,javax-swing,1,0.00006,393066,25.17916,1561077
24135,javeden,1,0.00006,393067,25.17922,1561077
24136,JaviBite,1,0.00006,393068,25.17928,1561077
24137,javier2419,1,0.00006,393069,25.17935,1561077
24138,javierlga,1,0.00006,393070,25.17941,1561077
24139,javiersanp,1,0.00006,393071,25.17948,1561077
24140,javrasya,1,0.00006,393072,25.17954,1561077
24141,JawadMalikComcast,1,0.00006,393073,25.17960,1561077
24142,jawadrehman,1,0.00006,393074,25.17967,1561077
24143,jawebada,1,0.00006,393075,25.17973,1561077
24144,jayarampoojari11,1,0.00006,393076,25.17980,1561077
24145,jaybauson,1,0.00006,393077,25.17986,1561077
24146,jaydattd,1,0.00006,393078,25.17992,1561077
24147,jaydp17,1,0.00006,393079,25.17999,1561077
24148,Jaykah,1,0.00006,393080,25.18005,1561077
24149,jaylinski,1,0.00006,393081,25.18012,1561077
24150,JaymonYang,1,0.00006,393082,25.18018,1561077
24151,jayniz,1,0.00006,393083,25.18024,1561077
24152,jaysirju,1,0.00006,393084,25.18031,1561077
24153,jayspang,1,0.00006,393085,25.18037,1561077
24154,jay-w-jensen,1,0.00006,393086,25.18044,1561077
24155,Jaywoods2,1,0.00006,393087,25.18050,1561077
24156,jazreal,1,0.00006,393088,25.18056,1561077
24157,jazza72,1,0.00006,393089,25.18063,1561077
24158,jazzbeaux59,1,0.00006,393090,25.18069,1561077
24159,jazzycamel,1,0.00006,393091,25.18076,1561077
24160,jb-2020,1,0.00006,393092,25.18082,1561077
24161,jb31890,1,0.00006,393093,25.18088,1561077
24162,jbarker4682,1,0.00006,393094,25.18095,1561077
24163,jbartece,1,0.00006,393095,25.18101,1561077
24164,jbasila,1,0.00006,393096,25.18108,1561077
24165,Jbekker,1,0.00006,393097,25.18114,1561077
24166,jbentler,1,0.00006,393098,25.18121,1561077
24167,jbeorse,1,0.00006,393099,25.18127,1561077
24168,jbeutin,1,0.00006,393100,25.18133,1561077
24169,jbisabel,1,0.00006,393101,25.18140,1561077
24170,jbkomo,1,0.00006,393102,25.18146,1561077
24171,Jblack881,1,0.00006,393103,25.18153,1561077
24172,jbliznak,1,0.00006,393104,25.18159,1561077
24173,jbmestelan,1,0.00006,393105,25.18165,1561077
24174,JBodkin-LH,1,0.00006,393106,25.18172,1561077
24175,jboffel,1,0.00006,393107,25.18178,1561077
24176,jbrantly,1,0.00006,393108,25.18185,1561077
24177,jbravo,1,0.00006,393109,25.18191,1561077
24178,jbrinksmeier,1,0.00006,393110,25.18197,1561077
24179,jbruinink,1,0.00006,393111,25.18204,1561077
24180,jbyibm,1,0.00006,393112,25.18210,1561077
24181,jc21,1,0.00006,393113,25.18217,1561077
24182,jcabelloc,1,0.00006,393114,25.18223,1561077
24183,jcamerin,1,0.00006,393115,25.18229,1561077
24184,jcastor,1,0.00006,393116,25.18236,1561077
24185,jcatta,1,0.00006,393117,25.18242,1561077
24186,JCEmmons,1,0.00006,393118,25.18249,1561077
24187,jcharier,1,0.00006,393119,25.18255,1561077
24188,JChrist,1,0.00006,393120,25.18261,1561077
24189,jcicchella,1,0.00006,393121,25.18268,1561077
24190,JcKlomp,1,0.00006,393122,25.18274,1561077
24191,jclinto1,1,0.00006,393123,25.18281,1561077
24192,jcmendez-guerrero,1,0.00006,393124,25.18287,1561077
24193,jcmmv00,1,0.00006,393125,25.18293,1561077
24194,jcompagner,1,0.00006,393126,25.18300,1561077
24195,jcormier,1,0.00006,393127,25.18306,1561077
24196,jcploucha,1,0.00006,393128,25.18313,1561077
24197,jcuevaso,1,0.00006,393129,25.18319,1561077
24198,jcuzens,1,0.00006,393130,25.18325,1561077
24199,jdall,1,0.00006,393131,25.18332,1561077
24200,jdamasceno,1,0.00006,393132,25.18338,1561077
24201,jdamme,1,0.00006,393133,25.18345,1561077
24202,jdassonvil,1,0.00006,393134,25.18351,1561077
24203,jdbandoni,1,0.00006,393135,25.18358,1561077
24204,jdcskillet,1,0.00006,393136,25.18364,1561077
24205,jdelStrother,1,0.00006,393137,25.18370,1561077
24206,jdftapi,1,0.00006,393138,25.18377,1561077
24207,jdgood,1,0.00006,393139,25.18383,1561077
24208,jdjamsa1,1,0.00006,393140,25.18390,1561077
24209,jdmc562,1,0.00006,393141,25.18396,1561077
24210,jdonaldson10,1,0.00006,393142,25.18402,1561077
24211,jdrosensweig,1,0.00006,393143,25.18409,1561077
24212,jdsalchow,1,0.00006,393144,25.18415,1561077
24213,jdstapleton,1,0.00006,393145,25.18422,1561077
24214,jdussouillez,1,0.00006,393146,25.18428,1561077
24215,JEBoothjr,1,0.00006,393147,25.18434,1561077
24216,jedallado,1,0.00006,393148,25.18441,1561077
24217,jedrekdomanski,1,0.00006,393149,25.18447,1561077
24218,jeeook,1,0.00006,393150,25.18454,1561077
24219,jeetendra-choudhary,1,0.00006,393151,25.18460,1561077
24220,jeff1326,1,0.00006,393152,25.18466,1561077
24221,jeffchan,1,0.00006,393153,25.18473,1561077
24222,jeffdlee715,1,0.00006,393154,25.18479,1561077
24223,Jeffery-L,1,0.00006,393155,25.18486,1561077
24224,JEFF-GINSBERG,1,0.00006,393156,25.18492,1561077
24225,jeffjk-me,1,0.00006,393157,25.18498,1561077
24226,jeffmartinxyz,1,0.00006,393158,25.18505,1561077
24227,JeffreyJamesMMM,1,0.00006,393159,25.18511,1561077
24228,jeffsigmon,1,0.00006,393160,25.18518,1561077
24229,Jeff-Symphony,1,0.00006,393161,25.18524,1561077
24230,Jeff-Tian,1,0.00006,393162,25.18530,1561077
24231,jehadkalifah,1,0.00006,393163,25.18537,1561077
24232,Jehan8,1,0.00006,393164,25.18543,1561077
24233,jehugaleahsa,1,0.00006,393165,25.18550,1561077
24234,jeinstei,1,0.00006,393166,25.18556,1561077
24235,jejohns,1,0.00006,393167,25.18563,1561077
24236,jekamilene,1,0.00006,393168,25.18569,1561077
24237,jekhardt,1,0.00006,393169,25.18575,1561077
24238,jelly972,1,0.00006,393170,25.18582,1561077
24239,jelyman2,1,0.00006,393171,25.18588,1561077
24240,jenkins2-drivenets,1,0.00006,393172,25.18595,1561077
24241,jenkinsclub,1,0.00006,393173,25.18601,1561077
24242,jenkinsim,1,0.00006,393174,25.18607,1561077
24243,JenkinsMoin,1,0.00006,393175,25.18614,1561077
24244,JenkinsWEF,1,0.00006,393176,25.18620,1561077
24245,jenkinsxgit,1,0.00006,393177,25.18627,1561077
24246,jenkinsx-glide-mvp,1,0.00006,393178,25.18633,1561077
24247,jennings,1,0.00006,393179,25.18639,1561077
24248,j-enny,1,0.00006,393180,25.18646,1561077
24249,jensmaurer,1,0.00006,393181,25.18652,1561077
24250,jensneubauer,1,0.00006,393182,25.18659,1561077
24251,jensolsson,1,0.00006,393183,25.18665,1561077
24252,JensRestemeier,1,0.00006,393184,25.18671,1561077
24253,jenssaade,1,0.00006,393185,25.18678,1561077
24254,jep,1,0.00006,393186,25.18684,1561077
24255,jepperson2,1,0.00006,393187,25.18691,1561077
24256,jeremycarroll,1,0.00006,393188,25.18697,1561077
24257,jeremychauvet,1,0.00006,393189,25.18703,1561077
24258,jeremycornett,1,0.00006,393190,25.18710,1561077
24259,Jeremygarden,1,0.00006,393191,25.18716,1561077
24260,JeremyHutchings,1,0.00006,393192,25.18723,1561077
24261,jeremyjensen3,1,0.00006,393193,25.18729,1561077
24262,jeremymasters,1,0.00006,393194,25.18735,1561077
24263,jeremystewart85,1,0.00006,393195,25.18742,1561077
24264,jerinka,1,0.00006,393196,25.18748,1561077
24265,jeritiana,1,0.00006,393197,25.18755,1561077
24266,jeroen92,1,0.00006,393198,25.18761,1561077
24267,jeroenlandheer,1,0.00006,393199,25.18767,1561077
24268,JeronimoColonSP,1,0.00006,393200,25.18774,1561077
24269,jerr,1,0.00006,393201,25.18780,1561077
24270,jerrypnorman,1,0.00006,393202,25.18787,1561077
24271,jerrywei116,1,0.00006,393203,25.18793,1561077
24272,jervie-vitriolo,1,0.00006,393204,25.18800,1561077
24273,jescholl,1,0.00006,393205,25.18806,1561077
24274,jess8147,1,0.00006,393206,25.18812,1561077
24275,jessebs,1,0.00006,393207,25.18819,1561077
24276,jessecooper,1,0.00006,393208,25.18825,1561077
24277,jessegeens,1,0.00006,393209,25.18832,1561077
24278,jesseluo,1,0.00006,393210,25.18838,1561077
24279,jessicafarias,1,0.00006,393211,25.18844,1561077
24280,JESUSANSWERS777,1,0.00006,393212,25.18851,1561077
24281,jeveleth,1,0.00006,393213,25.18857,1561077
24282,jewelsjacobs,1,0.00006,393214,25.18864,1561077
24283,jewes,1,0.00006,393215,25.18870,1561077
24284,JeySee3,1,0.00006,393216,25.18876,1561077
24285,jezovuk,1,0.00006,393217,25.18883,1561077
24286,jfcarp,1,0.00006,393218,25.18889,1561077
24287,jferna57,1,0.00006,393219,25.18896,1561077
24288,jfindlay,1,0.00006,393220,25.18902,1561077
24289,jflow,1,0.00006,393221,25.18908,1561077
24290,jfougere,1,0.00006,393222,25.18915,1561077
24291,jfpdazey,1,0.00006,393223,25.18921,1561077
24292,jfquinto,1,0.00006,393224,25.18928,1561077
24293,jfranzoi-gucci,1,0.00006,393225,25.18934,1561077
24294,jfrederick,1,0.00006,393226,25.18940,1561077
24295,jfrederickson,1,0.00006,393227,25.18947,1561077
24296,jfyne,1,0.00006,393228,25.18953,1561077
24297,jgbiii,1,0.00006,393229,25.18960,1561077
24298,Jgerardopine,1,0.00006,393230,25.18966,1561077
24299,jgibbarduk,1,0.00006,393231,25.18972,1561077
24300,jglobant,1,0.00006,393232,25.18979,1561077
24301,jgrasett,1,0.00006,393233,25.18985,1561077
24302,jh125486,1,0.00006,393234,25.18992,1561077
24303,jhagedev,1,0.00006,393235,25.18998,1561077
24304,jhaumont,1,0.00006,393236,25.19005,1561077
24305,JHBalaji,1,0.00006,393237,25.19011,1561077
24306,jhcasco,1,0.00006,393238,25.19017,1561077
24307,jhd147350,1,0.00006,393239,25.19024,1561077
24308,jheilgeist,1,0.00006,393240,25.19030,1561077
24309,jhelmer-unicon,1,0.00006,393241,25.19037,1561077
24310,jhensley,1,0.00006,393242,25.19043,1561077
24311,jheydebrand,1,0.00006,393243,25.19049,1561077
24312,jhilburnsds,1,0.00006,393244,25.19056,1561077
24313,jhoffland,1,0.00006,393245,25.19062,1561077
24314,jhonalexander0809,1,0.00006,393246,25.19069,1561077
24315,jhonata-santos,1,0.00006,393247,25.19075,1561077
24316,jhonissouza-ignite,1,0.00006,393248,25.19081,1561077
24317,jhonsamson47,1,0.00006,393249,25.19088,1561077
24318,jhosemar-caylent,1,0.00006,393250,25.19094,1561077
24319,jhrabi,1,0.00006,393251,25.19101,1561077
24320,JH-scourse,1,0.00006,393252,25.19107,1561077
24321,jhseong,1,0.00006,393253,25.19113,1561077
24322,jhull123,1,0.00006,393254,25.19120,1561077
24323,jiahuifu,1,0.00006,393255,25.19126,1561077
24324,jialindai,1,0.00006,393256,25.19133,1561077
24325,JiangGuangxing,1,0.00006,393257,25.19139,1561077
24326,jiangkaijian,1,0.00006,393258,25.19145,1561077
24327,JianleiZhang,1,0.00006,393259,25.19152,1561077
24328,Jiaweizdev,1,0.00006,393260,25.19158,1561077
24329,jiaxinonly,1,0.00006,393261,25.19165,1561077
24330,jibsonline,1,0.00006,393262,25.19171,1561077
24331,JiElPe-Fr38,1,0.00006,393263,25.19177,1561077
24332,jiinoksoo,1,0.00006,393264,25.19184,1561077
24333,jijojosephin,1,0.00006,393265,25.19190,1561077
24334,jikl2001,1,0.00006,393266,25.19197,1561077
24335,jikuja,1,0.00006,393267,25.19203,1561077
24336,jim4067,1,0.00006,393268,25.19209,1561077
24337,jimarasim,1,0.00006,393269,25.19216,1561077
24338,jimbomed,1,0.00006,393270,25.19222,1561077
24339,jimdumont,1,0.00006,393271,25.19229,1561077
24340,jim-kirisame,1,0.00006,393272,25.19235,1561077
24341,jimklo,1,0.00006,393273,25.19242,1561077
24342,jimman88,1,0.00006,393274,25.19248,1561077
24343,jimmod,1,0.00006,393275,25.19254,1561077
24344,jimmy-chow,1,0.00006,393276,25.19261,1561077
24345,jimmyherreraGL,1,0.00006,393277,25.19267,1561077
24346,jimmyjudas,1,0.00006,393278,25.19274,1561077
24347,Jimmyscene,1,0.00006,393279,25.19280,1561077
24348,jimmythedog,1,0.00006,393280,25.19286,1561077
24349,jimmyw,1,0.00006,393281,25.19293,1561077
24350,jimolina,1,0.00006,393282,25.19299,1561077
24351,jimpriest,1,0.00006,393283,25.19306,1561077
24352,jimrippon,1,0.00006,393284,25.19312,1561077
24353,jimsears,1,0.00006,393285,25.19318,1561077
24354,jimthemighty,1,0.00006,393286,25.19325,1561077
24355,jimtut,1,0.00006,393287,25.19331,1561077
24356,jinagamvasubabu,1,0.00006,393288,25.19338,1561077
24357,jineshqa,1,0.00006,393289,25.19344,1561077
24358,jinfang134,1,0.00006,393290,25.19350,1561077
24359,jingjingzip,1,0.00006,393291,25.19357,1561077
24360,jinh574,1,0.00006,393292,25.19363,1561077
24361,jinnthegeek,1,0.00006,393293,25.19370,1561077
24362,JinpaLhawang,1,0.00006,393294,25.19376,1561077
24363,JinShibao,1,0.00006,393295,25.19382,1561077
24364,jinyulin,1,0.00006,393296,25.19389,1561077
24365,JIoJIaJIu,1,0.00006,393297,25.19395,1561077
24366,jishh,1,0.00006,393298,25.19402,1561077
24367,jishwinxavier,1,0.00006,393299,25.19408,1561077
24368,jitendrakhedar,1,0.00006,393300,25.19414,1561077
24369,jitun2004,1,0.00006,393301,25.19421,1561077
24370,jitzpop,1,0.00006,393302,25.19427,1561077
24371,jivk,1,0.00006,393303,25.19434,1561077
24372,JiXuefeng,1,0.00006,393304,25.19440,1561077
24373,jiyongseong,1,0.00006,393305,25.19447,1561077
24374,jj522,1,0.00006,393306,25.19453,1561077
24375,JJettenCIC,1,0.00006,393307,25.19459,1561077
24376,jjh999,1,0.00006,393308,25.19466,1561077
24377,jjj11x,1,0.00006,393309,25.19472,1561077
24378,jjmastro,1,0.00006,393310,25.19479,1561077
24379,jjmiv,1,0.00006,393311,25.19485,1561077
24380,jjoewy,1,0.00006,393312,25.19491,1561077
24381,jjshoe,1,0.00006,393313,25.19498,1561077
24382,jk563,1,0.00006,393314,25.19504,1561077
24383,jkarns87,1,0.00006,393315,25.19511,1561077
24384,jkattmann,1,0.00006,393316,25.19517,1561077
24385,jkdeveyra,1,0.00006,393317,25.19523,1561077
24386,jkdihenkar,1,0.00006,393318,25.19530,1561077
24387,jkee-r7,1,0.00006,393319,25.19536,1561077
24388,jkennedy1980,1,0.00006,393320,25.19543,1561077
24389,jkobus,1,0.00006,393321,25.19549,1561077
24390,jkoncel,1,0.00006,393322,25.19555,1561077
24391,jkonecny12,1,0.00006,393323,25.19562,1561077
24392,jkopcsek,1,0.00006,393324,25.19568,1561077
24393,jkusa,1,0.00006,393325,25.19575,1561077
24394,jlact,1,0.00006,393326,25.19581,1561077
24395,jlaiho,1,0.00006,393327,25.19587,1561077
24396,jlambov,1,0.00006,393328,25.19594,1561077
24397,jlambrechts,1,0.00006,393329,25.19600,1561077
24398,jlarocque88,1,0.00006,393330,25.19607,1561077
24399,jlcvp,1,0.00006,393331,25.19613,1561077
24400,jlczuk,1,0.00006,393332,25.19619,1561077
24401,jleclanche,1,0.00006,393333,25.19626,1561077
24402,jlegido,1,0.00006,393334,25.19632,1561077
24403,jlipps,1,0.00006,393335,25.19639,1561077
24404,jljouannic,1,0.00006,393336,25.19645,1561077
24405,jlo88,1,0.00006,393337,25.19651,1561077
24406,jlombardo29,1,0.00006,393338,25.19658,1561077
24407,jloneva,1,0.00006,393339,25.19664,1561077
24408,jlpogue3,1,0.00006,393340,25.19671,1561077
24409,jlussagnet,1,0.00006,393341,25.19677,1561077
24410,jlyons18,1,0.00006,393342,25.19684,1561077
24411,JM00oo,1,0.00006,393343,25.19690,1561077
24412,jmalkiewicz,1,0.00006,393344,25.19696,1561077
24413,jmatthis,1,0.00006,393345,25.19703,1561077
24414,jmbmxer,1,0.00006,393346,25.19709,1561077
24415,jmbowman,1,0.00006,393347,25.19716,1561077
24416,jmcardon,1,0.00006,393348,25.19722,1561077
24417,jmcastellote,1,0.00006,393349,25.19728,1561077
24418,jmcfallargo,1,0.00006,393350,25.19735,1561077
24419,jmcgarr,1,0.00006,393351,25.19741,1561077
24420,jmcubel,1,0.00006,393352,25.19748,1561077
24421,jmdcal,1,0.00006,393353,25.19754,1561077
24422,jmdelros,1,0.00006,393354,25.19760,1561077
24423,jmdingess,1,0.00006,393355,25.19767,1561077
24424,jmeit-fwdsec,1,0.00006,393356,25.19773,1561077
24425,jmewes,1,0.00006,393357,25.19780,1561077
24426,Jmingzi,1,0.00006,393358,25.19786,1561077
24427,jmiserez,1,0.00006,393359,25.19792,1561077
24428,jmk61,1,0.00006,393360,25.19799,1561077
24429,jmontanari,1,0.00006,393361,25.19805,1561077
24430,jmorille,1,0.00006,393362,25.19812,1561077
24431,jmoscato,1,0.00006,393363,25.19818,1561077
24432,jmp0xf,1,0.00006,393364,25.19824,1561077
24433,jmsanchez,1,0.00006,393365,25.19831,1561077
24434,jmslagle,1,0.00006,393366,25.19837,1561077
24435,jmStrickl,1,0.00006,393367,25.19844,1561077
24436,jmtbusiness,1,0.00006,393368,25.19850,1561077
24437,jmunozco,1,0.00006,393369,25.19856,1561077
24438,JMVM,1,0.00006,393370,25.19863,1561077
24439,jnalley,1,0.00006,393371,25.19869,1561077
24440,Jnchk,1,0.00006,393372,25.19876,1561077
24441,jnicol31,1,0.00006,393373,25.19882,1561077
24442,jniebuhr,1,0.00006,393374,25.19889,1561077
24443,jniemin,1,0.00006,393375,25.19895,1561077
24444,Jnnybrrn,1,0.00006,393376,25.19901,1561077
24445,jnorthcott,1,0.00006,393377,25.19908,1561077
24446,jnt2007,1,0.00006,393378,25.19914,1561077
24447,jnzamith,1,0.00006,393379,25.19921,1561077
24448,joachimroeleveld,1,0.00006,393380,25.19927,1561077
24449,joancafom,1,0.00006,393381,25.19933,1561077
24450,joandyiglesias,1,0.00006,393382,25.19940,1561077
24451,joannbrereton,1,0.00006,393383,25.19946,1561077
24452,joantune,1,0.00006,393384,25.19953,1561077
24453,joaoamaro-vakt,1,0.00006,393385,25.19959,1561077
24454,joaocarlossousa,1,0.00006,393386,25.19965,1561077
24455,JoaoGFarias,1,0.00006,393387,25.19972,1561077
24456,joaoguazzelli,1,0.00006,393388,25.19978,1561077
24457,JoaoPedroFerreira,1,0.00006,393389,25.19985,1561077
24458,joaosamuelp,1,0.00006,393390,25.19991,1561077
24459,JoaoVitoGomes,1,0.00006,393391,25.19997,1561077
24460,joaquinroldan,1,0.00006,393392,25.20004,1561077
24461,joastoe,1,0.00006,393393,25.20010,1561077
24462,jobevers,1,0.00006,393394,25.20017,1561077
24463,job-lukasz,1,0.00006,393395,25.20023,1561077
24464,jobrienTC,1,0.00006,393396,25.20029,1561077
24465,joby-h20,1,0.00006,393397,25.20036,1561077
24466,JocceNilsson,1,0.00006,393398,25.20042,1561077
24467,jocelynduc,1,0.00006,393399,25.20049,1561077
24468,jochenchrist,1,0.00006,393400,25.20055,1561077
24469,JochenHayek,1,0.00006,393401,25.20061,1561077
24470,jodok,1,0.00006,393402,25.20068,1561077
24471,joe733,1,0.00006,393403,25.20074,1561077
24472,joedenniss,1,0.00006,393404,25.20081,1561077
24473,joedimarzio,1,0.00006,393405,25.20087,1561077
24474,joelbricker,1,0.00006,393406,25.20093,1561077
24475,joelio,1,0.00006,393407,25.20100,1561077
24476,joeljeske,1,0.00006,393408,25.20106,1561077
24477,joelneubert,1,0.00006,393409,25.20113,1561077
24478,joelsonoda,1,0.00006,393410,25.20119,1561077
24479,joeltorby,1,0.00006,393411,25.20126,1561077
24480,joelynch,1,0.00006,393412,25.20132,1561077
24481,joerg-wille,1,0.00006,393413,25.20138,1561077
24482,joesaunderson,1,0.00006,393414,25.20145,1561077
24483,joeshannon,1,0.00006,393415,25.20151,1561077
24484,joesus,1,0.00006,393416,25.20158,1561077
24485,joeydong,1,0.00006,393417,25.20164,1561077
24486,JoeyG1973,1,0.00006,393418,25.20170,1561077
24487,JoeyJGarcia,1,0.00006,393419,25.20177,1561077
24488,joey-jonko-paypal,1,0.00006,393420,25.20183,1561077
24489,Joeylulu,1,0.00006,393421,25.20190,1561077
24490,joeywang2020,1,0.00006,393422,25.20196,1561077
24491,JoeyX-u,1,0.00006,393423,25.20202,1561077
24492,joffutt4,1,0.00006,393424,25.20209,1561077
24493,johan974,1,0.00006,393425,25.20215,1561077
24494,johankayati2019,1,0.00006,393426,25.20222,1561077
24495,JohannaVarga,1,0.00006,393427,25.20228,1561077
24496,johannesacco,1,0.00006,393428,25.20234,1561077
24497,johannespostler,1,0.00006,393429,25.20241,1561077
24498,johanrydstrom,1,0.00006,393430,25.20247,1561077
24499,johgr814,1,0.00006,393431,25.20254,1561077
24500,johlym,1,0.00006,393432,25.20260,1561077
24501,johnaohara,1,0.00006,393433,25.20266,1561077
24502,JohnAtComtech,1,0.00006,393434,25.20273,1561077
24503,john-auden,1,0.00006,393435,25.20279,1561077
24504,johnbayo,1,0.00006,393436,25.20286,1561077
24505,johnboscor,1,0.00006,393437,25.20292,1561077
24506,johncavanaugh,1,0.00006,393438,25.20298,1561077
24507,JohnDittmar,1,0.00006,393439,25.20305,1561077
24508,johnf,1,0.00006,393440,25.20311,1561077
24509,johngregg,1,0.00006,393441,25.20318,1561077
24510,Johnibur,1,0.00006,393442,25.20324,1561077
24511,johnjeffers,1,0.00006,393443,25.20331,1561077
24512,johnkarpn,1,0.00006,393444,25.20337,1561077
24513,johnk-novu,1,0.00006,393445,25.20343,1561077
24514,johnkzin,1,0.00006,393446,25.20350,1561077
24515,JohnLahr,1,0.00006,393447,25.20356,1561077
24516,johnmannix,1,0.00006,393448,25.20363,1561077
24517,JohnMarley,1,0.00006,393449,25.20369,1561077
24518,johnmj,1,0.00006,393450,25.20375,1561077
24519,johnnieskywalker,1,0.00006,393451,25.20382,1561077
24520,JohnnyChiang,1,0.00006,393452,25.20388,1561077
24521,Johnny-Martinez,1,0.00006,393453,25.20395,1561077
24522,johnnyrun,1,0.00006,393454,25.20401,1561077
24523,johnnyzhaoo,1,0.00006,393455,25.20407,1561077
24524,Johnogram,1,0.00006,393456,25.20414,1561077
24525,johnpbloch,1,0.00006,393457,25.20420,1561077
24526,john-shaskin,1,0.00006,393458,25.20427,1561077
24527,johnsheehan,1,0.00006,393459,25.20433,1561077
24528,johnsonexosite,1,0.00006,393460,25.20439,1561077
24529,johnstarmer,1,0.00006,393461,25.20446,1561077
24530,JohnStratoudakis,1,0.00006,393462,25.20452,1561077
24531,johnswu,1,0.00006,393463,25.20459,1561077
24532,johnwalker247,1,0.00006,393464,25.20465,1561077
24533,johnwbyrd,1,0.00006,393465,25.20471,1561077
24534,johnyzed,1,0.00006,393466,25.20478,1561077
24535,jojand,1,0.00006,393467,25.20484,1561077
24536,jojjezlatansson,1,0.00006,393468,25.20491,1561077
24537,jojo221119,1,0.00006,393469,25.20497,1561077
24538,Jojo255,1,0.00006,393470,25.20503,1561077
24539,joker1,1,0.00006,393471,25.20510,1561077
24540,Joker-DW,1,0.00006,393472,25.20516,1561077
24541,jolivier23,1,0.00006,393473,25.20523,1561077
24542,jolt23,1,0.00006,393474,25.20529,1561077
24543,jonashaag,1,0.00006,393475,25.20536,1561077
24544,JonasHornung,1,0.00006,393476,25.20542,1561077
24545,jonasliekens,1,0.00006,393477,25.20548,1561077
24546,jonasmkarlsson,1,0.00006,393478,25.20555,1561077
24547,Jonas-vdb,1,0.00006,393479,25.20561,1561077
24548,jonathanappel,1,0.00006,393480,25.20568,1561077
24549,Jonathanboliveira,1,0.00006,393481,25.20574,1561077
24550,jonathancolby-olx,1,0.00006,393482,25.20580,1561077
24551,JonathanHallKJR,1,0.00006,393483,25.20587,1561077
24552,JonathanKershaw,1,0.00006,393484,25.20593,1561077
24553,jonathanmorley,1,0.00006,393485,25.20600,1561077
24554,JonathanRRogers,1,0.00006,393486,25.20606,1561077
24555,jonbuck16,1,0.00006,393487,25.20612,1561077
24556,jondeandres,1,0.00006,393488,25.20619,1561077
24557,jondhoor,1,0.00006,393489,25.20625,1561077
24558,JonHodgson,1,0.00006,393490,25.20632,1561077
24559,jonni83,1,0.00006,393491,25.20638,1561077
24560,jonny7,1,0.00006,393492,25.20644,1561077
24561,JonnyBarthow,1,0.00006,393493,25.20651,1561077
24562,jonnygrm,1,0.00006,393494,25.20657,1561077
24563,jonnyhsu,1,0.00006,393495,25.20664,1561077
24564,jononu,1,0.00006,393496,25.20670,1561077
24565,jonschreiber,1,0.00006,393497,25.20676,1561077
24566,jonstacks13,1,0.00006,393498,25.20683,1561077
24567,jontro,1,0.00006,393499,25.20689,1561077
24568,jontwo,1,0.00006,393500,25.20696,1561077
24569,joonaspessi,1,0.00006,393501,25.20702,1561077
24570,Joon-S,1,0.00006,393502,25.20708,1561077
24571,Jooones,1,0.00006,393503,25.20715,1561077
24572,joprice,1,0.00006,393504,25.20721,1561077
24573,jordanandres1,1,0.00006,393505,25.20728,1561077
24574,jordanbailes,1,0.00006,393506,25.20734,1561077
24575,jordanffs,1,0.00006,393507,25.20740,1561077
24576,jordansimonovski,1,0.00006,393508,25.20747,1561077
24577,jordburns,1,0.00006,393509,25.20753,1561077
24578,jordiAtING,1,0.00006,393510,25.20760,1561077
24579,jordimolesblanco,1,0.00006,393511,25.20766,1561077
24580,jordirovira,1,0.00006,393512,25.20773,1561077
24581,jorgebo10,1,0.00006,393513,25.20779,1561077
24582,jorgehc03,1,0.00006,393514,25.20785,1561077
24583,Jorgesmash,1,0.00006,393515,25.20792,1561077
24584,jorhett,1,0.00006,393516,25.20798,1561077
24585,jorwalk,1,0.00006,393517,25.20805,1561077
24586,josacu,1,0.00006,393518,25.20811,1561077
24587,josebenitez681,1,0.00006,393519,25.20817,1561077
24588,josedesousa,1,0.00006,393520,25.20824,1561077
24589,josefloressv,1,0.00006,393521,25.20830,1561077
24590,josefsalyer,1,0.00006,393522,25.20837,1561077
24591,josefwells,1,0.00006,393523,25.20843,1561077
24592,jose-hernandez2,1,0.00006,393524,25.20849,1561077
24593,josejsarmento,1,0.00006,393525,25.20856,1561077
24594,josephaxisa,1,0.00006,393526,25.20862,1561077
24595,josephearl,1,0.00006,393527,25.20869,1561077
24596,josephmc5,1,0.00006,393528,25.20875,1561077
24597,JosephWitthuhnTR,1,0.00006,393529,25.20881,1561077
24598,josephyeager,1,0.00006,393530,25.20888,1561077
24599,josephzilberman,1,0.00006,393531,25.20894,1561077
24600,JosersRu,1,0.00006,393532,25.20901,1561077
24601,joshadambell,1,0.00006,393533,25.20907,1561077
24602,joshbohde,1,0.00006,393534,25.20913,1561077
24603,joshbrw,1,0.00006,393535,25.20920,1561077
24604,JoshCoady,1,0.00006,393536,25.20926,1561077
24605,joshcurago,1,0.00006,393537,25.20933,1561077
24606,joshdcox,1,0.00006,393538,25.20939,1561077
24607,joshdk,1,0.00006,393539,25.20945,1561077
24608,Josh-Dutton,1,0.00006,393540,25.20952,1561077
24609,joshfridgen,1,0.00006,393541,25.20958,1561077
24610,joshight,1,0.00006,393542,25.20965,1561077
24611,joshiparth1000,1,0.00006,393543,25.20971,1561077
24612,joshk132,1,0.00006,393544,25.20978,1561077
24613,joshlong,1,0.00006,393545,25.20984,1561077
24614,joshm1,1,0.00006,393546,25.20990,1561077
24615,joshmanderson,1,0.00006,393547,25.20997,1561077
24616,joshmello,1,0.00006,393548,25.21003,1561077
24617,joshmullis,1,0.00006,393549,25.21010,1561077
24618,joshmyers,1,0.00006,393550,25.21016,1561077
24619,joshrabinowitz,1,0.00006,393551,25.21022,1561077
24620,JoshStutts,1,0.00006,393552,25.21029,1561077
24621,josh-tepper-clarifai,1,0.00006,393553,25.21035,1561077
24622,joshua5201,1,0.00006,393554,25.21042,1561077
24623,Joshua-Beha,1,0.00006,393555,25.21048,1561077
24624,Joshuacordova,1,0.00006,393556,25.21054,1561077
24625,joshua-d-miller,1,0.00006,393557,25.21061,1561077
24626,joshua-jandyco,1,0.00006,393558,25.21067,1561077
24627,joshua-s,1,0.00006,393559,25.21074,1561077
24628,joshua-seals,1,0.00006,393560,25.21080,1561077
24629,JOSivtoft,1,0.00006,393561,25.21086,1561077
24630,joskfg,1,0.00006,393562,25.21093,1561077
24631,josqu4red,1,0.00006,393563,25.21099,1561077
24632,jossemarGT,1,0.00006,393564,25.21106,1561077
24633,jotomo,1,0.00006,393565,25.21112,1561077
24634,jotterbot,1,0.00006,393566,25.21118,1561077
24635,joulrone,1,0.00006,393567,25.21125,1561077
24636,jovianinc,1,0.00006,393568,25.21131,1561077
24637,joxford-soltech,1,0.00006,393569,25.21138,1561077
24638,joxoby,1,0.00006,393570,25.21144,1561077
24639,joyjitpal100,1,0.00006,393571,25.21150,1561077
24640,JozoVilcek,1,0.00006,393572,25.21157,1561077
24641,jozuenoon,1,0.00006,393573,25.21163,1561077
24642,JP3BGY,1,0.00006,393574,25.21170,1561077
24643,JP69745,1,0.00006,393575,25.21176,1561077
24644,JPalmerGithub,1,0.00006,393576,25.21182,1561077
24645,jpappe,1,0.00006,393577,25.21189,1561077
24646,jpavlav,1,0.00006,393578,25.21195,1561077
24647,jpbottinelli,1,0.00006,393579,25.21202,1561077
24648,jpdesigndev,1,0.00006,393580,25.21208,1561077
24649,jpedro,1,0.00006,393581,25.21215,1561077
24650,jperkin,1,0.00006,393582,25.21221,1561077
24651,JPGibart,1,0.00006,393583,25.21227,1561077
24652,JPGrieb,1,0.00006,393584,25.21234,1561077
24653,jphautin,1,0.00006,393585,25.21240,1561077
24654,jphaws,1,0.00006,393586,25.21247,1561077
24655,jpilgrim,1,0.00006,393587,25.21253,1561077
24656,jpinsonault,1,0.00006,393588,25.21259,1561077
24657,JPLemelin,1,0.00006,393589,25.21266,1561077
24658,jplimack,1,0.00006,393590,25.21272,1561077
24659,jplower,1,0.00006,393591,25.21279,1561077
24660,jpmontez,1,0.00006,393592,25.21285,1561077
24661,JPocalyko-REISys,1,0.00006,393593,25.21291,1561077
24662,JPS40,1,0.00006,393594,25.21298,1561077
24663,jpshields,1,0.00006,393595,25.21304,1561077
24664,jpsilvagallino,1,0.00006,393596,25.21311,1561077
24665,jpuffen,1,0.00006,393597,25.21317,1561077
24666,jpushkar,1,0.00006,393598,25.21323,1561077
24667,jpvalencia04,1,0.00006,393599,25.21330,1561077
24668,jpvandervelden,1,0.00006,393600,25.21336,1561077
24669,jpvee,1,0.00006,393601,25.21343,1561077
24670,jpyams,1,0.00006,393602,25.21349,1561077
24671,jquast,1,0.00006,393603,25.21355,1561077
24672,jquejad-bdb,1,0.00006,393604,25.21362,1561077
24673,jquinc30,1,0.00006,393605,25.21368,1561077
24674,jrab66,1,0.00006,393606,25.21375,1561077
24675,jralonso,1,0.00006,393607,25.21381,1561077
24676,jramosf,1,0.00006,393608,25.21387,1561077
24677,jrasillo,1,0.00006,393609,25.21394,1561077
24678,jreijn,1,0.00006,393610,25.21400,1561077
24679,jreuben11,1,0.00006,393611,25.21407,1561077
24680,JRLesser,1,0.00006,393612,25.21413,1561077
24681,jRom42,1,0.00006,393613,25.21420,1561077
24682,jrominesf,1,0.00006,393614,25.21426,1561077
24683,jroylance,1,0.00006,393615,25.21432,1561077
24684,jrpally,1,0.00006,393616,25.21439,1561077
24685,jrpedrianes,1,0.00006,393617,25.21445,1561077
24686,jrsaravanan,1,0.00006,393618,25.21452,1561077
24687,jrsen,1,0.00006,393619,25.21458,1561077
24688,jrtheinert,1,0.00006,393620,25.21464,1561077
24689,jsaintyv,1,0.00006,393621,25.21471,1561077
24690,jsalatiel,1,0.00006,393622,25.21477,1561077
24691,jsanchezramos,1,0.00006,393623,25.21484,1561077
24692,jsbarber-emis,1,0.00006,393624,25.21490,1561077
24693,jschneider,1,0.00006,393625,25.21496,1561077
24694,jschoedt,1,0.00006,393626,25.21503,1561077
24695,jschroed91,1,0.00006,393627,25.21509,1561077
24696,jsearby,1,0.00006,393628,25.21516,1561077
24697,jsearles57,1,0.00006,393629,25.21522,1561077
24698,jshbrntt,1,0.00006,393630,25.21528,1561077
24699,jshier,1,0.00006,393631,25.21535,1561077
24700,jshthornton,1,0.00006,393632,25.21541,1561077
24701,jsight,1,0.00006,393633,25.21548,1561077
24702,jsjzh,1,0.00006,393634,25.21554,1561077
24703,jskov-jyskebank-dk,1,0.00006,393635,25.21560,1561077
24704,jsloth,1,0.00006,393636,25.21567,1561077
24705,jsmimi,1,0.00006,393637,25.21573,1561077
24706,jsnmc,1,0.00006,393638,25.21580,1561077
24707,JSoet,1,0.00006,393639,25.21586,1561077
24708,jspam,1,0.00006,393640,25.21592,1561077
24709,jspiro,1,0.00006,393641,25.21599,1561077
24710,jspitzen,1,0.00006,393642,25.21605,1561077
24711,jssnirmal,1,0.00006,393643,25.21612,1561077
24712,jstallm,1,0.00006,393644,25.21618,1561077
24713,jstenquist,1,0.00006,393645,25.21624,1561077
24714,jstolp,1,0.00006,393646,25.21631,1561077
24715,jsuag,1,0.00006,393647,25.21637,1561077
24716,JTarball,1,0.00006,393648,25.21644,1561077
24717,jtflint19,1,0.00006,393649,25.21650,1561077
24718,jtgrohn,1,0.00006,393650,25.21657,1561077
24719,jtmoree-kahalamgmt-com,1,0.00006,393651,25.21663,1561077
24720,Jtramey,1,0.00006,393652,25.21669,1561077
24721,jtrmal,1,0.00006,393653,25.21676,1561077
24722,JTSimmons,1,0.00006,393654,25.21682,1561077
24723,jtuttle,1,0.00006,393655,25.21689,1561077
24724,juan199,1,0.00006,393656,25.21695,1561077
24725,juanbrein,1,0.00006,393657,25.21701,1561077
24726,juancarloscruz,1,0.00006,393658,25.21708,1561077
24727,Juandavi1,1,0.00006,393659,25.21714,1561077
24728,juanecabellob,1,0.00006,393660,25.21721,1561077
24729,juanignaciociriaco,1,0.00006,393661,25.21727,1561077
24730,juanjosebesa,1,0.00006,393662,25.21733,1561077
24731,JuanMakeCo,1,0.00006,393663,25.21740,1561077
24732,juanse417,1,0.00006,393664,25.21746,1561077
24733,juanyang,1,0.00006,393665,25.21753,1561077
24734,juba895,1,0.00006,393666,25.21759,1561077
24735,judezhu,1,0.00006,393667,25.21765,1561077
24736,judofyr,1,0.00006,393668,25.21772,1561077
24737,judos,1,0.00006,393669,25.21778,1561077
24738,JuergenSimon,1,0.00006,393670,25.21785,1561077
24739,JuergenZimmer,1,0.00006,393671,25.21791,1561077
24740,juexun,1,0.00006,393672,25.21797,1561077
24741,jugalps,1,0.00006,393673,25.21804,1561077
24742,juggernaut76,1,0.00006,393674,25.21810,1561077
24743,jugggao,1,0.00006,393675,25.21817,1561077
24744,jugu,1,0.00006,393676,25.21823,1561077
24745,JugurthaT,1,0.00006,393677,25.21829,1561077
24746,jug-workshop-2013,1,0.00006,393678,25.21836,1561077
24747,juhovan,1,0.00006,393679,25.21842,1561077
24748,jujardhabarwala,1,0.00006,393680,25.21849,1561077
24749,juju2great,1,0.00006,393681,25.21855,1561077
24750,JukieWalsh,1,0.00006,393682,25.21862,1561077
24751,JukkaForsgren,1,0.00006,393683,25.21868,1561077
24752,jukov,1,0.00006,393684,25.21874,1561077
24753,julia3,1,0.00006,393685,25.21881,1561077
24754,JuliaFerdus,1,0.00006,393686,25.21887,1561077
24755,julianatienza,1,0.00006,393687,25.21894,1561077
24756,juliangrosshauser,1,0.00006,393688,25.21900,1561077
24757,JulianUO,1,0.00006,393689,25.21906,1561077
24758,JulianVoelkel,1,0.00006,393690,25.21913,1561077
24759,julien3,1,0.00006,393691,25.21919,1561077
24760,julien-carsique-sonarsource,1,0.00006,393692,25.21926,1561077
24761,julienje,1,0.00006,393693,25.21932,1561077
24762,juliensap1,1,0.00006,393694,25.21938,1561077
24763,julimej,1,0.00006,393695,25.21945,1561077
24764,juliofalbo,1,0.00006,393696,25.21951,1561077
24765,juliogonzalez,1,0.00006,393697,25.21958,1561077
24766,julio-rivera,1,0.00006,393698,25.21964,1561077
24767,juliusspencer,1,0.00006,393699,25.21970,1561077
24768,jumashev,1,0.00006,393700,25.21977,1561077
24769,jumois,1,0.00006,393701,25.21983,1561077
24770,jumping,1,0.00006,393702,25.21990,1561077
24771,jun87lam,1,0.00006,393703,25.21996,1561077
24772,junandaip,1,0.00006,393704,25.22002,1561077
24773,junior-ales,1,0.00006,393705,25.22009,1561077
24774,Junkratz,1,0.00006,393706,25.22015,1561077
24775,junpengl,1,0.00006,393707,25.22022,1561077
24776,junseok-l2,1,0.00006,393708,25.22028,1561077
24777,junshanxu,1,0.00006,393709,25.22034,1561077
24778,junsionzhang,1,0.00006,393710,25.22041,1561077
24779,junsulee,1,0.00006,393711,25.22047,1561077
24780,Juntaran,1,0.00006,393712,25.22054,1561077
24781,junxinzhang,1,0.00006,393713,25.22060,1561077
24782,jupeter,1,0.00006,393714,25.22066,1561077
24783,Jurawa,1,0.00006,393715,25.22073,1561077
24784,jurenovic,1,0.00006,393716,25.22079,1561077
24785,juris-kreilis,1,0.00006,393717,25.22086,1561077
24786,jusene,1,0.00006,393718,25.22092,1561077
24787,justahole,1,0.00006,393719,25.22099,1561077
24788,JustinGuese,1,0.00006,393720,25.22105,1561077
24789,justinm,1,0.00006,393721,25.22111,1561077
24790,justinzelinsky,1,0.00006,393722,25.22118,1561077
24791,justpolidor,1,0.00006,393723,25.22124,1561077
24792,JuulRoelofs,1,0.00006,393724,25.22131,1561077
24793,Juvat,1,0.00006,393725,25.22137,1561077
24794,jvallon1,1,0.00006,393726,25.22143,1561077
24795,jvalters,1,0.00006,393727,25.22150,1561077
24796,jvarela01,1,0.00006,393728,25.22156,1561077
24797,jvdlaar,1,0.00006,393729,25.22163,1561077
24798,jvdvTechno,1,0.00006,393730,25.22169,1561077
24799,jveldboom,1,0.00006,393731,25.22175,1561077
24800,jverkoey,1,0.00006,393732,25.22182,1561077
24801,jvignolainc,1,0.00006,393733,25.22188,1561077
24802,jvitorinoj,1,0.00006,393734,25.22195,1561077
24803,jvperrin,1,0.00006,393735,25.22201,1561077
24804,jvtrigueros,1,0.00006,393736,25.22207,1561077
24805,jw99324,1,0.00006,393737,25.22214,1561077
24806,j-walker23,1,0.00006,393738,25.22220,1561077
24807,jwalter,1,0.00006,393739,25.22227,1561077
24808,jwarden,1,0.00006,393740,25.22233,1561077
24809,jwbrandon,1,0.00006,393741,25.22239,1561077
24810,jweaver-personal,1,0.00006,393742,25.22246,1561077
24811,jweibel22,1,0.00006,393743,25.22252,1561077
24812,JWesorick,1,0.00006,393744,25.22259,1561077
24813,jweyrich,1,0.00006,393745,25.22265,1561077
24814,jwjanssen90,1,0.00006,393746,25.22271,1561077
24815,jwoehrle,1,0.00006,393747,25.22278,1561077
24816,jwwk,1,0.00006,393748,25.22284,1561077
24817,jwyoungpm,1,0.00006,393749,25.22291,1561077
24818,jxramos,1,0.00006,393750,25.22297,1561077
24819,jyothibasuk,1,0.00006,393751,25.22304,1561077
24820,Jyothi-Prakash,1,0.00006,393752,25.22310,1561077
24821,Jyoti050402,1,0.00006,393753,25.22316,1561077
24822,JyotirmoyVS,1,0.00006,393754,25.22323,1561077
24823,jyppy,1,0.00006,393755,25.22329,1561077
24824,jzakrzewski,1,0.00006,393756,25.22336,1561077
24825,jzee,1,0.00006,393757,25.22342,1561077
24826,jzhang10-atl,1,0.00006,393758,25.22348,1561077
24827,jzuniga184,1,0.00006,393759,25.22355,1561077
24828,jzy3d,1,0.00006,393760,25.22361,1561077
24829,k801030,1,0.00006,393761,25.22368,1561077
24830,k8s42,1,0.00006,393762,25.22374,1561077
24831,k9ert,1,0.00006,393763,25.22380,1561077
24832,k9nz00,1,0.00006,393764,25.22387,1561077
24833,Kaatjie,1,0.00006,393765,25.22393,1561077
24834,kacpersaw,1,0.00006,393766,25.22400,1561077
24835,kadauber,1,0.00006,393767,25.22406,1561077
24836,kad-hollac1,1,0.00006,393768,25.22412,1561077
24837,kadirselcuk,1,0.00006,393769,25.22419,1561077
24838,kad-kooija,1,0.00006,393770,25.22425,1561077
24839,kad-kostej,1,0.00006,393771,25.22432,1561077
24840,kadryomar,1,0.00006,393772,25.22438,1561077
24841,kadzu,1,0.00006,393773,25.22444,1561077
24842,kaendfinger,1,0.00006,393774,25.22451,1561077
24843,KaeseToBa,1,0.00006,393775,25.22457,1561077
24844,kafka-kowl,1,0.00006,393776,25.22464,1561077
24845,kafka-kowl-admin,1,0.00006,393777,25.22470,1561077
24846,kagarlickij,1,0.00006,393778,25.22476,1561077
24847,kageurufu,1,0.00006,393779,25.22483,1561077
24848,kahayes,1,0.00006,393780,25.22489,1561077
24849,kai0,1,0.00006,393781,25.22496,1561077
24850,KaibutsuX,1,0.00006,393782,25.22502,1561077
24851,kaihenzler,1,0.00006,393783,25.22508,1561077
24852,kaihowl,1,0.00006,393784,25.22515,1561077
24853,kaijparo,1,0.00006,393785,25.22521,1561077
24854,kaimelis,1,0.00006,393786,25.22528,1561077
24855,KaiNahrgang,1,0.00006,393787,25.22534,1561077
24856,kainswor,1,0.00006,393788,25.22541,1561077
24857,kairaazure,1,0.00006,393789,25.22547,1561077
24858,kaizimmerm,1,0.00006,393790,25.22553,1561077
24859,kajabfab,1,0.00006,393791,25.22560,1561077
24860,kakastg,1,0.00006,393792,25.22566,1561077
24861,kalahari,1,0.00006,393793,25.22573,1561077
24862,kalaiarasan231,1,0.00006,393794,25.22579,1561077
24863,kalaiganeshan,1,0.00006,393795,25.22585,1561077
24864,kalidina,1,0.00006,393796,25.22592,1561077
24865,kalihman,1,0.00006,393797,25.22598,1561077
24866,kalimera8764,1,0.00006,393798,25.22605,1561077
24867,kalioz,1,0.00006,393799,25.22611,1561077
24868,kalsky,1,0.00006,393800,25.22617,1561077
24869,kalw,1,0.00006,393801,25.22624,1561077
24870,KalyanAkella,1,0.00006,393802,25.22630,1561077
24871,KamalAman,1,0.00006,393803,25.22637,1561077
24872,kamal-kaur04,1,0.00006,393804,25.22643,1561077
24873,kamaltherocky,1,0.00006,393805,25.22649,1561077
24874,kamalvdm,1,0.00006,393806,25.22656,1561077
24875,kambles,1,0.00006,393807,25.22662,1561077
24876,kamieniarzk,1,0.00006,393808,25.22669,1561077
24877,kamil1014,1,0.00006,393809,25.22675,1561077
24878,Kamilcuk,1,0.00006,393810,25.22681,1561077
24879,kamilic,1,0.00006,393811,25.22688,1561077
24880,KamilWalczak-TomTom,1,0.00006,393812,25.22694,1561077
24881,kamilzajacdeviniti,1,0.00006,393813,25.22701,1561077
24882,kamisetty1995,1,0.00006,393814,25.22707,1561077
24883,kamrajshahapure,1,0.00006,393815,25.22713,1561077
24884,k-Anastasiya,1,0.00006,393816,25.22720,1561077
24885,kaneg,1,0.00006,393817,25.22726,1561077
24886,kanezch,1,0.00006,393818,25.22733,1561077
24887,Kannan1015,1,0.00006,393819,25.22739,1561077
24888,Kannanmj,1,0.00006,393820,25.22746,1561077
24889,KantarBruceAdams,1,0.00006,393821,25.22752,1561077
24890,kanth1222,1,0.00006,393822,25.22758,1561077
24891,kanton10062006,1,0.00006,393823,25.22765,1561077
24892,kanuku,1,0.00006,393824,25.22771,1561077
24893,kaotika,1,0.00006,393825,25.22778,1561077
24894,kapi,1,0.00006,393826,25.22784,1561077
24895,kapil111999,1,0.00006,393827,25.22790,1561077
24896,kapildaksh,1,0.00006,393828,25.22797,1561077
24897,kaplanitay,1,0.00006,393829,25.22803,1561077
24898,kapomaho,1,0.00006,393830,25.22810,1561077
24899,kapoorsunny,1,0.00006,393831,25.22816,1561077
24900,kappacrafter,1,0.00006,393832,25.22822,1561077
24901,kara91770,1,0.00006,393833,25.22829,1561077
24902,karangarg218,1,0.00006,393834,25.22835,1561077
24903,karanjain71,1,0.00006,393835,25.22842,1561077
24904,karankh,1,0.00006,393836,25.22848,1561077
24905,karanp24,1,0.00006,393837,25.22854,1561077
24906,karapish,1,0.00006,393838,25.22861,1561077
24907,kareemmahmoudb,1,0.00006,393839,25.22867,1561077
24908,karenrfay,1,0.00006,393840,25.22874,1561077
24909,kariem,1,0.00006,393841,25.22880,1561077
24910,karikalanbalachandran,1,0.00006,393842,25.22886,1561077
24911,karimMourra,1,0.00006,393843,25.22893,1561077
24912,kariudo,1,0.00006,393844,25.22899,1561077
24913,karl18,1,0.00006,393845,25.22906,1561077
24914,karlazzam,1,0.00006,393846,25.22912,1561077
24915,Karl-br,1,0.00006,393847,25.22918,1561077
24916,karlhe,1,0.00006,393848,25.22925,1561077
24917,karlhendrik,1,0.00006,393849,25.22931,1561077
24918,karlins,1,0.00006,393850,25.22938,1561077
24919,KarloWilfredoVelasquez,1,0.00006,393851,25.22944,1561077
24920,karlp,1,0.00006,393852,25.22951,1561077
24921,karmacoma-eth,1,0.00006,393853,25.22957,1561077
24922,karnatinaresh,1,0.00006,393854,25.22963,1561077
24923,Karnich,1,0.00006,393855,25.22970,1561077
24924,Karoid,1,0.00006,393856,25.22976,1561077
24925,Karol3500,1,0.00006,393857,25.22983,1561077
24926,karreddy,1,0.00006,393858,25.22989,1561077
24927,kartheeofficial,1,0.00006,393859,25.22995,1561077
24928,karthick4kumaran,1,0.00006,393860,25.23002,1561077
24929,karthickcv,1,0.00006,393861,25.23008,1561077
24930,karthikeyan68,1,0.00006,393862,25.23015,1561077
24931,karthikeyan-malaisamy,1,0.00006,393863,25.23021,1561077
24932,karthikkbaalaji,1,0.00006,393864,25.23027,1561077
24933,karthikkumarkp,1,0.00006,393865,25.23034,1561077
24934,karthikpaidi,1,0.00006,393866,25.23040,1561077
24935,karthikpost,1,0.00006,393867,25.23047,1561077
24936,kartik1200,1,0.00006,393868,25.23053,1561077
24937,Kartinkin,1,0.00006,393869,25.23059,1561077
24938,karume,1,0.00006,393870,25.23066,1561077
24939,karunakar960,1,0.00006,393871,25.23072,1561077
24940,Karynn,1,0.00006,393872,25.23079,1561077
24941,Kasama,1,0.00006,393873,25.23085,1561077
24942,kashano,1,0.00006,393874,25.23091,1561077
24943,kashiif,1,0.00006,393875,25.23098,1561077
24944,kashjs,1,0.00006,393876,25.23104,1561077
24945,kasinskim,1,0.00006,393877,25.23111,1561077
24946,kassner,1,0.00006,393878,25.23117,1561077
24947,kataggart,1,0.00006,393879,25.23123,1561077
24948,katerberg,1,0.00006,393880,25.23130,1561077
24949,kateyy,1,0.00006,393881,25.23136,1561077
24950,katie291100,1,0.00006,393882,25.23143,1561077
24951,katiesapede,1,0.00006,393883,25.23149,1561077
24952,katonica,1,0.00006,393884,25.23155,1561077
24953,Katsz,1,0.00006,393885,25.23162,1561077
24954,katzdm,1,0.00006,393886,25.23168,1561077
24955,kaushalpanjwani,1,0.00006,393887,25.23175,1561077
24956,kaushi90,1,0.00006,393888,25.23181,1561077
24957,kaustubhd93,1,0.00006,393889,25.23188,1561077
24958,kavalerchik,1,0.00006,393890,25.23194,1561077
24959,kave,1,0.00006,393891,25.23200,1561077
24960,kavita1205,1,0.00006,393892,25.23207,1561077
24961,kavmaria,1,0.00006,393893,25.23213,1561077
24962,KAWALMEET-SINGH,1,0.00006,393894,25.23220,1561077
24963,kayabendroth,1,0.00006,393895,25.23226,1561077
24964,kayabendroth-epages,1,0.00006,393896,25.23232,1561077
24965,KayaLukenIncapptic,1,0.00006,393897,25.23239,1561077
24966,kayhiangtan,1,0.00006,393898,25.23245,1561077
24967,kaykay88,1,0.00006,393899,25.23252,1561077
24968,kay-ramme,1,0.00006,393900,25.23258,1561077
24969,Kazylla,1,0.00006,393901,25.23264,1561077
24970,Kazzer,1,0.00006,393902,25.23271,1561077
24971,kbakk,1,0.00006,393903,25.23277,1561077
24972,kbd4hire,1,0.00006,393904,25.23284,1561077
24973,kbhuvanamohan,1,0.00006,393905,25.23290,1561077
24974,kbokh,1,0.00006,393906,25.23296,1561077
24975,kbristow,1,0.00006,393907,25.23303,1561077
24976,kbthomp1,1,0.00006,393908,25.23309,1561077
24977,kbudke,1,0.00006,393909,25.23316,1561077
24978,kcacciatore,1,0.00006,393910,25.23322,1561077
24979,kchenhal,1,0.00006,393911,25.23328,1561077
24980,kchowhan,1,0.00006,393912,25.23335,1561077
24981,Kchymet,1,0.00006,393913,25.23341,1561077
24982,kcormier,1,0.00006,393914,25.23348,1561077
24983,kcsmalls,1,0.00006,393915,25.23354,1561077
24984,KD4,1,0.00006,393916,25.23360,1561077
24985,kdeenanauth,1,0.00006,393917,25.23367,1561077
24986,kdftest,1,0.00006,393918,25.23373,1561077
24987,kdopen,1,0.00006,393919,25.23380,1561077
24988,kdougl,1,0.00006,393920,25.23386,1561077
24989,kdrnaik24,1,0.00006,393921,25.23393,1561077
24990,kdsnice,1,0.00006,393922,25.23399,1561077
24991,kdubrovnyi,1,0.00006,393923,25.23405,1561077
24992,kdykeman,1,0.00006,393924,25.23412,1561077
24993,keatontaylor,1,0.00006,393925,25.23418,1561077
24994,kedziorm,1,0.00006,393926,25.23425,1561077
24995,keefbaker,1,0.00006,393927,25.23431,1561077
24996,keep2iron,1,0.00006,393928,25.23437,1561077
24997,keerthikorivi,1,0.00006,393929,25.23444,1561077
24998,keesj,1,0.00006,393930,25.23450,1561077
24999,keilw,1,0.00006,393931,25.23457,1561077
25000,keithzg,1,0.00006,393932,25.23463,1561077
25001,kekbait,1,0.00006,393933,25.23469,1561077
25002,kekcogen,1,0.00006,393934,25.23476,1561077
25003,kelberg-r,1,0.00006,393935,25.23482,1561077
25004,KellerII,1,0.00006,393936,25.23489,1561077
25005,kellyellery,1,0.00006,393937,25.23495,1561077
25006,kelp404,1,0.00006,393938,25.23501,1561077
25007,kelseyq,1,0.00006,393939,25.23508,1561077
25008,kemmemha,1,0.00006,393940,25.23514,1561077
25009,ken210,1,0.00006,393941,25.23521,1561077
25010,kenankule,1,0.00006,393942,25.23527,1561077
25011,KenanSulayman,1,0.00006,393943,25.23533,1561077
25012,kencoenen,1,0.00006,393944,25.23540,1561077
25013,KenDJohnson,1,0.00006,393945,25.23546,1561077
25014,kenguest,1,0.00006,393946,25.23553,1561077
25015,kenhosr,1,0.00006,393947,25.23559,1561077
25016,KenjiDeguchi,1,0.00006,393948,25.23565,1561077
25017,kenjiuno,1,0.00006,393949,25.23572,1561077
25018,Ken-LiuL,1,0.00006,393950,25.23578,1561077
25019,kennethmyers,1,0.00006,393951,25.23585,1561077
25020,kennethrithvik,1,0.00006,393952,25.23591,1561077
25021,kennetn,1,0.00006,393953,25.23597,1561077
25022,Kenny2Go,1,0.00006,393954,25.23604,1561077
25023,kennydee,1,0.00006,393955,25.23610,1561077
25024,kennylopez,1,0.00006,393956,25.23617,1561077
25025,kenplusplus,1,0.00006,393957,25.23623,1561077
25026,KenProle,1,0.00006,393958,25.23630,1561077
25027,kenshi90,1,0.00006,393959,25.23636,1561077
25028,kenstime,1,0.00006,393960,25.23642,1561077
25029,kentoj,1,0.00006,393961,25.23649,1561077
25030,kenttannady,1,0.00006,393962,25.23655,1561077
25031,kenwoodjw,1,0.00006,393963,25.23662,1561077
25032,kenzliang,1,0.00006,393964,25.23668,1561077
25033,kepler2-seakr,1,0.00006,393965,25.23674,1561077
25034,kerber,1,0.00006,393966,25.23681,1561077
25035,kerenyit,1,0.00006,393967,25.23687,1561077
25036,keriati,1,0.00006,393968,25.23694,1561077
25037,kerk1v,1,0.00006,393969,25.23700,1561077
25038,kermek,1,0.00006,393970,25.23706,1561077
25039,keroro6,1,0.00006,393971,25.23713,1561077
25040,kerrykimbrough,1,0.00006,393972,25.23719,1561077
25041,kerschy,1,0.00006,393973,25.23726,1561077
25042,kerwenzhang,1,0.00006,393974,25.23732,1561077
25043,kesavkolla,1,0.00006,393975,25.23738,1561077
25044,keshavprasadms,1,0.00006,393976,25.23745,1561077
25045,Kesin11,1,0.00006,393977,25.23751,1561077
25046,kespinola,1,0.00006,393978,25.23758,1561077
25047,kespinosa05,1,0.00006,393979,25.23764,1561077
25048,ketangangal,1,0.00006,393980,25.23770,1561077
25049,ketank-new,1,0.00006,393981,25.23777,1561077
25050,kev111,1,0.00006,393982,25.23783,1561077
25051,kevin0x90,1,0.00006,393983,25.23790,1561077
25052,KevinBoyette,1,0.00006,393984,25.23796,1561077
25053,kevinburkemeter,1,0.00006,393985,25.23802,1561077
25054,kevinchabreck,1,0.00006,393986,25.23809,1561077
25055,KevinColbert,1,0.00006,393987,25.23815,1561077
25056,KevinDMack,1,0.00006,393988,25.23822,1561077
25057,kevinfait,1,0.00006,393989,25.23828,1561077
25058,kevinisback,1,0.00006,393990,25.23835,1561077
25059,Kevin-Jobst,1,0.00006,393991,25.23841,1561077
25060,kevin-j-smith,1,0.00006,393992,25.23847,1561077
25061,kevinkrol,1,0.00006,393993,25.23854,1561077
25062,kevinleturc,1,0.00006,393994,25.23860,1561077
25063,kevinlondon,1,0.00006,393995,25.23867,1561077
25064,kevinnoel-be,1,0.00006,393996,25.23873,1561077
25065,KevinOlsthoorn,1,0.00006,393997,25.23879,1561077
25066,kevin-wimmer,1,0.00006,393998,25.23886,1561077
25067,keviny22,1,0.00006,393999,25.23892,1561077
25068,kewubenduben,1,0.00006,394000,25.23899,1561077
25069,keyboardsurfer,1,0.00006,394001,25.23905,1561077
25070,keydam,1,0.00006,394002,25.23911,1561077
25071,keyotik,1,0.00006,394003,25.23918,1561077
25072,kf3in,1,0.00006,394004,25.23924,1561077
25073,k-fish,1,0.00006,394005,25.23931,1561077
25074,kf-jstatz,1,0.00006,394006,25.23937,1561077
25075,kfreidank,1,0.00006,394007,25.23943,1561077
25076,kgaitanos,1,0.00006,394008,25.23950,1561077
25077,kgancarz0,1,0.00006,394009,25.23956,1561077
25078,kgrubb,1,0.00006,394010,25.23963,1561077
25079,kguelzau,1,0.00006,394011,25.23969,1561077
25080,Khaeyel,1,0.00006,394012,25.23975,1561077
25081,khalidkayode,1,0.00006,394013,25.23982,1561077
25082,KharanKnight,1,0.00006,394014,25.23988,1561077
25083,Kharibin,1,0.00006,394015,25.23995,1561077
25084,khasinski,1,0.00006,394016,25.24001,1561077
25085,khatiwadanaresh,1,0.00006,394017,25.24007,1561077
25086,kheaactua,1,0.00006,394018,25.24014,1561077
25087,khobbits,1,0.00006,394019,25.24020,1561077
25088,khomyakov42,1,0.00006,394020,25.24027,1561077
25089,KhrisL,1,0.00006,394021,25.24033,1561077
25090,kh-sonrai,1,0.00006,394022,25.24039,1561077
25091,khurdz,1,0.00006,394023,25.24046,1561077
25092,khushil,1,0.00006,394024,25.24052,1561077
25093,kiaz-github,1,0.00006,394025,25.24059,1561077
25094,Kib1967,1,0.00006,394026,25.24065,1561077
25095,kibumh,1,0.00006,394027,25.24072,1561077
25096,kiddouk,1,0.00006,394028,25.24078,1561077
25097,kidh0,1,0.00006,394029,25.24084,1561077
25098,KidPluto,1,0.00006,394030,25.24091,1561077
25099,Kiemes,1,0.00006,394031,25.24097,1561077
25100,kienbb,1,0.00006,394032,25.24104,1561077
25101,KieranBond,1,0.00006,394033,25.24110,1561077
25102,KieranFabrik,1,0.00006,394034,25.24116,1561077
25103,KieranWebber,1,0.00006,394035,25.24123,1561077
25104,kieukhuongthinh,1,0.00006,394036,25.24129,1561077
25105,kikilagou,1,0.00006,394037,25.24136,1561077
25106,KikyoC,1,0.00006,394038,25.24142,1561077
25107,kilabyte,1,0.00006,394039,25.24148,1561077
25108,killerwhile,1,0.00006,394040,25.24155,1561077
25109,killerwizz1,1,0.00006,394041,25.24161,1561077
25110,killianbrackey,1,0.00006,394042,25.24168,1561077
25111,kimaniv,1,0.00006,394043,25.24174,1561077
25112,kimdwkimdw,1,0.00006,394044,25.24180,1561077
25113,kimgoei,1,0.00006,394045,25.24187,1561077
25114,kimiyasharifi,1,0.00006,394046,25.24193,1561077
25115,kimlin,1,0.00006,394047,25.24200,1561077
25116,KimWanida,1,0.00006,394048,25.24206,1561077
25117,KingBarbarossa,1,0.00006,394049,25.24212,1561077
25118,kingchad1989,1,0.00006,394050,25.24219,1561077
25119,king--code,1,0.00006,394051,25.24225,1561077
25120,kingdaeho,1,0.00006,394052,25.24232,1561077
25121,Kingfatehkhan786,1,0.00006,394053,25.24238,1561077
25122,KINGMJ,1,0.00006,394054,25.24244,1561077
25123,kingofzgjsxz,1,0.00006,394055,25.24251,1561077
25124,kingslair,1,0.00006,394056,25.24257,1561077
25125,Kingsleyk15,1,0.00006,394057,25.24264,1561077
25126,kingsquirrel152,1,0.00006,394058,25.24270,1561077
25127,kingthorin,1,0.00006,394059,25.24277,1561077
25128,kinkerl,1,0.00006,394060,25.24283,1561077
25129,Kinmarui,1,0.00006,394061,25.24289,1561077
25130,kippandrew,1,0.00006,394062,25.24296,1561077
25131,kiran009,1,0.00006,394063,25.24302,1561077
25132,kiran3046,1,0.00006,394064,25.24309,1561077
25133,kiranfegade121,1,0.00006,394065,25.24315,1561077
25134,kirankumar77,1,0.00006,394066,25.24321,1561077
25135,KiranKumarVemparala,1,0.00006,394067,25.24328,1561077
25136,kiriasCMNH,1,0.00006,394068,25.24334,1561077
25137,Kirill-0x7C4,1,0.00006,394069,25.24341,1561077
25138,KirillLogin,1,0.00006,394070,25.24347,1561077
25139,kirkbrady,1,0.00006,394071,25.24353,1561077
25140,kirkHawksworth,1,0.00006,394072,25.24360,1561077
25141,kirqe,1,0.00006,394073,25.24366,1561077
25142,KIRSHANPAL,1,0.00006,394074,25.24373,1561077
25143,kiru98480,1,0.00006,394075,25.24379,1561077
25144,kis024,1,0.00006,394076,25.24385,1561077
25145,kishoredr,1,0.00006,394077,25.24392,1561077
25146,kishorerc,1,0.00006,394078,25.24398,1561077
25147,kishoretak,1,0.00006,394079,25.24405,1561077
25148,kishorkk91,1,0.00006,394080,25.24411,1561077
25149,kishor-u,1,0.00006,394081,25.24417,1561077
25150,kiss0840,1,0.00006,394082,25.24424,1561077
25151,Kissaki,1,0.00006,394083,25.24430,1561077
25152,kissgyongyver,1,0.00006,394084,25.24437,1561077
25153,Kiteva4,1,0.00006,394085,25.24443,1561077
25154,kitfit-dave,1,0.00006,394086,25.24449,1561077
25155,KitioFofack,1,0.00006,394087,25.24456,1561077
25156,kjarnet,1,0.00006,394088,25.24462,1561077
25157,kjayaraman-fiserv,1,0.00006,394089,25.24469,1561077
25158,kjbro,1,0.00006,394090,25.24475,1561077
25159,KjellTillstrand,1,0.00006,394091,25.24481,1561077
25160,kjwise,1,0.00006,394092,25.24488,1561077
25161,kkalin78,1,0.00006,394093,25.24494,1561077
25162,kkarolk,1,0.00006,394094,25.24501,1561077
25163,KKC28,1,0.00006,394095,25.24507,1561077
25164,kkochubey1,1,0.00006,394096,25.24514,1561077
25165,kkolk,1,0.00006,394097,25.24520,1561077
25166,KKoovalsky,1,0.00006,394098,25.24526,1561077
25167,KKtiandao,1,0.00006,394099,25.24533,1561077
25168,kkucera,1,0.00006,394100,25.24539,1561077
25169,kkujala,1,0.00006,394101,25.24546,1561077
25170,kkumler,1,0.00006,394102,25.24552,1561077
25171,kkurzyna,1,0.00006,394103,25.24558,1561077
25172,kkyb123,1,0.00006,394104,25.24565,1561077
25173,klaask,1,0.00006,394105,25.24571,1561077
25174,klamping,1,0.00006,394106,25.24578,1561077
25175,klehman-rally,1,0.00006,394107,25.24584,1561077
25176,klehno00,1,0.00006,394108,25.24590,1561077
25177,kleinen,1,0.00006,394109,25.24597,1561077
25178,Kleinitay,1,0.00006,394110,25.24603,1561077
25179,klemis,1,0.00006,394111,25.24610,1561077
25180,klemmster,1,0.00006,394112,25.24616,1561077
25181,KliminV,1,0.00006,394113,25.24622,1561077
25182,kloarubeek,1,0.00006,394114,25.24629,1561077
25183,klosboss,1,0.00006,394115,25.24635,1561077
25184,kluke0,1,0.00006,394116,25.24642,1561077
25185,klzbb,1,0.00006,394117,25.24648,1561077
25186,kMaiSmith,1,0.00006,394118,25.24654,1561077
25187,kmansel,1,0.00006,394119,25.24661,1561077
25188,kmccreery-viking,1,0.00006,394120,25.24667,1561077
25189,kmelinda,1,0.00006,394121,25.24674,1561077
25190,kmos,1,0.00006,394122,25.24680,1561077
25191,kmthinkingrock,1,0.00006,394123,25.24686,1561077
25192,kmurrayAtCloudbees,1,0.00006,394124,25.24693,1561077
25193,kmurthyms,1,0.00006,394125,25.24699,1561077
25194,knan-nrk,1,0.00006,394126,25.24706,1561077
25195,knaperek,1,0.00006,394127,25.24712,1561077
25196,knehring,1,0.00006,394128,25.24719,1561077
25197,knelasevero,1,0.00006,394129,25.24725,1561077
25198,KnifeHand,1,0.00006,394130,25.24731,1561077
25199,KnightYoshi,1,0.00006,394131,25.24738,1561077
25200,knope,1,0.00006,394132,25.24744,1561077
25201,knorrium,1,0.00006,394133,25.24751,1561077
25202,kobozo,1,0.00006,394134,25.24757,1561077
25203,kocsistemsahne,1,0.00006,394135,25.24763,1561077
25204,kodayashi,1,0.00006,394136,25.24770,1561077
25205,kodehat,1,0.00006,394137,25.24776,1561077
25206,kodekolli,1,0.00006,394138,25.24783,1561077
25207,kodi1981,1,0.00006,394139,25.24789,1561077
25208,kodil,1,0.00006,394140,25.24795,1561077
25209,KoeketieneDesign,1,0.00006,394141,25.24802,1561077
25210,kofwang,1,0.00006,394142,25.24808,1561077
25211,koglinjg,1,0.00006,394143,25.24815,1561077
25212,kohldampfer,1,0.00006,394144,25.24821,1561077
25213,kokorin,1,0.00006,394145,25.24827,1561077
25214,kokoro-team,1,0.00006,394146,25.24834,1561077
25215,Kokos2083,1,0.00006,394147,25.24840,1561077
25216,kolivero-chwy,1,0.00006,394148,25.24847,1561077
25217,KoljaKrueckmeyer,1,0.00006,394149,25.24853,1561077
25218,Kollerb04,1,0.00006,394150,25.24859,1561077
25219,kolobok01,1,0.00006,394151,25.24866,1561077
25220,komkomissarov,1,0.00006,394152,25.24872,1561077
25221,konohanaruto,1,0.00006,394153,25.24879,1561077
25222,konradczajka,1,0.00006,394154,25.24885,1561077
25223,konradstrack,1,0.00006,394155,25.24891,1561077
25224,konserw,1,0.00006,394156,25.24898,1561077
25225,kontact-chan,1,0.00006,394157,25.24904,1561077
25226,Koop1212,1,0.00006,394158,25.24911,1561077
25227,kopelli,1,0.00006,394159,25.24917,1561077
25228,kopinions,1,0.00006,394160,25.24923,1561077
25229,korlat,1,0.00006,394161,25.24930,1561077
25230,kornfan,1,0.00006,394162,25.24936,1561077
25231,korniltsev,1,0.00006,394163,25.24943,1561077
25232,Korvin32,1,0.00006,394164,25.24949,1561077
25233,kostadin-kar,1,0.00006,394165,25.24956,1561077
25234,Kostanos,1,0.00006,394166,25.24962,1561077
25235,KostasMSC,1,0.00006,394167,25.24968,1561077
25236,kostyaplis,1,0.00006,394168,25.24975,1561077
25237,KostyaSha-auto,1,0.00006,394169,25.24981,1561077
25238,kotalakshman,1,0.00006,394170,25.24988,1561077
25239,kotaroooo0,1,0.00006,394171,25.24994,1561077
25240,kotky,1,0.00006,394172,25.25000,1561077
25241,kotprav,1,0.00006,394173,25.25007,1561077
25242,koushikchoudhury0,1,0.00006,394174,25.25013,1561077
25243,kousik93,1,0.00006,394175,25.25020,1561077
25244,Kouter39,1,0.00006,394176,25.25026,1561077
25245,koval-jan,1,0.00006,394177,25.25032,1561077
25246,kowalcj0,1,0.00006,394178,25.25039,1561077
25247,kowy,1,0.00006,394179,25.25045,1561077
25248,koying,1,0.00006,394180,25.25052,1561077
25249,kozy,1,0.00006,394181,25.25058,1561077
25250,kpittman-securus,1,0.00006,394182,25.25064,1561077
25251,kpmueller,1,0.00006,394183,25.25071,1561077
25252,kpostrup,1,0.00006,394184,25.25077,1561077
25253,KPREDDIE,1,0.00006,394185,25.25084,1561077
25254,kraduk,1,0.00006,394186,25.25090,1561077
25255,kraenhansen,1,0.00006,394187,25.25096,1561077
25256,krajewf,1,0.00006,394188,25.25103,1561077
25257,krakel,1,0.00006,394189,25.25109,1561077
25258,kralleman,1,0.00006,394190,25.25116,1561077
25259,kralq,1,0.00006,394191,25.25122,1561077
25260,kramik1,1,0.00006,394192,25.25128,1561077
25261,kramos,1,0.00006,394193,25.25135,1561077
25262,KRams2019,1,0.00006,394194,25.25141,1561077
25263,kranthi-123,1,0.00006,394195,25.25148,1561077
25264,kranthiB,1,0.00006,394196,25.25154,1561077
25265,Kras4ooo,1,0.00006,394197,25.25161,1561077
25266,krazziekay,1,0.00006,394198,25.25167,1561077
25267,krepkay,1,0.00006,394199,25.25173,1561077
25268,krezzoid,1,0.00006,394200,25.25180,1561077
25269,krinmik,1,0.00006,394201,25.25186,1561077
25270,kripe,1,0.00006,394202,25.25193,1561077
25271,krippee,1,0.00006,394203,25.25199,1561077
25272,krisgreene,1,0.00006,394204,25.25205,1561077
25273,krish2304,1,0.00006,394205,25.25212,1561077
25274,krishanil,1,0.00006,394206,25.25218,1561077
25275,krishna295,1,0.00006,394207,25.25225,1561077
25276,krishnacdunuka,1,0.00006,394208,25.25231,1561077
25277,krishnafims,1,0.00006,394209,25.25237,1561077
25278,KrishnaKairamkonda,1,0.00006,394210,25.25244,1561077
25279,krishnavijayashunyaka,1,0.00006,394211,25.25250,1561077
25280,krissrex,1,0.00006,394212,25.25257,1561077
25281,kristianonline,1,0.00006,394213,25.25263,1561077
25282,Kristina001,1,0.00006,394214,25.25269,1561077
25283,kristoferw20,1,0.00006,394215,25.25276,1561077
25284,kristofvb,1,0.00006,394216,25.25282,1561077
25285,krlmlr,1,0.00006,394217,25.25289,1561077
25286,krm1312,1,0.00006,394218,25.25295,1561077
25287,krmal,1,0.00006,394219,25.25301,1561077
25288,krockhold,1,0.00006,394220,25.25308,1561077
25289,krogon,1,0.00006,394221,25.25314,1561077
25290,krolco,1,0.00006,394222,25.25321,1561077
25291,kromg,1,0.00006,394223,25.25327,1561077
25292,kronflux,1,0.00006,394224,25.25333,1561077
25293,kr-pawan,1,0.00006,394225,25.25340,1561077
25294,krstcs,1,0.00006,394226,25.25346,1561077
25295,krsujeetviet,1,0.00006,394227,25.25353,1561077
25296,krugerm-4c,1,0.00006,394228,25.25359,1561077
25297,KrunoKnego,1,0.00006,394229,25.25366,1561077
25298,krusolu,1,0.00006,394230,25.25372,1561077
25299,kruton,1,0.00006,394231,25.25378,1561077
25300,Kryan90,1,0.00006,394232,25.25385,1561077
25301,kryger,1,0.00006,394233,25.25391,1561077
25302,krystan,1,0.00006,394234,25.25398,1561077
25303,KrystianMarek,1,0.00006,394235,25.25404,1561077
25304,krzysztof-moscichowski-smartbear,1,0.00006,394236,25.25410,1561077
25305,krzysztofzawadzki,1,0.00006,394237,25.25417,1561077
25306,ksapede,1,0.00006,394238,25.25423,1561077
25307,ksaraie,1,0.00006,394239,25.25430,1561077
25308,ksato9700,1,0.00006,394240,25.25436,1561077
25309,ksaurabhsinha,1,0.00006,394241,25.25442,1561077
25310,kschethan,1,0.00006,394242,25.25449,1561077
25311,kseifriedredhat,1,0.00006,394243,25.25455,1561077
25312,ksharadhi,1,0.00006,394244,25.25462,1561077
25313,Kshatrix,1,0.00006,394245,25.25468,1561077
25314,KShoukry,1,0.00006,394246,25.25474,1561077
25315,ksiv,1,0.00006,394247,25.25481,1561077
25316,ksmahesh,1,0.00006,394248,25.25487,1561077
25317,ksmith97,1,0.00006,394249,25.25494,1561077
25318,ksmith-coxautoinc,1,0.00006,394250,25.25500,1561077
25319,ksnehi,1,0.00006,394251,25.25506,1561077
25320,k-spa,1,0.00006,394252,25.25513,1561077
25321,kstephan-wescale,1,0.00006,394253,25.25519,1561077
25322,ksubileau,1,0.00006,394254,25.25526,1561077
25323,ksuetani,1,0.00006,394255,25.25532,1561077
25324,kswaroop,1,0.00006,394256,25.25538,1561077
25325,kswong-sg,1,0.00006,394257,25.25545,1561077
25326,kszarlej,1,0.00006,394258,25.25551,1561077
25327,KTannenberg,1,0.00006,394259,25.25558,1561077
25328,ktibi,1,0.00006,394260,25.25564,1561077
25329,ktpktr0,1,0.00006,394261,25.25570,1561077
25330,ktugan,1,0.00006,394262,25.25577,1561077
25331,kuangniaokuang,1,0.00006,394263,25.25583,1561077
25332,kubakunc,1,0.00006,394264,25.25590,1561077
25333,kubasikus,1,0.00006,394265,25.25596,1561077
25334,kubetrix,1,0.00006,394266,25.25603,1561077
25335,kubo44,1,0.00006,394267,25.25609,1561077
25336,kuboj,1,0.00006,394268,25.25615,1561077
25337,kuborgh-hgiesenow,1,0.00006,394269,25.25622,1561077
25338,kubovdm,1,0.00006,394270,25.25628,1561077
25339,kuchmiyalex,1,0.00006,394271,25.25635,1561077
25340,kudiyarov,1,0.00006,394272,25.25641,1561077
25341,kuhner,1,0.00006,394273,25.25647,1561077
25342,kuhyeonjeong,1,0.00006,394274,25.25654,1561077
25343,Kukunin,1,0.00006,394275,25.25660,1561077
25344,kul3r4,1,0.00006,394276,25.25667,1561077
25345,kuldeeps88,1,0.00006,394277,25.25673,1561077
25346,kule,1,0.00006,394278,25.25679,1561077
25347,kulkarnisu,1,0.00006,394279,25.25686,1561077
25348,kulon,1,0.00006,394280,25.25692,1561077
25349,kumadee,1,0.00006,394281,25.25699,1561077
25350,kumarchk,1,0.00006,394282,25.25705,1561077
25351,kumarfield29,1,0.00006,394283,25.25711,1561077
25352,kumarkrish85,1,0.00006,394284,25.25718,1561077
25353,kumarpb,1,0.00006,394285,25.25724,1561077
25354,kumarsingh1993,1,0.00006,394286,25.25731,1561077
25355,kunal-kannav,1,0.00006,394287,25.25737,1561077
25356,kundralaci,1,0.00006,394288,25.25743,1561077
25357,kunyan,1,0.00006,394289,25.25750,1561077
25358,KupchinskiyVasiliy,1,0.00006,394290,25.25756,1561077
25359,kuprince,1,0.00006,394291,25.25763,1561077
25360,kural82,1,0.00006,394292,25.25769,1561077
25361,kurczynski,1,0.00006,394293,25.25775,1561077
25362,kurekbharath,1,0.00006,394294,25.25782,1561077
25363,kurkku,1,0.00006,394295,25.25788,1561077
25364,kurlzor,1,0.00006,394296,25.25795,1561077
25365,kurmiyadla,1,0.00006,394297,25.25801,1561077
25366,kurupgovind,1,0.00006,394298,25.25808,1561077
25367,kushalbn,1,0.00006,394299,25.25814,1561077
25368,kushalkoolwal,1,0.00006,394300,25.25820,1561077
25369,kva183,1,0.00006,394301,25.25827,1561077
25370,kvarak,1,0.00006,394302,25.25833,1561077
25371,k-vekos,1,0.00006,394303,25.25840,1561077
25372,kvijai82,1,0.00006,394304,25.25846,1561077
25373,kvolety-nisum-com,1,0.00006,394305,25.25852,1561077
25374,kvtester,1,0.00006,394306,25.25859,1561077
25375,KwaleePublishingTechSupport,1,0.00006,394307,25.25865,1561077
25376,kwaping,1,0.00006,394308,25.25872,1561077
25377,kwit75,1,0.00006,394309,25.25878,1561077
25378,kwm14,1,0.00006,394310,25.25884,1561077
25379,kworr,1,0.00006,394311,25.25891,1561077
25380,kwridan-bb,1,0.00006,394312,25.25897,1561077
25381,kwyn,1,0.00006,394313,25.25904,1561077
25382,kyanh-vX7HLAHZLPsUxeHD,1,0.00006,394314,25.25910,1561077
25383,kykc,1,0.00006,394315,25.25916,1561077
25384,kyleaddison14,1,0.00006,394316,25.25923,1561077
25385,kylebevans,1,0.00006,394317,25.25929,1561077
25386,kylebluenote,1,0.00006,394318,25.25936,1561077
25387,kyleboon,1,0.00006,394319,25.25942,1561077
25388,kylefowler,1,0.00006,394320,25.25948,1561077
25389,kylegibson,1,0.00006,394321,25.25955,1561077
25390,KyleRogers,1,0.00006,394322,25.25961,1561077
25391,KyleTryon,1,0.00006,394323,25.25968,1561077
25392,KyleWiering,1,0.00006,394324,25.25974,1561077
25393,kylewolfe,1,0.00006,394325,25.25980,1561077
25394,Kylmakalle,1,0.00006,394326,25.25987,1561077
25395,kyluca,1,0.00006,394327,25.25993,1561077
25396,kys1230,1,0.00006,394328,25.26000,1561077
25397,Kyusuf186,1,0.00006,394329,25.26006,1561077
25398,kyxap,1,0.00006,394330,25.26012,1561077
25399,kz-flavius,1,0.00006,394331,25.26019,1561077
25400,kzhou57,1,0.00006,394332,25.26025,1561077
25401,l0rd17,1,0.00006,394333,25.26032,1561077
25402,l19891223j,1,0.00006,394334,25.26038,1561077
25403,l3m,1,0.00006,394335,25.26045,1561077
25404,l3r4nd,1,0.00006,394336,25.26051,1561077
25405,L3u3n,1,0.00006,394337,25.26057,1561077
25406,la5ell,1,0.00006,394338,25.26064,1561077
25407,laapsaap,1,0.00006,394339,25.26070,1561077
25408,LabibMansour,1,0.00006,394340,25.26077,1561077
25409,labisso,1,0.00006,394341,25.26083,1561077
25410,lacatus,1,0.00006,394342,25.26089,1561077
25411,lachiemurray,1,0.00006,394343,25.26096,1561077
25412,lafada,1,0.00006,394344,25.26102,1561077
25413,lagunary,1,0.00006,394345,25.26109,1561077
25414,LahbiziSafae,1,0.00006,394346,25.26115,1561077
25415,lainosantos,1,0.00006,394347,25.26121,1561077
25416,laksgreen,1,0.00006,394348,25.26128,1561077
25417,Lakshmipathi,1,0.00006,394349,25.26134,1561077
25418,lalithach,1,0.00006,394350,25.26141,1561077
25419,lalkhum,1,0.00006,394351,25.26147,1561077
25420,lamarquevs,1,0.00006,394352,25.26153,1561077
25421,lambdarookie,1,0.00006,394353,25.26160,1561077
25422,lamcw,1,0.00006,394354,25.26166,1561077
25423,lamdbui,1,0.00006,394355,25.26173,1561077
25424,lamont,1,0.00006,394356,25.26179,1561077
25425,lancespeelmon,1,0.00006,394357,25.26185,1561077
25426,lancherider,1,0.00006,394358,25.26192,1561077
25427,lancy-mega,1,0.00006,394359,25.26198,1561077
25428,landaumd,1,0.00006,394360,25.26205,1561077
25429,landgraf,1,0.00006,394361,25.26211,1561077
25430,landstroem,1,0.00006,394362,25.26217,1561077
25431,lange88,1,0.00006,394363,25.26224,1561077
25432,langes,1,0.00006,394364,25.26230,1561077
25433,langsingwe,1,0.00006,394365,25.26237,1561077
25434,langzi-zmg,1,0.00006,394366,25.26243,1561077
25435,lankakiran,1,0.00006,394367,25.26250,1561077
25436,Lanseuo,1,0.00006,394368,25.26256,1561077
25437,laochiji,1,0.00006,394369,25.26262,1561077
25438,lapayne,1,0.00006,394370,25.26269,1561077
25439,laplasz,1,0.00006,394371,25.26275,1561077
25440,Lapo26,1,0.00006,394372,25.26282,1561077
25441,larakiba,1,0.00006,394373,25.26288,1561077
25442,larcher,1,0.00006,394374,25.26294,1561077
25443,lared,1,0.00006,394375,25.26301,1561077
25444,larkinandy,1,0.00006,394376,25.26307,1561077
25445,larrybolt,1,0.00006,394377,25.26314,1561077
25446,larry-fuy,1,0.00006,394378,25.26320,1561077
25447,LarrysGIT,1,0.00006,394379,25.26326,1561077
25448,larseen,1,0.00006,394380,25.26333,1561077
25449,larsgerber,1,0.00006,394381,25.26339,1561077
25450,larson004,1,0.00006,394382,25.26346,1561077
25451,lasantha78,1,0.00006,394383,25.26352,1561077
25452,LassiAutio,1,0.00006,394384,25.26358,1561077
25453,laszlocph,1,0.00006,394385,25.26365,1561077
25454,LaudateCorpus1,1,0.00006,394386,25.26371,1561077
25455,laughtonsm,1,0.00006,394387,25.26378,1561077
25456,laukerta,1,0.00006,394388,25.26384,1561077
25457,lauksas,1,0.00006,394389,25.26390,1561077
25458,lauraseidler,1,0.00006,394390,25.26397,1561077
25459,laurentL,1,0.00006,394391,25.26403,1561077
25460,laurent-malvert,1,0.00006,394392,25.26410,1561077
25461,LaurentTardif,1,0.00006,394393,25.26416,1561077
25462,laurenyello,1,0.00006,394394,25.26422,1561077
25463,laurichj,1,0.00006,394395,25.26429,1561077
25464,lauriemhu,1,0.00006,394396,25.26435,1561077
25465,laurimak,1,0.00006,394397,25.26442,1561077
25466,lauserb,1,0.00006,394398,25.26448,1561077
25467,lavcraft,1,0.00006,394399,25.26454,1561077
25468,LavenXu,1,0.00006,394400,25.26461,1561077
25469,lavie,1,0.00006,394401,25.26467,1561077
25470,lavock,1,0.00006,394402,25.26474,1561077
25471,lawrence615,1,0.00006,394403,25.26480,1561077
25472,layneYoo,1,0.00006,394404,25.26487,1561077
25473,lazee,1,0.00006,394405,25.26493,1561077
25474,lazyfrosch,1,0.00006,394406,25.26499,1561077
25475,lbarinstein,1,0.00006,394407,25.26506,1561077
25476,lbeder,1,0.00006,394408,25.26512,1561077
25477,lbly,1,0.00006,394409,25.26519,1561077
25478,lbp-code,1,0.00006,394410,25.26525,1561077
25479,lbrader,1,0.00006,394411,25.26531,1561077
25480,lbrigman124,1,0.00006,394412,25.26538,1561077
25481,lbrownell-gpsw,1,0.00006,394413,25.26544,1561077
25482,lbykos,1,0.00006,394414,25.26551,1561077
25483,lcareto,1,0.00006,394415,25.26557,1561077
25484,lcarlier,1,0.00006,394416,25.26563,1561077
25485,lcary,1,0.00006,394417,25.26570,1561077
25486,lcasassa,1,0.00006,394418,25.26576,1561077
25487,lcasey001,1,0.00006,394419,25.26583,1561077
25488,lcastrooliveira,1,0.00006,394420,25.26589,1561077
25489,lcc2207,1,0.00006,394421,25.26595,1561077
25490,lcgkm,1,0.00006,394422,25.26602,1561077
25491,lchenay,1,0.00006,394423,25.26608,1561077
25492,lchiron,1,0.00006,394424,25.26615,1561077
25493,lcollins,1,0.00006,394425,25.26621,1561077
25494,lcoriton-acc,1,0.00006,394426,25.26627,1561077
25495,lcrodriguez,1,0.00006,394427,25.26634,1561077
25496,lcustodio,1,0.00006,394428,25.26640,1561077
25497,lczupryn-tibco,1,0.00006,394429,25.26647,1561077
25498,ld000,1,0.00006,394430,25.26653,1561077
25499,ldaume,1,0.00006,394431,25.26659,1561077
25500,ldelgadop44,1,0.00006,394432,25.26666,1561077
25501,ldhertert,1,0.00006,394433,25.26672,1561077
25502,ldobson,1,0.00006,394434,25.26679,1561077
25503,ldominique92,1,0.00006,394435,25.26685,1561077
25504,LDQuad,1,0.00006,394436,25.26692,1561077
25505,ldsink,1,0.00006,394437,25.26698,1561077
25506,leahecole,1,0.00006,394438,25.26704,1561077
25507,leanator,1,0.00006,394439,25.26711,1561077
25508,leandro-loos,1,0.00006,394440,25.26717,1561077
25509,leapin-devops,1,0.00006,394441,25.26724,1561077
25510,learnerbyheart,1,0.00006,394442,25.26730,1561077
25511,LearningCitizen,1,0.00006,394443,25.26736,1561077
25512,learning-de,1,0.00006,394444,25.26743,1561077
25513,LearningPur,1,0.00006,394445,25.26749,1561077
25514,LeBakii,1,0.00006,394446,25.26756,1561077
25515,lebeg,1,0.00006,394447,25.26762,1561077
25516,lebtech,1,0.00006,394448,25.26768,1561077
25517,lebuitrago,1,0.00006,394449,25.26775,1561077
25518,Lectorrr,1,0.00006,394450,25.26781,1561077
25519,Lee2011,1,0.00006,394451,25.26788,1561077
25520,lee-40square,1,0.00006,394452,25.26794,1561077
25521,lee5i3,1,0.00006,394453,25.26800,1561077
25522,leearic,1,0.00006,394454,25.26807,1561077
25523,leehankyeol,1,0.00006,394455,25.26813,1561077
25524,leeknives,1,0.00006,394456,25.26820,1561077
25525,leelaprasadv,1,0.00006,394457,25.26826,1561077
25526,leeonlee,1,0.00006,394458,25.26832,1561077
25527,leeopop,1,0.00006,394459,25.26839,1561077
25528,LeeShape,1,0.00006,394460,25.26845,1561077
25529,leeshd,1,0.00006,394461,25.26852,1561077
25530,leestorm,1,0.00006,394462,25.26858,1561077
25531,leeuwenrjj,1,0.00006,394463,25.26864,1561077
25532,lefoulkrod,1,0.00006,394464,25.26871,1561077
25533,leftathome,1,0.00006,394465,25.26877,1561077
25534,legart,1,0.00006,394466,25.26884,1561077
25535,leginj,1,0.00006,394467,25.26890,1561077
25536,legoktm,1,0.00006,394468,25.26896,1561077
25537,legovaer,1,0.00006,394469,25.26903,1561077
25538,legshort,1,0.00006,394470,25.26909,1561077
25539,lehnerj,1,0.00006,394471,25.26916,1561077
25540,leifbladt,1,0.00006,394472,25.26922,1561077
25541,leishenzhupi,1,0.00006,394473,25.26929,1561077
25542,leitmedium,1,0.00006,394474,25.26935,1561077
25543,Leits,1,0.00006,394475,25.26941,1561077
25544,leitu,1,0.00006,394476,25.26948,1561077
25545,leiyazhen,1,0.00006,394477,25.26954,1561077
25546,lemitrou,1,0.00006,394478,25.26961,1561077
25547,lemmywrap,1,0.00006,394479,25.26967,1561077
25548,lemonov,1,0.00006,394480,25.26973,1561077
25549,lemosdeveloper,1,0.00006,394481,25.26980,1561077
25550,lenis0012,1,0.00006,394482,25.26986,1561077
25551,lennehendrickx,1,0.00006,394483,25.26993,1561077
25552,leo-chan-symc,1,0.00006,394484,25.26999,1561077
25553,LeoCyclope,1,0.00006,394485,25.27005,1561077
25554,Leo-Guo,1,0.00006,394486,25.27012,1561077
25555,LeoLuo21,1,0.00006,394487,25.27018,1561077
25556,leonardge,1,0.00006,394488,25.27025,1561077
25557,leonardocastanodiaz,1,0.00006,394489,25.27031,1561077
25558,leonardokochake,1,0.00006,394490,25.27037,1561077
25559,leonbsilva,1,0.00006,394491,25.27044,1561077
25560,LeoNineStudios,1,0.00006,394492,25.27050,1561077
25561,leoniscsem,1,0.00006,394493,25.27057,1561077
25562,leonkatz,1,0.00006,394494,25.27063,1561077
25563,leopaul36,1,0.00006,394495,25.27069,1561077
25564,leopck,1,0.00006,394496,25.27076,1561077
25565,leopoldodonnell,1,0.00006,394497,25.27082,1561077
25566,LeopoldoNicotra,1,0.00006,394498,25.27089,1561077
25567,leoslf,1,0.00006,394499,25.27095,1561077
25568,leostolyarov,1,0.00006,394500,25.27101,1561077
25569,Leow88,1,0.00006,394501,25.27108,1561077
25570,leoytelus,1,0.00006,394502,25.27114,1561077
25571,lepffm,1,0.00006,394503,25.27121,1561077
25572,leptonyu,1,0.00006,394504,25.27127,1561077
25573,le-ross,1,0.00006,394505,25.27134,1561077
25574,leroybernardjr,1,0.00006,394506,25.27140,1561077
25575,lerrigatto,1,0.00006,394507,25.27146,1561077
25576,lesinigo,1,0.00006,394508,25.27153,1561077
25577,lesthre,1,0.00006,394509,25.27159,1561077
25578,lestinliu,1,0.00006,394510,25.27166,1561077
25579,leti-ulloa,1,0.00006,394511,25.27172,1561077
25580,letran3691,1,0.00006,394512,25.27178,1561077
25581,level256,1,0.00006,394513,25.27185,1561077
25582,levente-staub,1,0.00006,394514,25.27191,1561077
25583,levidehaan,1,0.00006,394515,25.27198,1561077
25584,LeviMWilliamson,1,0.00006,394516,25.27204,1561077
25585,levi-rs,1,0.00006,394517,25.27210,1561077
25586,levisbakalinsky,1,0.00006,394518,25.27217,1561077
25587,Levitas,1,0.00006,394519,25.27223,1561077
25588,levrun,1,0.00006,394520,25.27230,1561077
25589,lewandowskim1988,1,0.00006,394521,25.27236,1561077
25590,lewer,1,0.00006,394522,25.27242,1561077
25591,LewG02,1,0.00006,394523,25.27249,1561077
25592,lewisd32,1,0.00006,394524,25.27255,1561077
25593,lewisreay,1,0.00006,394525,25.27262,1561077
25594,lewurm,1,0.00006,394526,25.27268,1561077
25595,lexaurin,1,0.00006,394527,25.27274,1561077
25596,lexia-wouter-vanrij,1,0.00006,394528,25.27281,1561077
25597,lfberge,1,0.00006,394529,25.27287,1561077
25598,LFDwater,1,0.00006,394530,25.27294,1561077
25599,lgilbert29,1,0.00006,394531,25.27300,1561077
25600,LGordon2,1,0.00006,394532,25.27306,1561077
25601,lgraziosi,1,0.00006,394533,25.27313,1561077
25602,lgtm-migrator,1,0.00006,394534,25.27319,1561077
25603,lhb008,1,0.00006,394535,25.27326,1561077
25604,lheeb,1,0.00006,394536,25.27332,1561077
25605,lhennerley,1,0.00006,394537,25.27338,1561077
25606,lholota,1,0.00006,394538,25.27345,1561077
25607,lhopki01,1,0.00006,394539,25.27351,1561077
25608,lhoss,1,0.00006,394540,25.27358,1561077
25609,lhotakj,1,0.00006,394541,25.27364,1561077
25610,LHRchina,1,0.00006,394542,25.27371,1561077
25611,liamfend,1,0.00006,394543,25.27377,1561077
25612,liamkirwan,1,0.00006,394544,25.27383,1561077
25613,LiamLeane,1,0.00006,394545,25.27390,1561077
25614,liamlundy,1,0.00006,394546,25.27396,1561077
25615,liammac,1,0.00006,394547,25.27403,1561077
25616,Liam-Pilot,1,0.00006,394548,25.27409,1561077
25617,liaoh009,1,0.00006,394549,25.27415,1561077
25618,liaowenming23,1,0.00006,394550,25.27422,1561077
25619,liaoyupeng,1,0.00006,394551,25.27428,1561077
25620,libincla,1,0.00006,394552,25.27435,1561077
25621,libratiger,1,0.00006,394553,25.27441,1561077
25622,lichong-a,1,0.00006,394554,25.27447,1561077
25623,lichunf,1,0.00006,394555,25.27454,1561077
25624,lidudutju,1,0.00006,394556,25.27460,1561077
25625,lieutdan13,1,0.00006,394557,25.27467,1561077
25626,life123,1,0.00006,394558,25.27473,1561077
25627,lifeblood,1,0.00006,394559,25.27479,1561077
25628,Lifeclue,1,0.00006,394560,25.27486,1561077
25629,lifesoccult,1,0.00006,394561,25.27492,1561077
25630,lifuzu,1,0.00006,394562,25.27499,1561077
25631,lightofanima,1,0.00006,394563,25.27505,1561077
25632,ligu01,1,0.00006,394564,25.27511,1561077
25633,lihihason,1,0.00006,394565,25.27518,1561077
25634,lik96,1,0.00006,394566,25.27524,1561077
25635,Likebutter,1,0.00006,394567,25.27531,1561077
25636,limasilet,1,0.00006,394568,25.27537,1561077
25637,Limech,1,0.00006,394569,25.27543,1561077
25638,limonte,1,0.00006,394570,25.27550,1561077
25639,linbiqiu,1,0.00006,394571,25.27556,1561077
25640,lincoln-b,1,0.00006,394572,25.27563,1561077
25641,lincoohe,1,0.00006,394573,25.27569,1561077
25642,Lindawu168,1,0.00006,394574,25.27576,1561077
25643,lindelani-nthangeni,1,0.00006,394575,25.27582,1561077
25644,lineshdifi,1,0.00006,394576,25.27588,1561077
25645,Lingeswaran-R,1,0.00006,394577,25.27595,1561077
25646,lingyan,1,0.00006,394578,25.27601,1561077
25647,linjan,1,0.00006,394579,25.27608,1561077
25648,linjer,1,0.00006,394580,25.27614,1561077
25649,link78,1,0.00006,394581,25.27620,1561077
25650,LINKIWI,1,0.00006,394582,25.27627,1561077
25651,LinRaise,1,0.00006,394583,25.27633,1561077
25652,Linshiqi,1,0.00006,394584,25.27640,1561077
25653,LinuxArchitects,1,0.00006,394585,25.27646,1561077
25654,linuxbunter213,1,0.00006,394586,25.27652,1561077
25655,linuxoid69,1,0.00006,394587,25.27659,1561077
25656,linzhenan,1,0.00006,394588,25.27665,1561077
25657,lionelfarr,1,0.00006,394589,25.27672,1561077
25658,liorlib7,1,0.00006,394590,25.27678,1561077
25659,liorsamuni,1,0.00006,394591,25.27684,1561077
25660,liquid1982,1,0.00006,394592,25.27691,1561077
25661,liquid-cloud,1,0.00006,394593,25.27697,1561077
25662,Liryna,1,0.00006,394594,25.27704,1561077
25663,lisageorgy21,1,0.00006,394595,25.27710,1561077
25664,lisaied,1,0.00006,394596,25.27716,1561077
25665,LisaYF,1,0.00006,394597,25.27723,1561077
25666,lite2073,1,0.00006,394598,25.27729,1561077
25667,littleday,1,0.00006,394599,25.27736,1561077
25668,littleGnAl,1,0.00006,394600,25.27742,1561077
25669,Little-Little-Bear,1,0.00006,394601,25.27748,1561077
25670,liu2qian,1,0.00006,394602,25.27755,1561077
25671,liudaolunboluo,1,0.00006,394603,25.27761,1561077
25672,Liudapeng,1,0.00006,394604,25.27768,1561077
25673,liudeing,1,0.00006,394605,25.27774,1561077
25674,liuhaotian,1,0.00006,394606,25.27781,1561077
25675,liuhhair,1,0.00006,394607,25.27787,1561077
25676,liuhw99,1,0.00006,394608,25.27793,1561077
25677,LivingBrain,1,0.00006,394609,25.27800,1561077
25678,liweis,1,0.00006,394610,25.27806,1561077
25679,lixmgl,1,0.00006,394611,25.27813,1561077
25680,LiyakathPandu,1,0.00006,394612,25.27819,1561077
25681,liyihe96,1,0.00006,394613,25.27825,1561077
25682,LizaKelly,1,0.00006,394614,25.27832,1561077
25683,lizhaobibi,1,0.00006,394615,25.27838,1561077
25684,lizhh123,1,0.00006,394616,25.27845,1561077
25685,lizlam,1,0.00006,394617,25.27851,1561077
25686,lj2007331,1,0.00006,394618,25.27857,1561077
25687,lklacar,1,0.00006,394619,25.27864,1561077
25688,lklkxcxc,1,0.00006,394620,25.27870,1561077
25689,lkwg82,1,0.00006,394621,25.27877,1561077
25690,llambeau,1,0.00006,394622,25.27883,1561077
25691,llan0war,1,0.00006,394623,25.27889,1561077
25692,llange,1,0.00006,394624,25.27896,1561077
25693,llasram,1,0.00006,394625,25.27902,1561077
25694,LLCoolDave,1,0.00006,394626,25.27909,1561077
25695,lleiguo,1,0.00006,394627,25.27915,1561077
25696,lleirgarciaboadapruebas,1,0.00006,394628,25.27921,1561077
25697,lleroyconsult,1,0.00006,394629,25.27928,1561077
25698,LLitchi,1,0.00006,394630,25.27934,1561077
25699,llizamab,1,0.00006,394631,25.27941,1561077
25700,llk89,1,0.00006,394632,25.27947,1561077
25701,LLluma,1,0.00006,394633,25.27953,1561077
25702,llmagicll,1,0.00006,394634,25.27960,1561077
25703,lluisStuart,1,0.00006,394635,25.27966,1561077
25704,lmarthorburn,1,0.00006,394636,25.27973,1561077
25705,lmasaya,1,0.00006,394637,25.27979,1561077
25706,lmeadows,1,0.00006,394638,25.27985,1561077
25707,lme-nca,1,0.00006,394639,25.27992,1561077
25708,lneuhaus,1,0.00006,394640,25.27998,1561077
25709,lnformbu,1,0.00006,394641,25.28005,1561077
25710,lnguyen-nvn,1,0.00006,394642,25.28011,1561077
25711,loadaverage,1,0.00006,394643,25.28018,1561077
25712,LobsterMan,1,0.00006,394644,25.28024,1561077
25713,lockheadone,1,0.00006,394645,25.28030,1561077
25714,LockiJiang,1,0.00006,394646,25.28037,1561077
25715,locorocoo,1,0.00006,394647,25.28043,1561077
25716,logansease,1,0.00006,394648,25.28050,1561077
25717,logi85,1,0.00006,394649,25.28056,1561077
25718,logicflakes,1,0.00006,394650,25.28062,1561077
25719,logikal,1,0.00006,394651,25.28069,1561077
25720,login2ashishverma,1,0.00006,394652,25.28075,1561077
25721,Lohandus,1,0.00006,394653,25.28082,1561077
25722,loic-carbonne,1,0.00006,394654,25.28088,1561077
25723,lokeshdangi,1,0.00006,394655,25.28094,1561077
25724,lokinegalur,1,0.00006,394656,25.28101,1561077
25725,lolpack,1,0.00006,394657,25.28107,1561077
25726,lonelysh,1,0.00006,394658,25.28114,1561077
25727,longfeiwlf,1,0.00006,394659,25.28120,1561077
25728,longquangao,1,0.00006,394660,25.28126,1561077
25729,longstone,1,0.00006,394661,25.28133,1561077
25730,lonix1,1,0.00006,394662,25.28139,1561077
25731,lonyphus,1,0.00006,394663,25.28146,1561077
25732,look4regev,1,0.00006,394664,25.28152,1561077
25733,Lorca-R,1,0.00006,394665,25.28158,1561077
25734,lordbyron,1,0.00006,394666,25.28165,1561077
25735,Lord-Evil,1,0.00006,394667,25.28171,1561077
25736,lordmortis,1,0.00006,394668,25.28178,1561077
25737,lordylike,1,0.00006,394669,25.28184,1561077
25738,lorenh,1,0.00006,394670,25.28190,1561077
25739,LorenzMende,1,0.00006,394671,25.28197,1561077
25740,LoriLorusso,1,0.00006,394672,25.28203,1561077
25741,LorisFriedel,1,0.00006,394673,25.28210,1561077
25742,lo-rodriguez,1,0.00006,394674,25.28216,1561077
25743,losmurfs,1,0.00006,394675,25.28223,1561077
25744,lotharschulz,1,0.00006,394676,25.28229,1561077
25745,loudDD,1,0.00006,394677,25.28235,1561077
25746,LouisAtNantes,1,0.00006,394678,25.28242,1561077
25747,louisdj,1,0.00006,394679,25.28248,1561077
25748,louiseemdavis,1,0.00006,394680,25.28255,1561077
25749,louisrli,1,0.00006,394681,25.28261,1561077
25750,LouisStAmour,1,0.00006,394682,25.28267,1561077
25751,loukou007,1,0.00006,394683,25.28274,1561077
25752,love477,1,0.00006,394684,25.28280,1561077
25753,loveai88,1,0.00006,394685,25.28287,1561077
25754,LoveDuckie,1,0.00006,394686,25.28293,1561077
25755,lovleshmalik,1,0.00006,394687,25.28299,1561077
25756,lpbedard,1,0.00006,394688,25.28306,1561077
25757,lpcruz,1,0.00006,394689,25.28312,1561077
25758,lpetrea,1,0.00006,394690,25.28319,1561077
25759,lpnueg4,1,0.00006,394691,25.28325,1561077
25760,lptarik,1,0.00006,394692,25.28331,1561077
25761,l-ray,1,0.00006,394693,25.28338,1561077
25762,lrebscher,1,0.00006,394694,25.28344,1561077
25763,lrm25,1,0.00006,394695,25.28351,1561077
25764,lrodrigueza,1,0.00006,394696,25.28357,1561077
25765,lrotberg,1,0.00006,394697,25.28363,1561077
25766,lrxtom2,1,0.00006,394698,25.28370,1561077
25767,lsarot,1,0.00006,394699,25.28376,1561077
25768,ls-christine-dodrill,1,0.00006,394700,25.28383,1561077
25769,lshadler,1,0.00006,394701,25.28389,1561077
25770,lsilvatux,1,0.00006,394702,25.28395,1561077
25771,lsim-bravura,1,0.00006,394703,25.28402,1561077
25772,lskillen,1,0.00006,394704,25.28408,1561077
25773,lstiebel,1,0.00006,394705,25.28415,1561077
25774,lszucsPmi,1,0.00006,394706,25.28421,1561077
25775,ltk-mpadelsky,1,0.00006,394707,25.28427,1561077
25776,lubomir,1,0.00006,394708,25.28434,1561077
25777,luca010,1,0.00006,394709,25.28440,1561077
25778,lucaf86,1,0.00006,394710,25.28447,1561077
25779,lucalandi,1,0.00006,394711,25.28453,1561077
25780,lucapalano,1,0.00006,394712,25.28460,1561077
25781,luca-poddigue,1,0.00006,394713,25.28466,1561077
25782,Lucas-Bah,1,0.00006,394714,25.28472,1561077
25783,lucasmarcelli,1,0.00006,394715,25.28479,1561077
25784,lucaspalavecino46,1,0.00006,394716,25.28485,1561077
25785,LucasSegersFabro,1,0.00006,394717,25.28492,1561077
25786,LucasSq,1,0.00006,394718,25.28498,1561077
25787,lucastercas,1,0.00006,394719,25.28504,1561077
25788,LucasTran380381,1,0.00006,394720,25.28511,1561077
25789,lucasvc,1,0.00006,394721,25.28517,1561077
25790,lucasvinals,1,0.00006,394722,25.28524,1561077
25791,lucavitucci,1,0.00006,394723,25.28530,1561077
25792,lucendio,1,0.00006,394724,25.28536,1561077
25793,luciavalles,1,0.00006,394725,25.28543,1561077
25794,lucibranc,1,0.00006,394726,25.28549,1561077
25795,luckeyca,1,0.00006,394727,25.28556,1561077
25796,luckielordie,1,0.00006,394728,25.28562,1561077
25797,luckyhsif,1,0.00006,394729,25.28568,1561077
25798,luckyswede,1,0.00006,394730,25.28575,1561077
25799,lucmann,1,0.00006,394731,25.28581,1561077
25800,LucyAkulovich,1,0.00006,394732,25.28588,1561077
25801,ludenus,1,0.00006,394733,25.28594,1561077
25802,ludicruz,1,0.00006,394734,25.28600,1561077
25803,ludmata,1,0.00006,394735,25.28607,1561077
25804,ludochane,1,0.00006,394736,25.28613,1561077
25805,ludoviclehmann,1,0.00006,394737,25.28620,1561077
25806,luebbe,1,0.00006,394738,25.28626,1561077
25807,luger1990,1,0.00006,394739,25.28632,1561077
25808,Lugge,1,0.00006,394740,25.28639,1561077
25809,luhugu,1,0.00006,394741,25.28645,1561077
25810,Luiferma,1,0.00006,394742,25.28652,1561077
25811,luinungom,1,0.00006,394743,25.28658,1561077
25812,luisbraga-msg,1,0.00006,394744,25.28665,1561077
25813,lujunbofan,1,0.00006,394745,25.28671,1561077
25814,luk355,1,0.00006,394746,25.28677,1561077
25815,luka-j,1,0.00006,394747,25.28684,1561077
25816,Lukas238,1,0.00006,394748,25.28690,1561077
25817,lukas9393,1,0.00006,394749,25.28697,1561077
25818,lukasbar,1,0.00006,394750,25.28703,1561077
25819,lukaseder,1,0.00006,394751,25.28709,1561077
25820,LukasJRG,1,0.00006,394752,25.28716,1561077
25821,lukasniemeier-zalando,1,0.00006,394753,25.28722,1561077
25822,LukasVice,1,0.00006,394754,25.28729,1561077
25823,lukaswajdzik,1,0.00006,394755,25.28735,1561077
25824,lukaszgorzynski,1,0.00006,394756,25.28741,1561077
25825,lukebigum,1,0.00006,394757,25.28748,1561077
25826,lukebrewerton,1,0.00006,394758,25.28754,1561077
25827,lukerosser,1,0.00006,394759,25.28761,1561077
25828,lukesaint,1,0.00006,394760,25.28767,1561077
25829,luke-shepherd,1,0.00006,394761,25.28773,1561077
25830,lukewpatterson,1,0.00006,394762,25.28780,1561077
25831,lukeZhangMengxi,1,0.00006,394763,25.28786,1561077
25832,luminescent,1,0.00006,394764,25.28793,1561077
25833,Lunaden,1,0.00006,394765,25.28799,1561077
25834,lunar-consultancy,1,0.00006,394766,25.28805,1561077
25835,lunasummer,1,0.00006,394767,25.28812,1561077
25836,lunaticare,1,0.00006,394768,25.28818,1561077
25837,luojianp,1,0.00006,394769,25.28825,1561077
25838,luoph,1,0.00006,394770,25.28831,1561077
25839,luorigufeng,1,0.00006,394771,25.28837,1561077
25840,luoyan35714,1,0.00006,394772,25.28844,1561077
25841,lurajon,1,0.00006,394773,25.28850,1561077
25842,lurume84,1,0.00006,394774,25.28857,1561077
25843,Lusandra,1,0.00006,394775,25.28863,1561077
25844,lustoykov,1,0.00006,394776,25.28869,1561077
25845,Lutfar1996,1,0.00006,394777,25.28876,1561077
25846,luuk-janssen-tiobe,1,0.00006,394778,25.28882,1561077
25847,luvpreetsingh,1,0.00006,394779,25.28889,1561077
25848,Luxor,1,0.00006,394780,25.28895,1561077
25849,lvhejin,1,0.00006,394781,25.28902,1561077
25850,lvinniel,1,0.00006,394782,25.28908,1561077
25851,lwangwangl,1,0.00006,394783,25.28914,1561077
25852,lwille,1,0.00006,394784,25.28921,1561077
25853,lwx2615,1,0.00006,394785,25.28927,1561077
25854,lwxcd,1,0.00006,394786,25.28934,1561077
25855,LWZ55,1,0.00006,394787,25.28940,1561077
25856,LyashenkoGS,1,0.00006,394788,25.28946,1561077
25857,Lydia0718,1,0.00006,394789,25.28953,1561077
25858,Lylah,1,0.00006,394790,25.28959,1561077
25859,Lynderyn,1,0.00006,394791,25.28966,1561077
25860,lynnlingHu,1,0.00006,394792,25.28972,1561077
25861,lynskey08,1,0.00006,394793,25.28978,1561077
25862,Lynx12,1,0.00006,394794,25.28985,1561077
25863,lyssdod,1,0.00006,394795,25.28991,1561077
25864,lzagreusSkyport,1,0.00006,394796,25.28998,1561077
25865,LzaldivarGS,1,0.00006,394797,25.29004,1561077
25866,lzhengqc,1,0.00006,394798,25.29010,1561077
25867,lzljump8102,1,0.00006,394799,25.29017,1561077
25868,m2bright,1,0.00006,394800,25.29023,1561077
25869,m2khosravi,1,0.00006,394801,25.29030,1561077
25870,m3ki,1,0.00006,394802,25.29036,1561077
25871,M4nuF,1,0.00006,394803,25.29042,1561077
25872,m4x1202,1,0.00006,394804,25.29049,1561077
25873,maage,1,0.00006,394805,25.29055,1561077
25874,maartengo,1,0.00006,394806,25.29062,1561077
25875,maartenvang,1,0.00006,394807,25.29068,1561077
25876,maass-tv,1,0.00006,394808,25.29074,1561077
25877,maazahmedks,1,0.00006,394809,25.29081,1561077
25878,m-abrarali,1,0.00006,394810,25.29087,1561077
25879,mabson,1,0.00006,394811,25.29094,1561077
25880,mabu2000,1,0.00006,394812,25.29100,1561077
25881,mabu-github,1,0.00006,394813,25.29107,1561077
25882,mac-110,1,0.00006,394814,25.29113,1561077
25883,Machiel-s,1,0.00006,394815,25.29119,1561077
25884,machosallad,1,0.00006,394816,25.29126,1561077
25885,machzqcq,1,0.00006,394817,25.29132,1561077
25886,maciejkra,1,0.00006,394818,25.29139,1561077
25887,maciejs20,1,0.00006,394819,25.29145,1561077
25888,maciej-wolny,1,0.00006,394820,25.29151,1561077
25889,mackoftrack,1,0.00006,394821,25.29158,1561077
25890,macmantrl,1,0.00006,394822,25.29164,1561077
25891,macnev2013,1,0.00006,394823,25.29171,1561077
25892,macolo,1,0.00006,394824,25.29177,1561077
25893,maconic,1,0.00006,394825,25.29183,1561077
25894,macpharlan,1,0.00006,394826,25.29190,1561077
25895,MacroLove,1,0.00006,394827,25.29196,1561077
25896,mad0house,1,0.00006,394828,25.29203,1561077
25897,madalinaptj,1,0.00006,394829,25.29209,1561077
25898,madalion,1,0.00006,394830,25.29215,1561077
25899,madamczyk-tbscg,1,0.00006,394831,25.29222,1561077
25900,MadbnM,1,0.00006,394832,25.29228,1561077
25901,Mad-Chicken,1,0.00006,394833,25.29235,1561077
25902,madduci,1,0.00006,394834,25.29241,1561077
25903,madhammock,1,0.00006,394835,25.29247,1561077
25904,madhubala2022,1,0.00006,394836,25.29254,1561077
25905,madhudevops1989,1,0.00006,394837,25.29260,1561077
25906,madhulikap0903,1,0.00006,394838,25.29267,1561077
25907,Madhupatel08,1,0.00006,394839,25.29273,1561077
25908,madhupmanihp,1,0.00006,394840,25.29279,1561077
25909,madhurinalluri,1,0.00006,394841,25.29286,1561077
25910,madihakh,1,0.00006,394842,25.29292,1561077
25911,madkroll,1,0.00006,394843,25.29299,1561077
25912,madmanidze,1,0.00006,394844,25.29305,1561077
25913,madmobilemike,1,0.00006,394845,25.29311,1561077
25914,madpipeline,1,0.00006,394846,25.29318,1561077
25915,MadsAndreasen,1,0.00006,394847,25.29324,1561077
25916,Maduflavins,1,0.00006,394848,25.29331,1561077
25917,madwyn,1,0.00006,394849,25.29337,1561077
25918,magevadi,1,0.00006,394850,25.29344,1561077
25919,maggnus,1,0.00006,394851,25.29350,1561077
25920,magicians2019,1,0.00006,394852,25.29356,1561077
25921,magicpds,1,0.00006,394853,25.29363,1561077
25922,magine1989,1,0.00006,394854,25.29369,1561077
25923,magixyu,1,0.00006,394855,25.29376,1561077
25924,magjac,1,0.00006,394856,25.29382,1561077
25925,magnuhho,1,0.00006,394857,25.29388,1561077
25926,magro,1,0.00006,394858,25.29395,1561077
25927,magus031,1,0.00006,394859,25.29401,1561077
25928,mahaase,1,0.00006,394860,25.29408,1561077
25929,mahaffey,1,0.00006,394861,25.29414,1561077
25930,mahaodong6318,1,0.00006,394862,25.29420,1561077
25931,mahdihijazi,1,0.00006,394863,25.29427,1561077
25932,mahehwagh29,1,0.00006,394864,25.29433,1561077
25933,mahendrans,1,0.00006,394865,25.29440,1561077
25934,mahendrarathod,1,0.00006,394866,25.29446,1561077
25935,mahernandezp,1,0.00006,394867,25.29452,1561077
25936,MaheshGooner,1,0.00006,394868,25.29459,1561077
25937,MAHESH-HASBI,1,0.00006,394869,25.29465,1561077
25938,mahileeb,1,0.00006,394870,25.29472,1561077
25939,mahmoud-samy,1,0.00006,394871,25.29478,1561077
25940,mahmoudshuaibi,1,0.00006,394872,25.29484,1561077
25941,mahp,1,0.00006,394873,25.29491,1561077
25942,mahsa-frj,1,0.00006,394874,25.29497,1561077
25943,mahyarv,1,0.00006,394875,25.29504,1561077
25944,maikebertpsc,1,0.00006,394876,25.29510,1561077
25945,MaikoHermans,1,0.00006,394877,25.29516,1561077
25946,Maikol,1,0.00006,394878,25.29523,1561077
25947,mailjunze,1,0.00006,394879,25.29529,1561077
25948,mailtosmyk,1,0.00006,394880,25.29536,1561077
25949,Maisteru,1,0.00006,394881,25.29542,1561077
25950,majhe,1,0.00006,394882,25.29549,1561077
25951,majid78,1,0.00006,394883,25.29555,1561077
25952,MajoraBora,1,0.00006,394884,25.29561,1561077
25953,majorgear,1,0.00006,394885,25.29568,1561077
25954,majszak,1,0.00006,394886,25.29574,1561077
25955,majusmisiak,1,0.00006,394887,25.29581,1561077
25956,makemesteaks,1,0.00006,394888,25.29587,1561077
25957,maker2413,1,0.00006,394889,25.29593,1561077
25958,makii42,1,0.00006,394890,25.29600,1561077
25959,makiolo,1,0.00006,394891,25.29606,1561077
25960,Makr91,1,0.00006,394892,25.29613,1561077
25961,makshop99,1,0.00006,394893,25.29619,1561077
25962,MaksTuev,1,0.00006,394894,25.29625,1561077
25963,maktup,1,0.00006,394895,25.29632,1561077
25964,malachid,1,0.00006,394896,25.29638,1561077
25965,malachiobadeyi,1,0.00006,394897,25.29645,1561077
25966,malaikah,1,0.00006,394898,25.29651,1561077
25967,malaoui79,1,0.00006,394899,25.29657,1561077
25968,malatesh-prodapt,1,0.00006,394900,25.29664,1561077
25969,MALATHI02,1,0.00006,394901,25.29670,1561077
25970,Malcolmnixon,1,0.00006,394902,25.29677,1561077
25971,malcops,1,0.00006,394903,25.29683,1561077
25972,malinoff,1,0.00006,394904,25.29689,1561077
25973,malins,1,0.00006,394905,25.29696,1561077
25974,malli312,1,0.00006,394906,25.29702,1561077
25975,mallikarjunece,1,0.00006,394907,25.29709,1561077
25976,mallocator,1,0.00006,394908,25.29715,1561077
25977,Mallow15,1,0.00006,394909,25.29721,1561077
25978,maloups,1,0.00006,394910,25.29728,1561077
25979,malteburkert,1,0.00006,394911,25.29734,1561077
25980,maltefiala,1,0.00006,394912,25.29741,1561077
25981,maltesermailo,1,0.00006,394913,25.29747,1561077
25982,mamantoha,1,0.00006,394914,25.29753,1561077
25983,mamghari,1,0.00006,394915,25.29760,1561077
25984,mamkkl,1,0.00006,394916,25.29766,1561077
25985,mamuf,1,0.00006,394917,25.29773,1561077
25986,manapanigrahi,1,0.00006,394918,25.29779,1561077
25987,manchot0,1,0.00006,394919,25.29786,1561077
25988,mandana10,1,0.00006,394920,25.29792,1561077
25989,mandiiip,1,0.00006,394921,25.29798,1561077
25990,mandoode,1,0.00006,394922,25.29805,1561077
25991,mandracke1976,1,0.00006,394923,25.29811,1561077
25992,mandrije,1,0.00006,394924,25.29818,1561077
25993,maneamarius,1,0.00006,394925,25.29824,1561077
25994,maneetgoyal,1,0.00006,394926,25.29830,1561077
25995,maneilldev,1,0.00006,394927,25.29837,1561077
25996,mangum99,1,0.00006,394928,25.29843,1561077
25997,Mani2693,1,0.00006,394929,25.29850,1561077
25998,maniaczek,1,0.00006,394930,25.29856,1561077
25999,MaNicolas,1,0.00006,394931,25.29862,1561077
26000,manihamza01,1,0.00006,394932,25.29869,1561077
26001,Manikanta-Reddy-Pasala,1,0.00006,394933,25.29875,1561077
26002,manikarnam,1,0.00006,394934,25.29882,1561077
26003,maninder-singh,1,0.00006,394935,25.29888,1561077
26004,manish1512,1,0.00006,394936,25.29894,1561077
26005,manish-devops,1,0.00006,394937,25.29901,1561077
26006,manishgoyaler,1,0.00006,394938,25.29907,1561077
26007,manisinghopsmx,1,0.00006,394939,25.29914,1561077
26008,manju6691,1,0.00006,394940,25.29920,1561077
26009,ManjuAsthuthe,1,0.00006,394941,25.29926,1561077
26010,Manjunath91,1,0.00006,394942,25.29933,1561077
26011,ManjunathRNayak,1,0.00006,394943,25.29939,1561077
26012,manjunathsoftwares,1,0.00006,394944,25.29946,1561077
26013,mannee,1,0.00006,394945,25.29952,1561077
26014,ManneW,1,0.00006,394946,25.29958,1561077
26015,mannyci,1,0.00006,394947,25.29965,1561077
26016,MANOHAR452,1,0.00006,394948,25.29971,1561077
26017,Manoj21333,1,0.00006,394949,25.29978,1561077
26018,Manojgoud11111,1,0.00006,394950,25.29984,1561077
26019,manojkumar405,1,0.00006,394951,25.29991,1561077
26020,manojmsrit,1,0.00006,394952,25.29997,1561077
26021,Manojvnair1,1,0.00006,394953,25.30003,1561077
26022,mans0954,1,0.00006,394954,25.30010,1561077
26023,manthang,1,0.00006,394955,25.30016,1561077
26024,manthasiddartha,1,0.00006,394956,25.30023,1561077
26025,manthasri,1,0.00006,394957,25.30029,1561077
26026,Manuel83,1,0.00006,394958,25.30035,1561077
26027,manuelaguir,1,0.00006,394959,25.30042,1561077
26028,manueliglesiasgarcia,1,0.00006,394960,25.30048,1561077
26029,manuinsfx,1,0.00006,394961,25.30055,1561077
26030,ManuOjha,1,0.00006,394962,25.30061,1561077
26031,manupgup,1,0.00006,394963,25.30067,1561077
26032,manuschillerdev,1,0.00006,394964,25.30074,1561077
26033,ManvendraFlipkart,1,0.00006,394965,25.30080,1561077
26034,manyagoyal12,1,0.00006,394966,25.30087,1561077
26035,maobaolong,1,0.00006,394967,25.30093,1561077
26036,maomaoaichirou,1,0.00006,394968,25.30099,1561077
26037,maopaolinux,1,0.00006,394969,25.30106,1561077
26038,maoueh,1,0.00006,394970,25.30112,1561077
26039,maozturk,1,0.00006,394971,25.30119,1561077
26040,mapham,1,0.00006,394972,25.30125,1561077
26041,maps90,1,0.00006,394973,25.30131,1561077
26042,mapusa1415daw2,1,0.00006,394974,25.30138,1561077
26043,maquino1985,1,0.00006,394975,25.30144,1561077
26044,Marachkouski,1,0.00006,394976,25.30151,1561077
26045,Maragues,1,0.00006,394977,25.30157,1561077
26046,maragues-kolibree,1,0.00006,394978,25.30163,1561077
26047,marble-ma,1,0.00006,394979,25.30170,1561077
26048,marblenix,1,0.00006,394980,25.30176,1561077
26049,marbon87,1,0.00006,394981,25.30183,1561077
26050,Marc43,1,0.00006,394982,25.30189,1561077
26051,marcecaro,1,0.00006,394983,25.30195,1561077
26052,marcelbrueckner,1,0.00006,394984,25.30202,1561077
26053,marcel-dias,1,0.00006,394985,25.30208,1561077
26054,MarcelFortunato,1,0.00006,394986,25.30215,1561077
26055,marcel-hamer,1,0.00006,394987,25.30221,1561077
26056,marcelin,1,0.00006,394988,25.30228,1561077
26057,marcel-kondermann,1,0.00006,394989,25.30234,1561077
26058,marcelloromani,1,0.00006,394990,25.30240,1561077
26059,marceloaguero,1,0.00006,394991,25.30247,1561077
26060,MarcelRaad,1,0.00006,394992,25.30253,1561077
26061,marcemv90,1,0.00006,394993,25.30260,1561077
26062,MarcG-CAE,1,0.00006,394994,25.30266,1561077
26063,Marche86,1,0.00006,394995,25.30272,1561077
26064,marchof,1,0.00006,394996,25.30279,1561077
26065,marciejones,1,0.00006,394997,25.30285,1561077
26066,MarcinCz,1,0.00006,394998,25.30292,1561077
26067,MarcioCruzTR,1,0.00006,394999,25.30298,1561077
26068,MarcioPaulo,1,0.00006,395000,25.30304,1561077
26069,marco-brandizi,1,0.00006,395001,25.30311,1561077
26070,marco-dev,1,0.00006,395002,25.30317,1561077
26071,MarcoDima,1,0.00006,395003,25.30324,1561077
26072,marcofiocco,1,0.00006,395004,25.30330,1561077
26073,marcohald,1,0.00006,395005,25.30336,1561077
26074,marco-luzzara,1,0.00006,395006,25.30343,1561077
26075,marcopiraccini,1,0.00006,395007,25.30349,1561077
26076,marcosArruda,1,0.00006,395008,25.30356,1561077
26077,marcospedreiro,1,0.00006,395009,25.30362,1561077
26078,marcosvrs,1,0.00006,395010,25.30368,1561077
26079,marcusl,1,0.00006,395011,25.30375,1561077
26080,marcus-lim-lrn,1,0.00006,395012,25.30381,1561077
26081,marcuspen,1,0.00006,395013,25.30388,1561077
26082,Marcux83,1,0.00006,395014,25.30394,1561077
26083,marcv81,1,0.00006,395015,25.30400,1561077
26084,mardicas,1,0.00006,395016,25.30407,1561077
26085,mareckii,1,0.00006,395017,25.30413,1561077
26086,marekdovjak,1,0.00006,395018,25.30420,1561077
26087,marekkopecky,1,0.00006,395019,25.30426,1561077
26088,MarekLani,1,0.00006,395020,25.30433,1561077
26089,marek-sezemsky,1,0.00006,395021,25.30439,1561077
26090,marekvesely-direct,1,0.00006,395022,25.30445,1561077
26091,MarekZa,1,0.00006,395023,25.30452,1561077
26092,Mareron,1,0.00006,395024,25.30458,1561077
26093,mareths,1,0.00006,395025,25.30465,1561077
26094,maretodoric,1,0.00006,395026,25.30471,1561077
26095,marfous,1,0.00006,395027,25.30477,1561077
26096,margeaux-gendron,1,0.00006,395028,25.30484,1561077
26097,mariachugunova,1,0.00006,395029,25.30490,1561077
26098,mariafleetwood,1,0.00006,395030,25.30497,1561077
26099,mariam606,1,0.00006,395031,25.30503,1561077
26100,marianob85,1,0.00006,395032,25.30509,1561077
26101,marianobilli,1,0.00006,395033,25.30516,1561077
26102,marianpetrikesg,1,0.00006,395034,25.30522,1561077
26103,mario21ic,1,0.00006,395035,25.30529,1561077
26104,MarioArgus,1,0.00006,395036,25.30535,1561077
26105,mariodu,1,0.00006,395037,25.30541,1561077
26106,mariogrip,1,0.00006,395038,25.30548,1561077
26107,mariolcakalli,1,0.00006,395039,25.30554,1561077
26108,mario-mazo,1,0.00006,395040,25.30561,1561077
26109,mariombq,1,0.00006,395041,25.30567,1561077
26110,mario-rivas-telus,1,0.00006,395042,25.30573,1561077
26111,marissa-halpert,1,0.00006,395043,25.30580,1561077
26112,MariusVolkhart,1,0.00006,395044,25.30586,1561077
26113,mark0978,1,0.00006,395045,25.30593,1561077
26114,mark0n,1,0.00006,395046,25.30599,1561077
26115,mark2000141230,1,0.00006,395047,25.30605,1561077
26116,markba,1,0.00006,395048,25.30612,1561077
26117,markbastiaans,1,0.00006,395049,25.30618,1561077
26118,markbsigler,1,0.00006,395050,25.30625,1561077
26119,markdemich,1,0.00006,395051,25.30631,1561077
26120,markeloff86,1,0.00006,395052,25.30638,1561077
26121,markentelo,1,0.00006,395053,25.30644,1561077
26122,markgargan,1,0.00006,395054,25.30650,1561077
26123,markhicken,1,0.00006,395055,25.30657,1561077
26124,markhuangext359,1,0.00006,395056,25.30663,1561077
26125,markhuyong,1,0.00006,395057,25.30670,1561077
26126,marklasater,1,0.00006,395058,25.30676,1561077
26127,markobogoevski,1,0.00006,395059,25.30682,1561077
26128,markperdue,1,0.00006,395060,25.30689,1561077
26129,markpiersak,1,0.00006,395061,25.30695,1561077
26130,markrileybot,1,0.00006,395062,25.30702,1561077
26131,MarkSJones,1,0.00006,395063,25.30708,1561077
26132,markusbergh,1,0.00006,395064,25.30714,1561077
26133,markuschen,1,0.00006,395065,25.30721,1561077
26134,markusheiden,1,0.00006,395066,25.30727,1561077
26135,markusheikkinen,1,0.00006,395067,25.30734,1561077
26136,markus-meisterernst,1,0.00006,395068,25.30740,1561077
26137,MarkusPalcer,1,0.00006,395069,25.30746,1561077
26138,MarkusStrand,1,0.00006,395070,25.30753,1561077
26139,markvarga91,1,0.00006,395071,25.30759,1561077
26140,markya0616,1,0.00006,395072,25.30766,1561077
26141,marmarama,1,0.00006,395073,25.30772,1561077
26142,MaroonedMind,1,0.00006,395074,25.30778,1561077
26143,MarouaneZhani,1,0.00006,395075,25.30785,1561077
26144,Marqo09,1,0.00006,395076,25.30791,1561077
26145,Mars709,1,0.00006,395077,25.30798,1561077
26146,marselsultanov,1,0.00006,395078,25.30804,1561077
26147,marsewe,1,0.00006,395079,25.30810,1561077
26148,marshall-prosperworks,1,0.00006,395080,25.30817,1561077
26149,martijan2020,1,0.00006,395081,25.30823,1561077
26150,martijnhjk,1,0.00006,395082,25.30830,1561077
26151,MartijnKaijser,1,0.00006,395083,25.30836,1561077
26152,martijnvanduijneveldt,1,0.00006,395084,25.30842,1561077
26153,martin1yness,1,0.00006,395085,25.30849,1561077
26154,martin-armory,1,0.00006,395086,25.30855,1561077
26155,martincermak,1,0.00006,395087,25.30862,1561077
26156,MartinCerny-awin,1,0.00006,395088,25.30868,1561077
26157,martinco,1,0.00006,395089,25.30875,1561077
26158,martindimitrov-taulia,1,0.00006,395090,25.30881,1561077
26159,martin-g,1,0.00006,395091,25.30887,1561077
26160,martingrambow,1,0.00006,395092,25.30894,1561077
26161,martinheg,1,0.00006,395093,25.30900,1561077
26162,MartinHerren,1,0.00006,395094,25.30907,1561077
26163,MartinJohns,1,0.00006,395095,25.30913,1561077
26164,MartinKeprta,1,0.00006,395096,25.30919,1561077
26165,martin-kirilov,1,0.00006,395097,25.30926,1561077
26166,martinnirtl,1,0.00006,395098,25.30932,1561077
26167,MartinNuc,1,0.00006,395099,25.30939,1561077
26168,martinohmann,1,0.00006,395100,25.30945,1561077
26169,martino-jelli,1,0.00006,395101,25.30951,1561077
26170,MartinPape,1,0.00006,395102,25.30958,1561077
26171,martinpritchard,1,0.00006,395103,25.30964,1561077
26172,martinsefcik,1,0.00006,395104,25.30971,1561077
26173,martinzding,1,0.00006,395105,25.30977,1561077
26174,martku,1,0.00006,395106,25.30983,1561077
26175,martmalo,1,0.00006,395107,25.30990,1561077
26176,martonivan,1,0.00006,395108,25.30996,1561077
26177,martukas,1,0.00006,395109,25.31003,1561077
26178,Marty,1,0.00006,395110,25.31009,1561077
26179,martyngigg,1,0.00006,395111,25.31015,1561077
26180,marubinotto,1,0.00006,395112,25.31022,1561077
26181,marvinruder,1,0.00006,395113,25.31028,1561077
26182,MarvinSchramm,1,0.00006,395114,25.31035,1561077
26183,maryamheni,1,0.00006,395115,25.31041,1561077
26184,marycats,1,0.00006,395116,25.31047,1561077
26185,marykay25,1,0.00006,395117,25.31054,1561077
26186,marytanfin,1,0.00006,395118,25.31060,1561077
26187,mas0061,1,0.00006,395119,25.31067,1561077
26188,mas-chen,1,0.00006,395120,25.31073,1561077
26189,maschuru,1,0.00006,395121,25.31080,1561077
26190,masonCaminer,1,0.00006,395122,25.31086,1561077
26191,masonwr,1,0.00006,395123,25.31092,1561077
26192,massimo-salidu,1,0.00006,395124,25.31099,1561077
26193,masstat,1,0.00006,395125,25.31105,1561077
26194,Master-An,1,0.00006,395126,25.31112,1561077
26195,masterhampel,1,0.00006,395127,25.31118,1561077
26196,masterheph,1,0.00006,395128,25.31124,1561077
26197,masterjk,1,0.00006,395129,25.31131,1561077
26198,masterrrp,1,0.00006,395130,25.31137,1561077
26199,MasterShihoChief,1,0.00006,395131,25.31144,1561077
26200,mat128,1,0.00006,395132,25.31150,1561077
26201,matandomuertos,1,0.00006,395133,25.31156,1561077
26202,matason,1,0.00006,395134,25.31163,1561077
26203,matchand-nokia,1,0.00006,395135,25.31169,1561077
26204,mateiQA,1,0.00006,395136,25.31176,1561077
26205,matejar,1,0.00006,395137,25.31182,1561077
26206,mateuspegoraro,1,0.00006,395138,25.31188,1561077
26207,MateusVMachado,1,0.00006,395139,25.31195,1561077
26208,mateuszboryn,1,0.00006,395140,25.31201,1561077
26209,mathbunnyru,1,0.00006,395141,25.31208,1561077
26210,mathcoder23,1,0.00006,395142,25.31214,1561077
26211,matheuscmelo,1,0.00006,395143,25.31220,1561077
26212,matheusrgomes,1,0.00006,395144,25.31227,1561077
26213,matheusrizzo,1,0.00006,395145,25.31233,1561077
26214,mathew-fleisch,1,0.00006,395146,25.31240,1561077
26215,mathiaskinzler,1,0.00006,395147,25.31246,1561077
26216,Mathieu-Steininger,1,0.00006,395148,25.31252,1561077
26217,mathroc,1,0.00006,395149,25.31259,1561077
26218,matiasholte,1,0.00006,395150,25.31265,1561077
26219,Matias-sys,1,0.00006,395151,25.31272,1561077
26220,matil019,1,0.00006,395152,25.31278,1561077
26221,matJC,1,0.00006,395153,25.31284,1561077
26222,matope,1,0.00006,395154,25.31291,1561077
26223,matpzu,1,0.00006,395155,25.31297,1561077
26224,Matrixvlore911,1,0.00006,395156,25.31304,1561077
26225,matsbov,1,0.00006,395157,25.31310,1561077
26226,matsprehn,1,0.00006,395158,25.31317,1561077
26227,matstatman,1,0.00006,395159,25.31323,1561077
26228,Matt029847294,1,0.00006,395160,25.31329,1561077
26229,matt2000,1,0.00006,395161,25.31336,1561077
26230,mattcolman,1,0.00006,395162,25.31342,1561077
26231,mattcovert,1,0.00006,395163,25.31349,1561077
26232,mattdjones,1,0.00006,395164,25.31355,1561077
26233,matt-duke,1,0.00006,395165,25.31361,1561077
26234,matt-fevold,1,0.00006,395166,25.31368,1561077
26235,MattFriedmanAfilias,1,0.00006,395167,25.31374,1561077
26236,mattgrayling,1,0.00006,395168,25.31381,1561077
26237,matthenry87,1,0.00006,395169,25.31387,1561077
26238,matthewhagel,1,0.00006,395170,25.31393,1561077
26239,matthewlowry,1,0.00006,395171,25.31400,1561077
26240,matthewmccollom,1,0.00006,395172,25.31406,1561077
26241,matthiasklein,1,0.00006,395173,25.31413,1561077
26242,matthiasstock,1,0.00006,395174,25.31419,1561077
26243,matthiasthieroff,1,0.00006,395175,25.31425,1561077
26244,MatthieuCoder,1,0.00006,395176,25.31432,1561077
26245,matthieugauthier,1,0.00006,395177,25.31438,1561077
26246,matthijsvdr,1,0.00006,395178,25.31445,1561077
26247,mattiasmgn,1,0.00006,395179,25.31451,1561077
26248,MattJustMatt,1,0.00006,395180,25.31457,1561077
26249,mattmoskwa,1,0.00006,395181,25.31464,1561077
26250,mattnelson,1,0.00006,395182,25.31470,1561077
26251,mattoolprawin,1,0.00006,395183,25.31477,1561077
26252,mattphi,1,0.00006,395184,25.31483,1561077
26253,mattr-,1,0.00006,395185,25.31489,1561077
26254,mattrochon,1,0.00006,395186,25.31496,1561077
26255,matts19,1,0.00006,395187,25.31502,1561077
26256,mattsch,1,0.00006,395188,25.31509,1561077
26257,mattsee,1,0.00006,395189,25.31515,1561077
26258,mattthaber,1,0.00006,395190,25.31522,1561077
26259,mat-work,1,0.00006,395191,25.31528,1561077
26260,MauBoy,1,0.00006,395192,25.31534,1561077
26261,maudineormsby,1,0.00006,395193,25.31541,1561077
26262,maulik-modi,1,0.00006,395194,25.31547,1561077
26263,MauricioPenteado,1,0.00006,395195,25.31554,1561077
26264,maurofaccenda,1,0.00006,395196,25.31560,1561077
26265,mauromedda,1,0.00006,395197,25.31566,1561077
26266,mavaishn,1,0.00006,395198,25.31573,1561077
26267,max-allan-surevine,1,0.00006,395199,25.31579,1561077
26268,maxamj,1,0.00006,395200,25.31586,1561077
26269,maxbalan,1,0.00006,395201,25.31592,1561077
26270,maxbr,1,0.00006,395202,25.31598,1561077
26271,MaxDesiatov,1,0.00006,395203,25.31605,1561077
26272,MaxDobbelstein,1,0.00006,395204,25.31611,1561077
26273,maxfouquet,1,0.00006,395205,25.31618,1561077
26274,maxhille,1,0.00006,395206,25.31624,1561077
26275,maximann,1,0.00006,395207,25.31630,1561077
26276,maxime066,1,0.00006,395208,25.31637,1561077
26277,maxime-viargues-serato,1,0.00006,395209,25.31643,1561077
26278,maxim-filkov,1,0.00006,395210,25.31650,1561077
26279,MaximilienRedemption,1,0.00006,395211,25.31656,1561077
26280,maximindsl,1,0.00006,395212,25.31662,1561077
26281,maximmold,1,0.00006,395213,25.31669,1561077
26282,maxlmo,1,0.00006,395214,25.31675,1561077
26283,max-l-weaver,1,0.00006,395215,25.31682,1561077
26284,MaxmaxB,1,0.00006,395216,25.31688,1561077
26285,maxmeyer,1,0.00006,395217,25.31694,1561077
26286,maxnis,1,0.00006,395218,25.31701,1561077
26287,Maxo112,1,0.00006,395219,25.31707,1561077
26288,maxsarath,1,0.00006,395220,25.31714,1561077
26289,Max-Sundar-vine,1,0.00006,395221,25.31720,1561077
26290,maxveit,1,0.00006,395222,25.31726,1561077
26291,maxwellleonardo,1,0.00006,395223,25.31733,1561077
26292,maxwellmckinnon,1,0.00006,395224,25.31739,1561077
26293,Mayankg7,1,0.00006,395225,25.31746,1561077
26294,mayankkhullar,1,0.00006,395226,25.31752,1561077
26295,mayankporwal08,1,0.00006,395227,25.31759,1561077
26296,mayank-sfdc,1,0.00006,395228,25.31765,1561077
26297,Mayanktiwari16,1,0.00006,395229,25.31771,1561077
26298,mayasnayak,1,0.00006,395230,25.31778,1561077
26299,MayCisco,1,0.00006,395231,25.31784,1561077
26300,Maydell,1,0.00006,395232,25.31791,1561077
26301,mayeco,1,0.00006,395233,25.31797,1561077
26302,maygic23,1,0.00006,395234,25.31803,1561077
26303,mayukh-sarkar-1,1,0.00006,395235,25.31810,1561077
26304,mayur-who,1,0.00006,395236,25.31816,1561077
26305,mazhewei,1,0.00006,395237,25.31823,1561077
26306,mbaas2,1,0.00006,395238,25.31829,1561077
26307,mbakgun,1,0.00006,395239,25.31835,1561077
26308,mbalaa-spring,1,0.00006,395240,25.31842,1561077
26309,mbaluda,1,0.00006,395241,25.31848,1561077
26310,mbaquer6,1,0.00006,395242,25.31855,1561077
26311,mbascus,1,0.00006,395243,25.31861,1561077
26312,mbasri,1,0.00006,395244,25.31867,1561077
26313,MbaZZ,1,0.00006,395245,25.31874,1561077
26314,mbeacom,1,0.00006,395246,25.31880,1561077
26315,mbennettcanada,1,0.00006,395247,25.31887,1561077
26316,mbmarosii,1,0.00006,395248,25.31893,1561077
26317,mbongale,1,0.00006,395249,25.31899,1561077
26318,mbraku,1,0.00006,395250,25.31906,1561077
26319,mbravo-cbw,1,0.00006,395251,25.31912,1561077
26320,mbriand,1,0.00006,395252,25.31919,1561077
26321,mbrmj,1,0.00006,395253,25.31925,1561077
26322,mbrostami,1,0.00006,395254,25.31931,1561077
26323,mbsamuels,1,0.00006,395255,25.31938,1561077
26324,mbtc100,1,0.00006,395256,25.31944,1561077
26325,mbtronics,1,0.00006,395257,25.31951,1561077
26326,m-bucher,1,0.00006,395258,25.31957,1561077
26327,mby-che,1,0.00006,395259,25.31964,1561077
26328,mc7857,1,0.00006,395260,25.31970,1561077
26329,mcambal,1,0.00006,395261,25.31976,1561077
26330,mcasperson,1,0.00006,395262,25.31983,1561077
26331,mcbanderson,1,0.00006,395263,25.31989,1561077
26332,mcclee,1,0.00006,395264,25.31996,1561077
26333,mcclellansws,1,0.00006,395265,25.32002,1561077
26334,mcgonagle,1,0.00006,395266,25.32008,1561077
26335,mcgrogan91,1,0.00006,395267,25.32015,1561077
26336,mchatt,1,0.00006,395268,25.32021,1561077
26337,mchelen,1,0.00006,395269,25.32028,1561077
26338,mchirag2002,1,0.00006,395270,25.32034,1561077
26339,mchoma,1,0.00006,395271,25.32040,1561077
26340,mchumakov,1,0.00006,395272,25.32047,1561077
26341,mcinnes01,1,0.00006,395273,25.32053,1561077
26342,McKAnt,1,0.00006,395274,25.32060,1561077
26343,mcmarkj,1,0.00006,395275,25.32066,1561077
26344,mcmarto,1,0.00006,395276,25.32072,1561077
26345,mcncyo,1,0.00006,395277,25.32079,1561077
26346,McNetic,1,0.00006,395278,25.32085,1561077
26347,McNouvion,1,0.00006,395279,25.32092,1561077
26348,mcohen,1,0.00006,395280,25.32098,1561077
26349,mcote55,1,0.00006,395281,25.32104,1561077
26350,mcpaint,1,0.00006,395282,25.32111,1561077
26351,mcw0933,1,0.00006,395283,25.32117,1561077
26352,mdasifhasan,1,0.00006,395284,25.32124,1561077
26353,M-Davies,1,0.00006,395285,25.32130,1561077
26354,mdb23inc,1,0.00006,395286,25.32136,1561077
26355,mdcme,1,0.00006,395287,25.32143,1561077
26356,mdenicki,1,0.00006,395288,25.32149,1561077
26357,mderaspe,1,0.00006,395289,25.32156,1561077
26358,mdfaller,1,0.00006,395290,25.32162,1561077
26359,mdholloway,1,0.00006,395291,25.32168,1561077
26360,mdiberardino-atlassian,1,0.00006,395292,25.32175,1561077
26361,mding5692,1,0.00006,395293,25.32181,1561077
26362,mdio,1,0.00006,395294,25.32188,1561077
26363,mdk194,1,0.00006,395295,25.32194,1561077
26364,mdkbdg,1,0.00006,395296,25.32201,1561077
26365,mdoninger,1,0.00006,395297,25.32207,1561077
26366,mdouek,1,0.00006,395298,25.32213,1561077
26367,mdpdesign,1,0.00006,395299,25.32220,1561077
26368,mdraijer,1,0.00006,395300,25.32226,1561077
26369,mdres,1,0.00006,395301,25.32233,1561077
26370,me42th,1,0.00006,395302,25.32239,1561077
26371,Meabed,1,0.00006,395303,25.32245,1561077
26372,meakashkharat,1,0.00006,395304,25.32252,1561077
26373,meAtfinleap,1,0.00006,395305,25.32258,1561077
26374,mebays,1,0.00006,395306,25.32265,1561077
26375,MEBrach,1,0.00006,395307,25.32271,1561077
26376,mechaHarry,1,0.00006,395308,25.32277,1561077
26377,Mechazawa,1,0.00006,395309,25.32284,1561077
26378,mecorusfc,1,0.00006,395310,25.32290,1561077
26379,medanets-admin,1,0.00006,395311,25.32297,1561077
26380,MedeilPlusCloudCust,1,0.00006,395312,25.32303,1561077
26381,medicce,1,0.00006,395313,25.32309,1561077
26382,medicharlachiranjeevi,1,0.00006,395314,25.32316,1561077
26383,medvedev1088,1,0.00006,395315,25.32322,1561077
26384,medvedev-evgeny,1,0.00006,395316,25.32329,1561077
26385,meeee,1,0.00006,395317,25.32335,1561077
26386,Meems33,1,0.00006,395318,25.32341,1561077
26387,meer0h,1,0.00006,395319,25.32348,1561077
26388,meeximum,1,0.00006,395320,25.32354,1561077
26389,megamingus,1,0.00006,395321,25.32361,1561077
26390,megazoll,1,0.00006,395322,25.32367,1561077
26391,MeghaPrasad,1,0.00006,395323,25.32373,1561077
26392,MeghaTek,1,0.00006,395324,25.32380,1561077
26393,mehiel,1,0.00006,395325,25.32386,1561077
26394,mehuldmehta,1,0.00006,395326,25.32393,1561077
26395,meiyuanli,1,0.00006,395327,25.32399,1561077
26396,Mei-Zhao,1,0.00006,395328,25.32406,1561077
26397,meizon,1,0.00006,395329,25.32412,1561077
26398,mekdev,1,0.00006,395330,25.32418,1561077
26399,melaronquillo,1,0.00006,395331,25.32425,1561077
26400,Mel-Github,1,0.00006,395332,25.32431,1561077
26401,Melinda94,1,0.00006,395333,25.32438,1561077
26402,melissaw,1,0.00006,395334,25.32444,1561077
26403,meljbruno,1,0.00006,395335,25.32450,1561077
26404,mellardc,1,0.00006,395336,25.32457,1561077
26405,Mellentin,1,0.00006,395337,25.32463,1561077
26406,meltingturret,1,0.00006,395338,25.32470,1561077
26407,Melvillian,1,0.00006,395339,25.32476,1561077
26408,mengdahuang,1,0.00006,395340,25.32482,1561077
26409,mennomenno,1,0.00006,395341,25.32489,1561077
26410,meotch,1,0.00006,395342,25.32495,1561077
26411,MEPhoenyx,1,0.00006,395343,25.32502,1561077
26412,meraj97,1,0.00006,395344,25.32508,1561077
26413,Merikanto,1,0.00006,395345,25.32514,1561077
26414,merlin66,1,0.00006,395346,25.32521,1561077
26415,merlineus,1,0.00006,395347,25.32527,1561077
26416,merolinpeter,1,0.00006,395348,25.32534,1561077
26417,mervynzhang,1,0.00006,395349,25.32540,1561077
26418,merykozlowska,1,0.00006,395350,25.32546,1561077
26419,messelmanibrahim,1,0.00006,395351,25.32553,1561077
26420,mestar99,1,0.00006,395352,25.32559,1561077
26421,metacubeqa,1,0.00006,395353,25.32566,1561077
26422,METAJIJI,1,0.00006,395354,25.32572,1561077
26423,metametadata,1,0.00006,395355,25.32578,1561077
26424,mfabricanti,1,0.00006,395356,25.32585,1561077
26425,mfeliciano,1,0.00006,395357,25.32591,1561077
26426,m-ferrero,1,0.00006,395358,25.32598,1561077
26427,mfolnovic,1,0.00006,395359,25.32604,1561077
26428,mfominov,1,0.00006,395360,25.32610,1561077
26429,mfranklin1,1,0.00006,395361,25.32617,1561077
26430,MF-ReStart,1,0.00006,395362,25.32623,1561077
26431,mfussenegger,1,0.00006,395363,25.32630,1561077
26432,mfwatts,1,0.00006,395364,25.32636,1561077
26433,mgambini,1,0.00006,395365,25.32643,1561077
26434,mgarratt,1,0.00006,395366,25.32649,1561077
26435,mgarzone,1,0.00006,395367,25.32655,1561077
26436,mgaunard,1,0.00006,395368,25.32662,1561077
26437,mghignet,1,0.00006,395369,25.32668,1561077
26438,mginou,1,0.00006,395370,25.32675,1561077
26439,mgodwin,1,0.00006,395371,25.32681,1561077
26440,mgonzal1,1,0.00006,395372,25.32687,1561077
26441,mgonzalezarkho,1,0.00006,395373,25.32694,1561077
26442,mgrechukh,1,0.00006,395374,25.32700,1561077
26443,mgrzechocinski,1,0.00006,395375,25.32707,1561077
26444,mgrzybek,1,0.00006,395376,25.32713,1561077
26445,mgundel,1,0.00006,395377,25.32719,1561077
26446,mgunjan,1,0.00006,395378,25.32726,1561077
26447,mhaas,1,0.00006,395379,25.32732,1561077
26448,mhalder,1,0.00006,395380,25.32739,1561077
26449,mharsing,1,0.00006,395381,25.32745,1561077
26450,mhazy,1,0.00006,395382,25.32751,1561077
26451,mheiges,1,0.00006,395383,25.32758,1561077
26452,mhelff,1,0.00006,395384,25.32764,1561077
26453,mhelgren,1,0.00006,395385,25.32771,1561077
26454,mhelmer,1,0.00006,395386,25.32777,1561077
26455,mherbert25,1,0.00006,395387,25.32783,1561077
26456,mhier,1,0.00006,395388,25.32790,1561077
26457,mhinc14,1,0.00006,395389,25.32796,1561077
26458,mhsbb,1,0.00006,395390,25.32803,1561077
26459,mhuijgen,1,0.00006,395391,25.32809,1561077
26460,mhuisman,1,0.00006,395392,25.32815,1561077
26461,miadabrin,1,0.00006,395393,25.32822,1561077
26462,mibeumer,1,0.00006,395394,25.32828,1561077
26463,mibrahim-github-cloud,1,0.00006,395395,25.32835,1561077
26464,mibzzz,1,0.00006,395396,25.32841,1561077
26465,micaelgallego,1,0.00006,395397,25.32848,1561077
26466,micc10,1,0.00006,395398,25.32854,1561077
26467,michaalm,1,0.00006,395399,25.32860,1561077
26468,Michad,1,0.00006,395400,25.32867,1561077
26469,michaelarichard,1,0.00006,395401,25.32873,1561077
26470,MichaelBell1990,1,0.00006,395402,25.32880,1561077
26471,michaelbenoit,1,0.00006,395403,25.32886,1561077
26472,MichaelBMiner,1,0.00006,395404,25.32892,1561077
26473,michaelcox,1,0.00006,395405,25.32899,1561077
26474,michaeldahlke,1,0.00006,395406,25.32905,1561077
26475,Michael-Downton,1,0.00006,395407,25.32912,1561077
26476,micha-eleric,1,0.00006,395408,25.32918,1561077
26477,michael-fredrickson,1,0.00006,395409,25.32924,1561077
26478,michaelfward,1,0.00006,395410,25.32931,1561077
26479,michael-hay,1,0.00006,395411,25.32937,1561077
26480,michaelkrog,1,0.00006,395412,25.32944,1561077
26481,michaelkuty,1,0.00006,395413,25.32950,1561077
26482,michael-mohemian,1,0.00006,395414,25.32956,1561077
26483,michaelrnz,1,0.00006,395415,25.32963,1561077
26484,MichaelRobertBell,1,0.00006,395416,25.32969,1561077
26485,michaelschem,1,0.00006,395417,25.32976,1561077
26486,MichaelSchmittQM,1,0.00006,395418,25.32982,1561077
26487,MichaelScript,1,0.00006,395419,25.32988,1561077
26488,michaeltg17,1,0.00006,395420,25.32995,1561077
26489,michaelw,1,0.00006,395421,25.33001,1561077
26490,michaelyoungstrom,1,0.00006,395422,25.33008,1561077
26491,michalb-sonar,1,0.00006,395423,25.33014,1561077
26492,michalchochol,1,0.00006,395424,25.33020,1561077
26493,michalczaplinski,1,0.00006,395425,25.33027,1561077
26494,michaldrabik,1,0.00006,395426,25.33033,1561077
26495,michal-duda-sonarsource,1,0.00006,395427,25.33040,1561077
26496,michalgoldys,1,0.00006,395428,25.33046,1561077
26497,michalmedvecky,1,0.00006,395429,25.33053,1561077
26498,MichalNowacki,1,0.00006,395430,25.33059,1561077
26499,Michalosu,1,0.00006,395431,25.33065,1561077
26500,MichalTaratuta,1,0.00006,395432,25.33072,1561077
26501,michary,1,0.00006,395433,25.33078,1561077
26502,Micheal-Github,1,0.00006,395434,25.33085,1561077
26503,MichealJou,1,0.00006,395435,25.33091,1561077
26504,Michealobasa,1,0.00006,395436,25.33097,1561077
26505,michelene,1,0.00006,395437,25.33104,1561077
26506,michellehalliwell,1,0.00006,395438,25.33110,1561077
26507,mickaelistria,1,0.00006,395439,25.33117,1561077
26508,mickj74,1,0.00006,395440,25.33123,1561077
26509,mickmcgrath13,1,0.00006,395441,25.33129,1561077
26510,micksear,1,0.00006,395442,25.33136,1561077
26511,miclefebvre,1,0.00006,395443,25.33142,1561077
26512,microbioticajon,1,0.00006,395444,25.33149,1561077
26513,micste,1,0.00006,395445,25.33155,1561077
26514,micuffaro,1,0.00006,395446,25.33161,1561077
26515,MiddleMan5,1,0.00006,395447,25.33168,1561077
26516,midebell,1,0.00006,395448,25.33174,1561077
26517,midolo,1,0.00006,395449,25.33181,1561077
26518,mielientiev,1,0.00006,395450,25.33187,1561077
26519,mighani,1,0.00006,395451,25.33193,1561077
26520,miguelandres3,1,0.00006,395452,25.33200,1561077
26521,miguel-arellano,1,0.00006,395453,25.33206,1561077
26522,miguelortize,1,0.00006,395454,25.33213,1561077
26523,miguelrincon,1,0.00006,395455,25.33219,1561077
26524,miguelwhite,1,0.00006,395456,25.33225,1561077
26525,mihaeu,1,0.00006,395457,25.33232,1561077
26526,mihail-dev,1,0.00006,395458,25.33238,1561077
26527,MihailKo,1,0.00006,395459,25.33245,1561077
26528,mihail-sky,1,0.00006,395460,25.33251,1561077
26529,mihaiparv,1,0.00006,395461,25.33257,1561077
26530,mihaitodor,1,0.00006,395462,25.33264,1561077
26531,MihaixD,1,0.00006,395463,25.33270,1561077
26532,mihalicyn,1,0.00006,395464,25.33277,1561077
26533,MihanEntalpo,1,0.00006,395465,25.33283,1561077
26534,mihiransup,1,0.00006,395466,25.33290,1561077
26535,mikador,1,0.00006,395467,25.33296,1561077
26536,mikaeladdepar,1,0.00006,395468,25.33302,1561077
26537,mikalai-okun,1,0.00006,395469,25.33309,1561077
26538,mikamboo,1,0.00006,395470,25.33315,1561077
26539,mikebonnet,1,0.00006,395471,25.33322,1561077
26540,mikeboutch,1,0.00006,395472,25.33328,1561077
26541,miked0004,1,0.00006,395473,25.33334,1561077
26542,mikeeastin,1,0.00006,395474,25.33341,1561077
26543,mikegreiner,1,0.00006,395475,25.33347,1561077
26544,mikegron,1,0.00006,395476,25.33354,1561077
26545,mikekuss,1,0.00006,395477,25.33360,1561077
26546,mikemaaaa,1,0.00006,395478,25.33366,1561077
26547,mike-maliska,1,0.00006,395479,25.33373,1561077
26548,mikenicholson,1,0.00006,395480,25.33379,1561077
26549,mikeobr,1,0.00006,395481,25.33386,1561077
26550,MikePaquette,1,0.00006,395482,25.33392,1561077
26551,mikeprigodich,1,0.00006,395483,25.33398,1561077
26552,MikePryn,1,0.00006,395484,25.33405,1561077
26553,mikepsinn,1,0.00006,395485,25.33411,1561077
26554,mikepurvis,1,0.00006,395486,25.33418,1561077
26555,miketaylr,1,0.00006,395487,25.33424,1561077
26556,mikevan,1,0.00006,395488,25.33430,1561077
26557,MikeWasson,1,0.00006,395489,25.33437,1561077
26558,mike-wendt,1,0.00006,395490,25.33443,1561077
26559,Mikhael-Danilov,1,0.00006,395491,25.33450,1561077
26560,MikhailGordeev,1,0.00006,395492,25.33456,1561077
26561,mikiedelstein,1,0.00006,395493,25.33462,1561077
26562,MikielAgutu,1,0.00006,395494,25.33469,1561077
26563,MikiManor,1,0.00006,395495,25.33475,1561077
26564,mikkiweesenaar,1,0.00006,395496,25.33482,1561077
26565,mikolajzajac,1,0.00006,395497,25.33488,1561077
26566,mikolajzieba,1,0.00006,395498,25.33495,1561077
26567,mikosa,1,0.00006,395499,25.33501,1561077
26568,mikuamuro,1,0.00006,395500,25.33507,1561077
26569,mikumikulch,1,0.00006,395501,25.33514,1561077
26570,milanbalazs,1,0.00006,395502,25.33520,1561077
26571,milenvk,1,0.00006,395503,25.33527,1561077
26572,milica-popovic-osf,1,0.00006,395504,25.33533,1561077
26573,milki,1,0.00006,395505,25.33539,1561077
26574,millenniummike,1,0.00006,395506,25.33546,1561077
26575,millerantonio810,1,0.00006,395507,25.33552,1561077
26576,Millnert,1,0.00006,395508,25.33559,1561077
26577,milos-u,1,0.00006,395509,25.33565,1561077
26578,milovaz,1,0.00006,395510,25.33571,1561077
26579,milror00,1,0.00006,395511,25.33578,1561077
26580,miltos,1,0.00006,395512,25.33584,1561077
26581,mimecast-tsweeney,1,0.00006,395513,25.33591,1561077
26582,MimoJSRepo,1,0.00006,395514,25.33597,1561077
26583,mimuret,1,0.00006,395515,25.33603,1561077
26584,minarikv,1,0.00006,395516,25.33610,1561077
26585,MindTwister,1,0.00006,395517,25.33616,1561077
26586,mingderwang,1,0.00006,395518,25.33623,1561077
26587,mingfan,1,0.00006,395519,25.33629,1561077
26588,minglight,1,0.00006,395520,25.33635,1561077
26589,mingliu,1,0.00006,395521,25.33642,1561077
26590,mingu-mz,1,0.00006,395522,25.33648,1561077
26591,minhtd1981,1,0.00006,395523,25.33655,1561077
26592,minhthanh3145,1,0.00006,395524,25.33661,1561077
26593,minid33,1,0.00006,395525,25.33667,1561077
26594,miniman42,1,0.00006,395526,25.33674,1561077
26595,MinJey,1,0.00006,395527,25.33680,1561077
26596,MinjunYu,1,0.00006,395528,25.33687,1561077
26597,minpet,1,0.00006,395529,25.33693,1561077
26598,Minx-SigEp,1,0.00006,395530,25.33699,1561077
26599,MioOgbeni,1,0.00006,395531,25.33706,1561077
26600,mippos,1,0.00006,395532,25.33712,1561077
26601,miradam,1,0.00006,395533,25.33719,1561077
26602,MirceaM11,1,0.00006,395534,25.33725,1561077
26603,mircomarahrens,1,0.00006,395535,25.33732,1561077
26604,miruflin,1,0.00006,395536,25.33738,1561077
26605,mischaboldy,1,0.00006,395537,25.33744,1561077
26606,MishraAbhay,1,0.00006,395538,25.33751,1561077
26607,mishraprafful,1,0.00006,395539,25.33757,1561077
26608,missing-cn,1,0.00006,395540,25.33764,1561077
26609,missweetcxx,1,0.00006,395541,25.33770,1561077
26610,misterwalrus,1,0.00006,395542,25.33776,1561077
26611,MitchelNijdam-Rockstars,1,0.00006,395543,25.33783,1561077
26612,mitchross,1,0.00006,395544,25.33789,1561077
26613,miteshvermaae,1,0.00006,395545,25.33796,1561077
26614,mithlajkn,1,0.00006,395546,25.33802,1561077
26615,Mithweth,1,0.00006,395547,25.33808,1561077
26616,MiticoBerna,1,0.00006,395548,25.33815,1561077
26617,Mitko-Kerezov,1,0.00006,395549,25.33821,1561077
26618,mitraed,1,0.00006,395550,25.33828,1561077
26619,mitrilmad,1,0.00006,395551,25.33834,1561077
26620,mittyok,1,0.00006,395552,25.33840,1561077
26621,Miuler,1,0.00006,395553,25.33847,1561077
26622,mixels,1,0.00006,395554,25.33853,1561077
26623,mixpo-github,1,0.00006,395555,25.33860,1561077
26624,miyajan,1,0.00006,395556,25.33866,1561077
26625,mjagielka,1,0.00006,395557,25.33872,1561077
26626,mjai39,1,0.00006,395558,25.33879,1561077
26627,mjeffrey,1,0.00006,395559,25.33885,1561077
26628,mjfuInrix,1,0.00006,395560,25.33892,1561077
26629,mjholtkamp,1,0.00006,395561,25.33898,1561077
26630,mjoubert,1,0.00006,395562,25.33904,1561077
26631,mkapra,1,0.00006,395563,25.33911,1561077
26632,mkasberg,1,0.00006,395564,25.33917,1561077
26633,mkasprzyk,1,0.00006,395565,25.33924,1561077
26634,mkazutaka,1,0.00006,395566,25.33930,1561077
26635,mkeckeis,1,0.00006,395567,25.33937,1561077
26636,mkgerasimenko,1,0.00006,395568,25.33943,1561077
26637,mkhan446,1,0.00006,395569,25.33949,1561077
26638,mkillianey,1,0.00006,395570,25.33956,1561077
26639,mkimbro,1,0.00006,395571,25.33962,1561077
26640,mkinzie,1,0.00006,395572,25.33969,1561077
26641,mklauber,1,0.00006,395573,25.33975,1561077
26642,mklemarczyk,1,0.00006,395574,25.33981,1561077
26643,MKletz,1,0.00006,395575,25.33988,1561077
26644,mkninc,1,0.00006,395576,25.33994,1561077
26645,mknous,1,0.00006,395577,25.34001,1561077
26646,mkokate,1,0.00006,395578,25.34007,1561077
26647,mkorotetsky,1,0.00006,395579,25.34013,1561077
26648,mkridi-r7,1,0.00006,395580,25.34020,1561077
26649,Mktmac,1,0.00006,395581,25.34026,1561077
26650,mkuziemko,1,0.00006,395582,25.34033,1561077
26651,ml-,1,0.00006,395583,25.34039,1561077
26652,mlaaksonen-csc,1,0.00006,395584,25.34045,1561077
26653,mlasalmo,1,0.00006,395585,25.34052,1561077
26654,mlb-,1,0.00006,395586,25.34058,1561077
26655,mlegait,1,0.00006,395587,25.34065,1561077
26656,mlescaudron,1,0.00006,395588,25.34071,1561077
26657,ml-extern,1,0.00006,395589,25.34077,1561077
26658,mlflr,1,0.00006,395590,25.34084,1561077
26659,mlhatfield,1,0.00006,395591,25.34090,1561077
26660,MLukman,1,0.00006,395592,25.34097,1561077
26661,mlulaj,1,0.00006,395593,25.34103,1561077
26662,mmallet-youilabs,1,0.00006,395594,25.34109,1561077
26663,mmalmeida,1,0.00006,395595,25.34116,1561077
26664,mmalta-daily,1,0.00006,395596,25.34122,1561077
26665,mmartes,1,0.00006,395597,25.34129,1561077
26666,mmastersvz,1,0.00006,395598,25.34135,1561077
26667,mmatoscom,1,0.00006,395599,25.34141,1561077
26668,mmclanerh,1,0.00006,395600,25.34148,1561077
26669,mmehra,1,0.00006,395601,25.34154,1561077
26670,mmenarguezpear,1,0.00006,395602,25.34161,1561077
26671,mmickan,1,0.00006,395603,25.34167,1561077
26672,m-mital,1,0.00006,395604,25.34174,1561077
26673,mmlac-bv,1,0.00006,395605,25.34180,1561077
26674,mmmasent,1,0.00006,395606,25.34186,1561077
26675,mmpetarpeshev,1,0.00006,395607,25.34193,1561077
26676,mmswiderski,1,0.00006,395608,25.34199,1561077
26677,mmukherjee,1,0.00006,395609,25.34206,1561077
26678,mmuth,1,0.00006,395610,25.34212,1561077
26679,mn0o7,1,0.00006,395611,25.34218,1561077
26680,mnarusze,1,0.00006,395612,25.34225,1561077
26681,mnedkov,1,0.00006,395613,25.34231,1561077
26682,mnehlsen,1,0.00006,395614,25.34238,1561077
26683,mneil,1,0.00006,395615,25.34244,1561077
26684,mneumei,1,0.00006,395616,25.34250,1561077
26685,mnoorl,1,0.00006,395617,25.34257,1561077
26686,mnr102,1,0.00006,395618,25.34263,1561077
26687,mntechguy,1,0.00006,395619,25.34270,1561077
26688,mnttnm,1,0.00006,395620,25.34276,1561077
26689,mnuthan1,1,0.00006,395621,25.34282,1561077
26690,mobara67,1,0.00006,395622,25.34289,1561077
26691,mobidroid,1,0.00006,395623,25.34295,1561077
26692,mobilemarines,1,0.00006,395624,25.34302,1561077
26693,MobileOak,1,0.00006,395625,25.34308,1561077
26694,mobsikx,1,0.00006,395626,25.34314,1561077
26695,mochadwi,1,0.00006,395627,25.34321,1561077
26696,mocnidule,1,0.00006,395628,25.34327,1561077
26697,mocsharp,1,0.00006,395629,25.34334,1561077
26698,modelt-sap,1,0.00006,395630,25.34340,1561077
26699,modess,1,0.00006,395631,25.34346,1561077
26700,Modomu,1,0.00006,395632,25.34353,1561077
26701,ModQA,1,0.00006,395633,25.34359,1561077
26702,modulo11,1,0.00006,395634,25.34366,1561077
26703,modyvishal11,1,0.00006,395635,25.34372,1561077
26704,moglimcgrath,1,0.00006,395636,25.34379,1561077
26705,mogronalol,1,0.00006,395637,25.34385,1561077
26706,mohaijiang,1,0.00006,395638,25.34391,1561077
26707,mohamedalaa33,1,0.00006,395639,25.34398,1561077
26708,MohamedAmineOuali,1,0.00006,395640,25.34404,1561077
26709,mohammadasim,1,0.00006,395641,25.34411,1561077
26710,mohammaddehnavi,1,0.00006,395642,25.34417,1561077
26711,MohammedAbdelhady,1,0.00006,395643,25.34423,1561077
26712,mohammedali-kadri,1,0.00006,395644,25.34430,1561077
26713,mohammedazhar7,1,0.00006,395645,25.34436,1561077
26714,mohan236,1,0.00006,395646,25.34443,1561077
26715,mohanbabu400,1,0.00006,395647,25.34449,1561077
26716,Mohangit03,1,0.00006,395648,25.34455,1561077
26717,mohanji,1,0.00006,395649,25.34462,1561077
26718,MohanKumarHG,1,0.00006,395650,25.34468,1561077
26719,mohd-aslam,1,0.00006,395651,25.34475,1561077
26720,mohit2501,1,0.00006,395652,25.34481,1561077
26721,mohitgaikwad9,1,0.00006,395653,25.34487,1561077
26722,mohkhan-BRONGA,1,0.00006,395654,25.34494,1561077
26723,mohsen-alizadeh-clark2,1,0.00006,395655,25.34500,1561077
26724,MohsineF,1,0.00006,395656,25.34507,1561077
26725,moise3,1,0.00006,395657,25.34513,1561077
26726,MoisesRT,1,0.00006,395658,25.34519,1561077
26727,mojjy,1,0.00006,395659,25.34526,1561077
26728,MoJo2600,1,0.00006,395660,25.34532,1561077
26729,mokhos,1,0.00006,395661,25.34539,1561077
26730,mokyskury,1,0.00006,395662,25.34545,1561077
26731,mo-LeeJohnson,1,0.00006,395663,25.34551,1561077
26732,molesmoke,1,0.00006,395664,25.34558,1561077
26733,moley,1,0.00006,395665,25.34564,1561077
26734,moltak,1,0.00006,395666,25.34571,1561077
26735,monamorsy,1,0.00006,395667,25.34577,1561077
26736,Moncefmd,1,0.00006,395668,25.34583,1561077
26737,MoneyMan573,1,0.00006,395669,25.34590,1561077
26738,Moni3099,1,0.00006,395670,25.34596,1561077
26739,Monishkumar12,1,0.00006,395671,25.34603,1561077
26740,monkeybeans,1,0.00006,395672,25.34609,1561077
26741,monkeyhandz,1,0.00006,395673,25.34616,1561077
26742,monksy,1,0.00006,395674,25.34622,1561077
26743,monolar,1,0.00006,395675,25.34628,1561077
26744,monolithh,1,0.00006,395676,25.34635,1561077
26745,monsieurh,1,0.00006,395677,25.34641,1561077
26746,MonsieurRoZz,1,0.00006,395678,25.34648,1561077
26747,montara,1,0.00006,395679,25.34654,1561077
26748,monupawan,1,0.00006,395680,25.34660,1561077
26749,moochael,1,0.00006,395681,25.34667,1561077
26750,Moocow9m,1,0.00006,395682,25.34673,1561077
26751,moonthug,1,0.00006,395683,25.34680,1561077
26752,moop-moop,1,0.00006,395684,25.34686,1561077
26753,Moopz123,1,0.00006,395685,25.34692,1561077
26754,moorthi07,1,0.00006,395686,25.34699,1561077
26755,moosan63,1,0.00006,395687,25.34705,1561077
26756,moo-the-cow,1,0.00006,395688,25.34712,1561077
26757,mopkobot,1,0.00006,395689,25.34718,1561077
26758,moppetit,1,0.00006,395690,25.34724,1561077
26759,moransk8,1,0.00006,395691,25.34731,1561077
26760,morco,1,0.00006,395692,25.34737,1561077
26761,mordocai,1,0.00006,395693,25.34744,1561077
26762,Morganov,1,0.00006,395694,25.34750,1561077
26763,morgma,1,0.00006,395695,25.34756,1561077
26764,morinted,1,0.00006,395696,25.34763,1561077
26765,moritetu,1,0.00006,395697,25.34769,1561077
26766,moritz89,1,0.00006,395698,25.34776,1561077
26767,Moritz90,1,0.00006,395699,25.34782,1561077
26768,moriyahazan,1,0.00006,395700,25.34788,1561077
26769,mormegil-cz,1,0.00006,395701,25.34795,1561077
26770,morphysk,1,0.00006,395702,25.34801,1561077
26771,Mortvola,1,0.00006,395703,25.34808,1561077
26772,moshe0076,1,0.00006,395704,25.34814,1561077
26773,MosheSheena,1,0.00006,395705,25.34821,1561077
26774,moshjeier,1,0.00006,395706,25.34827,1561077
26775,moss2k13,1,0.00006,395707,25.34833,1561077
26776,mostafa-eltaher,1,0.00006,395708,25.34840,1561077
26777,mostwanted1976,1,0.00006,395709,25.34846,1561077
26778,moto-timo,1,0.00006,395710,25.34853,1561077
26779,mouellet,1,0.00006,395711,25.34859,1561077
26780,mouhamoud-dembele-alien6,1,0.00006,395712,25.34865,1561077
26781,MountainAndSea,1,0.00006,395713,25.34872,1561077
26782,moutameni,1,0.00006,395714,25.34878,1561077
26783,mouuii,1,0.00006,395715,25.34885,1561077
26784,movermeyer,1,0.00006,395716,25.34891,1561077
26785,mozhata,1,0.00006,395717,25.34897,1561077
26786,mpccolorado,1,0.00006,395718,25.34904,1561077
26787,mpeg2,1,0.00006,395719,25.34910,1561077
26788,mpender,1,0.00006,395720,25.34917,1561077
26789,mpetricek-corp,1,0.00006,395721,25.34923,1561077
26790,mpicque,1,0.00006,395722,25.34929,1561077
26791,MPieter,1,0.00006,395723,25.34936,1561077
26792,mpkusnierz,1,0.00006,395724,25.34942,1561077
26793,mplonka,1,0.00006,395725,25.34949,1561077
26794,mplots,1,0.00006,395726,25.34955,1561077
26795,mplsbk,1,0.00006,395727,25.34961,1561077
26796,mplushnikov,1,0.00006,395728,25.34968,1561077
26797,mpm-bug,1,0.00006,395729,25.34974,1561077
26798,mprasil,1,0.00006,395730,25.34981,1561077
26799,mpress,1,0.00006,395731,25.34987,1561077
26800,mpreu,1,0.00006,395732,25.34993,1561077
26801,mprince,1,0.00006,395733,25.35000,1561077
26802,mprins,1,0.00006,395734,25.35006,1561077
26803,mprokopowicz,1,0.00006,395735,25.35013,1561077
26804,mprus,1,0.00006,395736,25.35019,1561077
26805,mputilin,1,0.00006,395737,25.35025,1561077
26806,mpwaldhorst,1,0.00006,395738,25.35032,1561077
26807,Mr20Hz,1,0.00006,395739,25.35038,1561077
26808,mraible,1,0.00006,395740,25.35045,1561077
26809,mrandhikpurwala,1,0.00006,395741,25.35051,1561077
26810,mrbence,1,0.00006,395742,25.35058,1561077
26811,mrbq,1,0.00006,395743,25.35064,1561077
26812,mrchief,1,0.00006,395744,25.35070,1561077
26813,MrChuanQ,1,0.00006,395745,25.35077,1561077
26814,MrDecisive,1,0.00006,395746,25.35083,1561077
26815,mreichelt,1,0.00006,395747,25.35090,1561077
26816,MrException,1,0.00006,395748,25.35096,1561077
26817,MrFishFinger,1,0.00006,395749,25.35102,1561077
26818,mrgasco,1,0.00006,395750,25.35109,1561077
26819,MrGutFeeling,1,0.00006,395751,25.35115,1561077
26820,Mr-H,1,0.00006,395752,25.35122,1561077
26821,mridang,1,0.00006,395753,25.35128,1561077
26822,mriddlegsn,1,0.00006,395754,25.35134,1561077
26823,m-riks,1,0.00006,395755,25.35141,1561077
26824,Mrinali05,1,0.00006,395756,25.35147,1561077
26825,Mrli2016,1,0.00006,395757,25.35154,1561077
26826,mrlov,1,0.00006,395758,25.35160,1561077
26827,MrMack2020,1,0.00006,395759,25.35166,1561077
26828,mr-martins,1,0.00006,395760,25.35173,1561077
26829,MrMickS,1,0.00006,395761,25.35179,1561077
26830,mrollo,1,0.00006,395762,25.35186,1561077
26831,mroohian,1,0.00006,395763,25.35192,1561077
26832,mrosinski,1,0.00006,395764,25.35198,1561077
26833,mroverton1,1,0.00006,395765,25.35205,1561077
26834,MrPrimate,1,0.00006,395766,25.35211,1561077
26835,mrroohian,1,0.00006,395767,25.35218,1561077
26836,MrShark,1,0.00006,395768,25.35224,1561077
26837,MrSoul42,1,0.00006,395769,25.35230,1561077
26838,Mr-TiNTaMaR,1,0.00006,395770,25.35237,1561077
26839,mrtnlrsn,1,0.00006,395771,25.35243,1561077
26840,mrtnvrga,1,0.00006,395772,25.35250,1561077
26841,mrtuborg,1,0.00006,395773,25.35256,1561077
26842,MrudulaTCS,1,0.00006,395774,25.35263,1561077
26843,mruell,1,0.00006,395775,25.35269,1561077
26844,mrunalgosar,1,0.00006,395776,25.35275,1561077
26845,mrusinak,1,0.00006,395777,25.35282,1561077
26846,MrWangwj,1,0.00006,395778,25.35288,1561077
26847,mrwatson,1,0.00006,395779,25.35295,1561077
26848,mrwilby,1,0.00006,395780,25.35301,1561077
26849,Mrxiaoxie,1,0.00006,395781,25.35307,1561077
26850,MrZoidberg,1,0.00006,395782,25.35314,1561077
26851,ms42,1,0.00006,395783,25.35320,1561077
26852,msathe-tech,1,0.00006,395784,25.35327,1561077
26853,msc-hi,1,0.00006,395785,25.35333,1561077
26854,mschreiber,1,0.00006,395786,25.35339,1561077
26855,mschuckmann,1,0.00006,395787,25.35346,1561077
26856,mselvam-clgx,1,0.00006,395788,25.35352,1561077
26857,mseroczynski,1,0.00006,395789,25.35359,1561077
26858,msettro,1,0.00006,395790,25.35365,1561077
26859,msevastian,1,0.00006,395791,25.35371,1561077
26860,mshack70,1,0.00006,395792,25.35378,1561077
26861,mshade,1,0.00006,395793,25.35384,1561077
26862,mshah-nisum-com,1,0.00006,395794,25.35391,1561077
26863,mshapran,1,0.00006,395795,25.35397,1561077
26864,mshauny,1,0.00006,395796,25.35403,1561077
26865,msilveus1,1,0.00006,395797,25.35410,1561077
26866,msinger-dev,1,0.00006,395798,25.35416,1561077
26867,msingh37,1,0.00006,395799,25.35423,1561077
26868,msl8r,1,0.00006,395800,25.35429,1561077
26869,MSLaguana,1,0.00006,395801,25.35435,1561077
26870,mslaven,1,0.00006,395802,25.35442,1561077
26871,mslayton-abra,1,0.00006,395803,25.35448,1561077
26872,ms-lolo,1,0.00006,395804,25.35455,1561077
26873,msmagoo87,1,0.00006,395805,25.35461,1561077
26874,msmahal,1,0.00006,395806,25.35468,1561077
26875,msoranno,1,0.00006,395807,25.35474,1561077
26876,msperisen,1,0.00006,395808,25.35480,1561077
26877,msr77,1,0.00006,395809,25.35487,1561077
26878,msteenhu,1,0.00006,395810,25.35493,1561077
26879,mstefanov-vmw,1,0.00006,395811,25.35500,1561077
26880,msteffensen19,1,0.00006,395812,25.35506,1561077
26881,mstrdev,1,0.00006,395813,25.35512,1561077
26882,mstred,1,0.00006,395814,25.35519,1561077
26883,mstyura,1,0.00006,395815,25.35525,1561077
26884,msurab,1,0.00006,395816,25.35532,1561077
26885,mswezey23,1,0.00006,395817,25.35538,1561077
26886,mszabo,1,0.00006,395818,25.35544,1561077
26887,mszalbach,1,0.00006,395819,25.35551,1561077
26888,mtewordt1,1,0.00006,395820,25.35557,1561077
26889,mtgoss40,1,0.00006,395821,25.35564,1561077
26890,mthegreat83,1,0.00006,395822,25.35570,1561077
26891,mtheus,1,0.00006,395823,25.35576,1561077
26892,mtlRL,1,0.00006,395824,25.35583,1561077
26893,mtn-boblloyd,1,0.00006,395825,25.35589,1561077
26894,mtomsocial,1,0.00006,395826,25.35596,1561077
26895,mtrautwig,1,0.00006,395827,25.35602,1561077
26896,mtricolici,1,0.00006,395828,25.35608,1561077
26897,mtscout6,1,0.00006,395829,25.35615,1561077
26898,mtthb,1,0.00006,395830,25.35621,1561077
26899,mtthoyle,1,0.00006,395831,25.35628,1561077
26900,muanis,1,0.00006,395832,25.35634,1561077
26901,mudrii,1,0.00006,395833,25.35640,1561077
26902,muffl0n,1,0.00006,395834,25.35647,1561077
26903,mugar97,1,0.00006,395835,25.35653,1561077
26904,muhajirdev,1,0.00006,395836,25.35660,1561077
26905,muhammadali1233ify,1,0.00006,395837,25.35666,1561077
26906,muhammad-hamed,1,0.00006,395838,25.35672,1561077
26907,muhammedSabbah,1,0.00006,395839,25.35679,1561077
26908,MuhLitfan,1,0.00006,395840,25.35685,1561077
26909,muilwyk,1,0.00006,395841,25.35692,1561077
26910,Muji86,1,0.00006,395842,25.35698,1561077
26911,MukeshAtGit,1,0.00006,395843,25.35705,1561077
26912,mukeshsingh18,1,0.00006,395844,25.35711,1561077
26913,mulmschneider,1,0.00006,395845,25.35717,1561077
26914,Mumakil,1,0.00006,395846,25.35724,1561077
26915,mumarf,1,0.00006,395847,25.35730,1561077
26916,munierujp,1,0.00006,395848,25.35737,1561077
26917,MuppyCwa,1,0.00006,395849,25.35743,1561077
26918,murali038,1,0.00006,395850,25.35749,1561077
26919,murariagrawal,1,0.00006,395851,25.35756,1561077
26920,Murazaki,1,0.00006,395852,25.35762,1561077
26921,Muree53,1,0.00006,395853,25.35769,1561077
26922,murilodag,1,0.00006,395854,25.35775,1561077
26923,murmangit,1,0.00006,395855,25.35781,1561077
26924,muroj,1,0.00006,395856,25.35788,1561077
26925,murthysrd,1,0.00006,395857,25.35794,1561077
26926,murukeshm,1,0.00006,395858,25.35801,1561077
26927,mus65,1,0.00006,395859,25.35807,1561077
26928,M-usamashahid,1,0.00006,395860,25.35813,1561077
26929,musanas,1,0.00006,395861,25.35820,1561077
26930,mustafa89,1,0.00006,395862,25.35826,1561077
26931,mustafakirimli,1,0.00006,395863,25.35833,1561077
26932,Muthukumar-sys,1,0.00006,395864,25.35839,1561077
26933,MuyBien,1,0.00006,395865,25.35845,1561077
26934,Muzamri,1,0.00006,395866,25.35852,1561077
26935,mvaleiko,1,0.00006,395867,25.35858,1561077
26936,mvantellingen,1,0.00006,395868,25.35865,1561077
26937,mvdwalle,1,0.00006,395869,25.35871,1561077
26938,MvEerd,1,0.00006,395870,25.35877,1561077
26939,mvgadagi,1,0.00006,395871,25.35884,1561077
26940,mvhirsch,1,0.00006,395872,25.35890,1561077
26941,mvineza,1,0.00006,395873,25.35897,1561077
26942,mvkirk,1,0.00006,395874,25.35903,1561077
26943,mvoelker,1,0.00006,395875,25.35910,1561077
26944,mvrabel,1,0.00006,395876,25.35916,1561077
26945,mwallace72,1,0.00006,395877,25.35922,1561077
26946,mwasilew2,1,0.00006,395878,25.35929,1561077
26947,mweinberg-cm,1,0.00006,395879,25.35935,1561077
26948,mwhitecoverity,1,0.00006,395880,25.35942,1561077
26949,mwinfie,1,0.00006,395881,25.35948,1561077
26950,mwiora,1,0.00006,395882,25.35954,1561077
26951,mwolniewicz,1,0.00006,395883,25.35961,1561077
26952,mwtzzz,1,0.00006,395884,25.35967,1561077
26953,mwuertinger,1,0.00006,395885,25.35974,1561077
26954,mxkyb,1,0.00006,395886,25.35980,1561077
26955,mxsxs2,1,0.00006,395887,25.35986,1561077
26956,myavalka,1,0.00006,395888,25.35993,1561077
26957,myazid,1,0.00006,395889,25.35999,1561077
26958,myboredfriends,1,0.00006,395890,25.36006,1561077
26959,mycroes,1,0.00006,395891,25.36012,1561077
26960,mydearmuthu1978,1,0.00006,395892,25.36018,1561077
26961,mydeveloperday,1,0.00006,395893,25.36025,1561077
26962,myDisconnect,1,0.00006,395894,25.36031,1561077
26963,myeveryheart,1,0.00006,395895,25.36038,1561077
26964,mykg,1,0.00006,395896,25.36044,1561077
26965,myonnet,1,0.00006,395897,25.36050,1561077
26966,myoussef89,1,0.00006,395898,25.36057,1561077
26967,MyroslavSeliverstov,1,0.00006,395899,25.36063,1561077
26968,myusoof-xinja,1,0.00006,395900,25.36070,1561077
26969,mzamfirmade,1,0.00006,395901,25.36076,1561077
26970,mzeyen,1,0.00006,395902,25.36082,1561077
26971,mziemer21,1,0.00006,395903,25.36089,1561077
26972,n111ke1,1,0.00006,395904,25.36095,1561077
26973,n3rd-vignesh,1,0.00006,395905,25.36102,1561077
26974,n3v3rf411,1,0.00006,395906,25.36108,1561077
26975,n635998,1,0.00006,395907,25.36114,1561077
26976,nabertrand,1,0.00006,395908,25.36121,1561077
26977,nabice,1,0.00006,395909,25.36127,1561077
26978,nabridges,1,0.00006,395910,25.36134,1561077
26979,naccarati,1,0.00006,395911,25.36140,1561077
26980,NaccOll,1,0.00006,395912,25.36147,1561077
26981,nacho-milanese,1,0.00006,395913,25.36153,1561077
26982,Nachtfeuer,1,0.00006,395914,25.36159,1561077
26983,Nadav1,1,0.00006,395915,25.36166,1561077
26984,Nadav-Eyesight,1,0.00006,395916,25.36172,1561077
26985,nadeemIqbal02,1,0.00006,395917,25.36179,1561077
26986,NadeemYunus,1,0.00006,395918,25.36185,1561077
26987,nadimkhemir,1,0.00006,395919,25.36191,1561077
26988,nafri-irfan96,1,0.00006,395920,25.36198,1561077
26989,Nagainos,1,0.00006,395921,25.36204,1561077
26990,NagarajMasub,1,0.00006,395922,25.36211,1561077
26991,nagarajui7,1,0.00006,395923,25.36217,1561077
26992,nagarameshreddy,1,0.00006,395924,25.36223,1561077
26993,nagavenkatakiran,1,0.00006,395925,25.36230,1561077
26994,nagharaaj,1,0.00006,395926,25.36236,1561077
26995,nagsudhakar,1,0.00006,395927,25.36243,1561077
26996,naguait85,1,0.00006,395928,25.36249,1561077
26997,nagwww,1,0.00006,395929,25.36255,1561077
26998,NahidSiddiqui,1,0.00006,395930,25.36262,1561077
26999,Naimadnap,1,0.00006,395931,25.36268,1561077
27000,naimdjon,1,0.00006,395932,25.36275,1561077
27001,naineel,1,0.00006,395933,25.36281,1561077
27002,naisargparmar,1,0.00006,395934,25.36287,1561077
27003,naitse,1,0.00006,395935,25.36294,1561077
27004,nakadayou,1,0.00006,395936,25.36300,1561077
27005,nakkapeddi,1,0.00006,395937,25.36307,1561077
27006,nakulvs-adeo,1,0.00006,395938,25.36313,1561077
27007,nalingarg2,1,0.00006,395939,25.36319,1561077
27008,nalinigokulpure,1,0.00006,395940,25.36326,1561077
27009,naliwajek,1,0.00006,395941,25.36332,1561077
27010,namanChaturvedi,1,0.00006,395942,25.36339,1561077
27011,namannigam,1,0.00006,395943,25.36345,1561077
27012,namjitharavind,1,0.00006,395944,25.36352,1561077
27013,namnn96,1,0.00006,395945,25.36358,1561077
27014,namratha-bharadwaj,1,0.00006,395946,25.36364,1561077
27015,nan008,1,0.00006,395947,25.36371,1561077
27016,nanakwafo,1,0.00006,395948,25.36377,1561077
27017,NancyChunlan,1,0.00006,395949,25.36384,1561077
27018,nancy-echefu,1,0.00006,395950,25.36390,1561077
27019,Nancy-Robertson,1,0.00006,395951,25.36396,1561077
27020,nand0p,1,0.00006,395952,25.36403,1561077
27021,nanderson94,1,0.00006,395953,25.36409,1561077
27022,nandipatianil,1,0.00006,395954,25.36416,1561077
27023,Nanduyana,1,0.00006,395955,25.36422,1561077
27024,nangalvivek,1,0.00006,395956,25.36428,1561077
27025,nanonyme,1,0.00006,395957,25.36435,1561077
27026,Naoises,1,0.00006,395958,25.36441,1561077
27027,naorc123,1,0.00006,395959,25.36448,1561077
27028,Naowaki,1,0.00006,395960,25.36454,1561077
27029,Napo2k,1,0.00006,395961,25.36460,1561077
27030,nappy,1,0.00006,395962,25.36467,1561077
27031,naqushab,1,0.00006,395963,25.36473,1561077
27032,naradahess,1,0.00006,395964,25.36480,1561077
27033,naramana,1,0.00006,395965,25.36486,1561077
27034,narayanan-n,1,0.00006,395966,25.36492,1561077
27035,narayanatao,1,0.00006,395967,25.36499,1561077
27036,narcistesa,1,0.00006,395968,25.36505,1561077
27037,narendra7095,1,0.00006,395969,25.36512,1561077
27038,narendrachandrakar,1,0.00006,395970,25.36518,1561077
27039,nareshbandi123,1,0.00006,395971,25.36524,1561077
27040,nareshgnT,1,0.00006,395972,25.36531,1561077
27041,nareshnayini,1,0.00006,395973,25.36537,1561077
27042,nariman1987,1,0.00006,395974,25.36544,1561077
27043,Narimm,1,0.00006,395975,25.36550,1561077
27044,Narkhip,1,0.00006,395976,25.36556,1561077
27045,nashid,1,0.00006,395977,25.36563,1561077
27046,nasonfish,1,0.00006,395978,25.36569,1561077
27047,nassercarlos19,1,0.00006,395979,25.36576,1561077
27048,natalia-pokrovskaya,1,0.00006,395980,25.36582,1561077
27049,natarajanmurukan,1,0.00006,395981,25.36589,1561077
27050,natebakescakes,1,0.00006,395982,25.36595,1561077
27051,nate-johnston,1,0.00006,395983,25.36601,1561077
27052,nateo,1,0.00006,395984,25.36608,1561077
27053,nate-opti,1,0.00006,395985,25.36614,1561077
27054,nateridderman,1,0.00006,395986,25.36621,1561077
27055,NathanAZaks,1,0.00006,395987,25.36627,1561077
27056,nathanblair,1,0.00006,395988,25.36633,1561077
27057,NathanZookCH,1,0.00006,395989,25.36640,1561077
27058,natnebuer,1,0.00006,395990,25.36646,1561077
27059,Nautigsam,1,0.00006,395991,25.36653,1561077
27060,nautilussu,1,0.00006,395992,25.36659,1561077
27061,Nav-2d,1,0.00006,395993,25.36665,1561077
27062,NavazishS,1,0.00006,395994,25.36672,1561077
27063,naveedjaffar968,1,0.00006,395995,25.36678,1561077
27064,Naveen1836,1,0.00006,395996,25.36685,1561077
27065,NaveenBadal,1,0.00006,395997,25.36691,1561077
27066,naveenkumar1012,1,0.00006,395998,25.36697,1561077
27067,NaveenVastare,1,0.00006,395999,25.36704,1561077
27068,naviat,1,0.00006,396000,25.36710,1561077
27069,navidurrahman,1,0.00006,396001,25.36717,1561077
27070,navin89,1,0.00006,396002,25.36723,1561077
27071,navinkbe7,1,0.00006,396003,25.36729,1561077
27072,navneetlal,1,0.00006,396004,25.36736,1561077
27073,nazaga,1,0.00006,396005,25.36742,1561077
27074,nazarii-piontko,1,0.00006,396006,25.36749,1561077
27075,nazrul007,1,0.00006,396007,25.36755,1561077
27076,nbarithel,1,0.00006,396008,25.36761,1561077
27077,nbarrett,1,0.00006,396009,25.36768,1561077
27078,nbarrientos,1,0.00006,396010,25.36774,1561077
27079,nbartos,1,0.00006,396011,25.36781,1561077
27080,nbattala,1,0.00006,396012,25.36787,1561077
27081,nbenmoody-tesouro,1,0.00006,396013,25.36794,1561077
27082,nbgucer,1,0.00006,396014,25.36800,1561077
27083,nbin,1,0.00006,396015,25.36806,1561077
27084,nblair,1,0.00006,396016,25.36813,1561077
27085,nblintsov,1,0.00006,396017,25.36819,1561077
27086,nbon12,1,0.00006,396018,25.36826,1561077
27087,nboury-vsct,1,0.00006,396019,25.36832,1561077
27088,nbraun1,1,0.00006,396020,25.36838,1561077
27089,nbruno,1,0.00006,396021,25.36845,1561077
27090,nbuso,1,0.00006,396022,25.36851,1561077
27091,nbutkowski-chub,1,0.00006,396023,25.36858,1561077
27092,NBZ4live,1,0.00006,396024,25.36864,1561077
27093,ncihnegn,1,0.00006,396025,25.36870,1561077
27094,ncrothe,1,0.00006,396026,25.36877,1561077
27095,ndelargy,1,0.00006,396027,25.36883,1561077
27096,ndelic0,1,0.00006,396028,25.36890,1561077
27097,ndessart,1,0.00006,396029,25.36896,1561077
27098,ndevenish,1,0.00006,396030,25.36902,1561077
27099,ndh103,1,0.00006,396031,25.36909,1561077
27100,ndlanier,1,0.00006,396032,25.36915,1561077
27101,ndmanvar,1,0.00006,396033,25.36922,1561077
27102,ne1000,1,0.00006,396034,25.36928,1561077
27103,NebelskyiDmytro,1,0.00006,396035,25.36934,1561077
27104,nebulans,1,0.00006,396036,25.36941,1561077
27105,NeckBeardPrince,1,0.00006,396037,25.36947,1561077
27106,necroscope,1,0.00006,396038,25.36954,1561077
27107,nedad,1,0.00006,396039,25.36960,1561077
27108,ned-si,1,0.00006,396040,25.36966,1561077
27109,neerajkhanal,1,0.00006,396041,25.36973,1561077
27110,neerajky,1,0.00006,396042,25.36979,1561077
27111,Neerajraj07,1,0.00006,396043,25.36986,1561077
27112,neerajsb,1,0.00006,396044,25.36992,1561077
27113,nefethael,1,0.00006,396045,25.36998,1561077
27114,negarnegma,1,0.00006,396046,25.37005,1561077
27115,negmos,1,0.00006,396047,25.37011,1561077
27116,nehaev,1,0.00006,396048,25.37018,1561077
27117,neigor,1,0.00006,396049,25.37024,1561077
27118,neil-benn,1,0.00006,396050,25.37031,1561077
27119,neilferreira,1,0.00006,396051,25.37037,1561077
27120,neilmarion1,1,0.00006,396052,25.37043,1561077
27121,neilshannon,1,0.00006,396053,25.37050,1561077
27122,neirbowj,1,0.00006,396054,25.37056,1561077
27123,neizmirasego,1,0.00006,396055,25.37063,1561077
27124,nejtr0n,1,0.00006,396056,25.37069,1561077
27125,nek-00-ken,1,0.00006,396057,25.37075,1561077
27126,NekiMedo,1,0.00006,396058,25.37082,1561077
27127,nelroosevelt,1,0.00006,396059,25.37088,1561077
27128,nelsg,1,0.00006,396060,25.37095,1561077
27129,nelson-liu,1,0.00006,396061,25.37101,1561077
27130,nelsonmca,1,0.00006,396062,25.37107,1561077
27131,nembot,1,0.00006,396063,25.37114,1561077
27132,nemo42,1,0.00006,396064,25.37120,1561077
27133,Nemric,1,0.00006,396065,25.37127,1561077
27134,nenych,1,0.00006,396066,25.37133,1561077
27135,neocode24,1,0.00006,396067,25.37139,1561077
27136,neo-feng,1,0.00006,396068,25.37146,1561077
27137,Neonnq,1,0.00006,396069,25.37152,1561077
27138,neosimsim,1,0.00006,396070,25.37159,1561077
27139,NeoTheThird,1,0.00006,396071,25.37165,1561077
27140,neozonka,1,0.00006,396072,25.37171,1561077
27141,nep-group,1,0.00006,396073,25.37178,1561077
27142,nergal,1,0.00006,396074,25.37184,1561077
27143,nerro,1,0.00006,396075,25.37191,1561077
27144,neshp,1,0.00006,396076,25.37197,1561077
27145,nestorbolivar,1,0.00006,396077,25.37203,1561077
27146,neswork-th,1,0.00006,396078,25.37210,1561077
27147,netheosgithub,1,0.00006,396079,25.37216,1561077
27148,netkey,1,0.00006,396080,25.37223,1561077
27149,netrounds-joakim,1,0.00006,396081,25.37229,1561077
27150,netvisao,1,0.00006,396082,25.37236,1561077
27151,neuquino,1,0.00006,396083,25.37242,1561077
27152,neverwet,1,0.00006,396084,25.37248,1561077
27153,nevskrem,1,0.00006,396085,25.37255,1561077
27154,newbenji,1,0.00006,396086,25.37261,1561077
27155,newforma-bclemans,1,0.00006,396087,25.37268,1561077
27156,new-ninja2020,1,0.00006,396088,25.37274,1561077
27157,newporta,1,0.00006,396089,25.37280,1561077
27158,NewProggie,1,0.00006,396090,25.37287,1561077
27159,newsoulbr,1,0.00006,396091,25.37293,1561077
27160,Newstarstart,1,0.00006,396092,25.37300,1561077
27161,newsworthy39,1,0.00006,396093,25.37306,1561077
27162,Newtopian,1,0.00006,396094,25.37312,1561077
27163,newtorob,1,0.00006,396095,25.37319,1561077
27164,Nexile-Erk,1,0.00006,396096,25.37325,1561077
27165,nextinteractivemobile,1,0.00006,396097,25.37332,1561077
27166,neybar,1,0.00006,396098,25.37338,1561077
27167,Nezale,1,0.00006,396099,25.37344,1561077
27168,nezero,1,0.00006,396100,25.37351,1561077
27169,nfantone,1,0.00006,396101,25.37357,1561077
27170,nfergu,1,0.00006,396102,25.37364,1561077
27171,nfoxmttr,1,0.00006,396103,25.37370,1561077
27172,ngc3766,1,0.00006,396104,25.37376,1561077
27173,ngcdev,1,0.00006,396105,25.37383,1561077
27174,ngerstle,1,0.00006,396106,25.37389,1561077
27175,ngksternhagen,1,0.00006,396107,25.37396,1561077
27176,ngnintedemcartelle,1,0.00006,396108,25.37402,1561077
27177,ngocmchu,1,0.00006,396109,25.37408,1561077
27178,ngrennan-inflection,1,0.00006,396110,25.37415,1561077
27179,ngreyes,1,0.00006,396111,25.37421,1561077
27180,ngriffiths,1,0.00006,396112,25.37428,1561077
27181,NGTOne,1,0.00006,396113,25.37434,1561077
27182,nguyencatpham,1,0.00006,396114,25.37440,1561077
27183,nguyenlamlll,1,0.00006,396115,25.37447,1561077
27184,nguyenlevulong,1,0.00006,396116,25.37453,1561077
27185,nguyenph88,1,0.00006,396117,25.37460,1561077
27186,nhathy,1,0.00006,396118,25.37466,1561077
27187,nhattran2311,1,0.00006,396119,25.37473,1561077
27188,nhelvig,1,0.00006,396120,25.37479,1561077
27189,nhok,1,0.00006,396121,25.37485,1561077
27190,nia2k7,1,0.00006,396122,25.37492,1561077
27191,niahmiah,1,0.00006,396123,25.37498,1561077
27192,nianglao,1,0.00006,396124,25.37505,1561077
27193,NiasSt90,1,0.00006,396125,25.37511,1561077
27194,niau,1,0.00006,396126,25.37517,1561077
27195,Nibeditar333,1,0.00006,396127,25.37524,1561077
27196,nibty,1,0.00006,396128,25.37530,1561077
27197,nichaoyi,1,0.00006,396129,25.37537,1561077
27198,nichobbs,1,0.00006,396130,25.37543,1561077
27199,NicholasAzar,1,0.00006,396131,25.37549,1561077
27200,nicholascus,1,0.00006,396132,25.37556,1561077
27201,nichollascorrealab,1,0.00006,396133,25.37562,1561077
27202,nick0511,1,0.00006,396134,25.37569,1561077
27203,nick123pig,1,0.00006,396135,25.37575,1561077
27204,nickdgriffin,1,0.00006,396136,25.37581,1561077
27205,nick-kadhao,1,0.00006,396137,25.37588,1561077
27206,nicklasl,1,0.00006,396138,25.37594,1561077
27207,nickm4062,1,0.00006,396139,25.37601,1561077
27208,nick-mathison,1,0.00006,396140,25.37607,1561077
27209,nickmccally,1,0.00006,396141,25.37613,1561077
27210,nickoe,1,0.00006,396142,25.37620,1561077
27211,NickQA,1,0.00006,396143,25.37626,1561077
27212,nicksanders,1,0.00006,396144,25.37633,1561077
27213,nick-scoutbee,1,0.00006,396145,25.37639,1561077
27214,nick-tripp,1,0.00006,396146,25.37645,1561077
27215,nickyfoster,1,0.00006,396147,25.37652,1561077
27216,NickyWeber,1,0.00006,396148,25.37658,1561077
27217,Nicobubu,1,0.00006,396149,25.37665,1561077
27218,nicocesar,1,0.00006,396150,25.37671,1561077
27219,nicolabeghin,1,0.00006,396151,25.37678,1561077
27220,nicolasaigner,1,0.00006,396152,25.37684,1561077
27221,nicolasavenza,1,0.00006,396153,25.37690,1561077
27222,nicolasbraun,1,0.00006,396154,25.37697,1561077
27223,nicolasfagotti,1,0.00006,396155,25.37703,1561077
27224,nicolaslauquin,1,0.00006,396156,25.37710,1561077
27225,nicolasproton,1,0.00006,396157,25.37716,1561077
27226,NicoleG25,1,0.00006,396158,25.37722,1561077
27227,nicolovergari,1,0.00006,396159,25.37729,1561077
27228,nicopaez,1,0.00006,396160,25.37735,1561077
27229,nicosuave,1,0.00006,396161,25.37742,1561077
27230,nicpalmer,1,0.00006,396162,25.37748,1561077
27231,niduvivier,1,0.00006,396163,25.37754,1561077
27232,NielsAlebregtse,1,0.00006,396164,25.37761,1561077
27233,NielsenAnders,1,0.00006,396165,25.37767,1561077
27234,NielsKorschinsky,1,0.00006,396166,25.37774,1561077
27235,nielsz,1,0.00006,396167,25.37780,1561077
27236,nieverbe,1,0.00006,396168,25.37786,1561077
27237,nieyong1,1,0.00006,396169,25.37793,1561077
27238,ni-fgenois,1,0.00006,396170,25.37799,1561077
27239,nigesh-pugazhendhi,1,0.00006,396171,25.37806,1561077
27240,nijicompany,1,0.00006,396172,25.37812,1561077
27241,nik9000,1,0.00006,396173,25.37818,1561077
27242,nikarul,1,0.00006,396174,25.37825,1561077
27243,nikfalstie,1,0.00006,396175,25.37831,1561077
27244,nikhil-kalbande,1,0.00006,396176,25.37838,1561077
27245,nikhilkhanna,1,0.00006,396177,25.37844,1561077
27246,nikhilsharma6311,1,0.00006,396178,25.37850,1561077
27247,NikhilShrivastava,1,0.00006,396179,25.37857,1561077
27248,nikhilve99,1,0.00006,396180,25.37863,1561077
27249,Nikita757,1,0.00006,396181,25.37870,1561077
27250,nikitamendelbaum,1,0.00006,396182,25.37876,1561077
27251,nikitin-dev,1,0.00006,396183,25.37883,1561077
27252,nikkobertrand,1,0.00006,396184,25.37889,1561077
27253,nikkonix,1,0.00006,396185,25.37895,1561077
27254,nikname,1,0.00006,396186,25.37902,1561077
27255,nikobarli,1,0.00006,396187,25.37908,1561077
27256,nikolay-borzov,1,0.00006,396188,25.37915,1561077
27257,nikolaykasyanov,1,0.00006,396189,25.37921,1561077
27258,nikpoputko,1,0.00006,396190,25.37927,1561077
27259,nikulabs,1,0.00006,396191,25.37934,1561077
27260,nikwan,1,0.00006,396192,25.37940,1561077
27261,nilesh2501,1,0.00006,396193,25.37947,1561077
27262,nileshpokale,1,0.00006,396194,25.37953,1561077
27263,NilkamalDey,1,0.00006,396195,25.37959,1561077
27264,nils91,1,0.00006,396196,25.37966,1561077
27265,NilsHasenbanck4758,1,0.00006,396197,25.37972,1561077
27266,nilsrobinsander,1,0.00006,396198,25.37979,1561077
27267,NilsRuiz,1,0.00006,396199,25.37985,1561077
27268,nimajalali,1,0.00006,396200,25.37991,1561077
27269,nimbuscrenel,1,0.00006,396201,25.37998,1561077
27270,Nimms1,1,0.00006,396202,25.38004,1561077
27271,ninadingole,1,0.00006,396203,25.38011,1561077
27272,niniphon,1,0.00006,396204,25.38017,1561077
27273,NinjaBuggs,1,0.00006,396205,25.38023,1561077
27274,ninjaMog,1,0.00006,396206,25.38030,1561077
27275,Ninkal007,1,0.00006,396207,25.38036,1561077
27276,niothiel,1,0.00006,396208,25.38043,1561077
27277,niravmsh,1,0.00006,396209,25.38049,1561077
27278,NirBehalf,1,0.00006,396210,25.38055,1561077
27279,NirBenjamin,1,0.00006,396211,25.38062,1561077
27280,nirfeldman,1,0.00006,396212,25.38068,1561077
27281,nirgur,1,0.00006,396213,25.38075,1561077
27282,nirtsruya,1,0.00006,396214,25.38081,1561077
27283,Nirusu,1,0.00006,396215,25.38087,1561077
27284,nirutgupta,1,0.00006,396216,25.38094,1561077
27285,nirvana-flame,1,0.00006,396217,25.38100,1561077
27286,nisaea,1,0.00006,396218,25.38107,1561077
27287,nisdonel,1,0.00006,396219,25.38113,1561077
27288,nishant041,1,0.00006,396220,25.38120,1561077
27289,nishant-dani,1,0.00006,396221,25.38126,1561077
27290,nishantkantojha,1,0.00006,396222,25.38132,1561077
27291,NishanWijesinghe,1,0.00006,396223,25.38139,1561077
27292,nishikant,1,0.00006,396224,25.38145,1561077
27293,nishikants,1,0.00006,396225,25.38152,1561077
27294,nishtpan,1,0.00006,396226,25.38158,1561077
27295,nishu876mishra,1,0.00006,396227,25.38164,1561077
27296,nishwalshetty,1,0.00006,396228,25.38171,1561077
27297,niskarsha10,1,0.00006,396229,25.38177,1561077
27298,nissaba,1,0.00006,396230,25.38184,1561077
27299,nissar450,1,0.00006,396231,25.38190,1561077
27300,nitelite,1,0.00006,396232,25.38196,1561077
27301,niteshthakur,1,0.00006,396233,25.38203,1561077
27302,nithinkota,1,0.00006,396234,25.38209,1561077
27303,NithyaRaji,1,0.00006,396235,25.38216,1561077
27304,nitish-predera,1,0.00006,396236,25.38222,1561077
27305,nitobuendia,1,0.00006,396237,25.38228,1561077
27306,NitzanDevOpser,1,0.00006,396238,25.38235,1561077
27307,NivardoX,1,0.00006,396239,25.38241,1561077
27308,Nivki,1,0.00006,396240,25.38248,1561077
27309,nivleshc,1,0.00006,396241,25.38254,1561077
27310,niyasimonc,1,0.00006,396242,25.38260,1561077
27311,niyomi,1,0.00006,396243,25.38267,1561077
27312,NIZ-elsevier,1,0.00006,396244,25.38273,1561077
27313,njZhuMin,1,0.00006,396245,25.38280,1561077
27314,nkakouros,1,0.00006,396246,25.38286,1561077
27315,nkalev,1,0.00006,396247,25.38292,1561077
27316,NKame,1,0.00006,396248,25.38299,1561077
27317,nkavian,1,0.00006,396249,25.38305,1561077
27318,nkcfan,1,0.00006,396250,25.38312,1561077
27319,nkchand91,1,0.00006,396251,25.38318,1561077
27320,nklkarthi,1,0.00006,396252,25.38325,1561077
27321,nkondratyk,1,0.00006,396253,25.38331,1561077
27322,nkshschdv,1,0.00006,396254,25.38337,1561077
27323,nkts,1,0.00006,396255,25.38344,1561077
27324,nLight,1,0.00006,396256,25.38350,1561077
27325,nlloyd,1,0.00006,396257,25.38357,1561077
27326,nm515350,1,0.00006,396258,25.38363,1561077
27327,nmani,1,0.00006,396259,25.38369,1561077
27328,nmardiks,1,0.00006,396260,25.38376,1561077
27329,nmcgann-r7,1,0.00006,396261,25.38382,1561077
27330,nmenetrier,1,0.00006,396262,25.38389,1561077
27331,nmguse-bighealth,1,0.00006,396263,25.38395,1561077
27332,Nmishin,1,0.00006,396264,25.38401,1561077
27333,nmusaelian-rally,1,0.00006,396265,25.38408,1561077
27334,nnadams,1,0.00006,396266,25.38414,1561077
27335,nnand10,1,0.00006,396267,25.38421,1561077
27336,nnashok,1,0.00006,396268,25.38427,1561077
27337,noah-ws,1,0.00006,396269,25.38433,1561077
27338,noamanhesham,1,0.00006,396270,25.38440,1561077
27339,noamdo,1,0.00006,396271,25.38446,1561077
27340,Nockiro,1,0.00006,396272,25.38453,1561077
27341,nodefourtytwo,1,0.00006,396273,25.38459,1561077
27342,nodnarbnitram,1,0.00006,396274,25.38465,1561077
27343,noeliajimenezg,1,0.00006,396275,25.38472,1561077
27344,noel-yap,1,0.00006,396276,25.38478,1561077
27345,nofacer,1,0.00006,396277,25.38485,1561077
27346,nofate,1,0.00006,396278,25.38491,1561077
27347,nogorman-r7,1,0.00006,396279,25.38497,1561077
27348,nogudnik,1,0.00006,396280,25.38504,1561077
27349,nogueirad88,1,0.00006,396281,25.38510,1561077
27350,NoImageFound,1,0.00006,396282,25.38517,1561077
27351,NokiDev,1,0.00006,396283,25.38523,1561077
27352,Noksa,1,0.00006,396284,25.38529,1561077
27353,nolar,1,0.00006,396285,25.38536,1561077
27354,nonasoumy,1,0.00006,396286,25.38542,1561077
27355,none0nfg,1,0.00006,396287,25.38549,1561077
27356,nonmanifold,1,0.00006,396288,25.38555,1561077
27357,nonnhima,1,0.00006,396289,25.38562,1561077
27358,nonsoagbo1,1,0.00006,396290,25.38568,1561077
27359,noppelmax,1,0.00006,396291,25.38574,1561077
27360,nopunYntendeed,1,0.00006,396292,25.38581,1561077
27361,noraroxette,1,0.00006,396293,25.38587,1561077
27362,norbertdalecker,1,0.00006,396294,25.38594,1561077
27363,NorCalCoder11,1,0.00006,396295,25.38600,1561077
27364,nordstrand,1,0.00006,396296,25.38606,1561077
27365,norenstrakh-r7,1,0.00006,396297,25.38613,1561077
27366,normand1,1,0.00006,396298,25.38619,1561077
27367,normseth,1,0.00006,396299,25.38626,1561077
27368,nosheenakhtar,1,0.00006,396300,25.38632,1561077
27369,noshinidevi,1,0.00006,396301,25.38638,1561077
27370,Nosk14,1,0.00006,396302,25.38645,1561077
27371,Nossnevs,1,0.00006,396303,25.38651,1561077
27372,nostalic,1,0.00006,396304,25.38658,1561077
27373,notaz,1,0.00006,396305,25.38664,1561077
27374,notbeewtf,1,0.00006,396306,25.38670,1561077
27375,notbhaskarr,1,0.00006,396307,25.38677,1561077
27376,notihs,1,0.00006,396308,25.38683,1561077
27377,notnarb,1,0.00006,396309,25.38690,1561077
27378,NotNoah,1,0.00006,396310,25.38696,1561077
27379,notSoWiseOldMan,1,0.00006,396311,25.38702,1561077
27380,nouiz,1,0.00006,396312,25.38709,1561077
27381,Novakov,1,0.00006,396313,25.38715,1561077
27382,novaterata,1,0.00006,396314,25.38722,1561077
27383,novskey,1,0.00006,396315,25.38728,1561077
27384,nowayride,1,0.00006,396316,25.38734,1561077
27385,noymer,1,0.00006,396317,25.38741,1561077
27386,nparry,1,0.00006,396318,25.38747,1561077
27387,npaufler,1,0.00006,396319,25.38754,1561077
27388,n-peugnet,1,0.00006,396320,25.38760,1561077
27389,npmaile,1,0.00006,396321,25.38767,1561077
27390,nqthqn,1,0.00006,396322,25.38773,1561077
27391,nraval1729,1,0.00006,396323,25.38779,1561077
27392,nrchandan,1,0.00006,396324,25.38786,1561077
27393,nreymundo,1,0.00006,396325,25.38792,1561077
27394,nRon,1,0.00006,396326,25.38799,1561077
27395,Nrvjvn,1,0.00006,396327,25.38805,1561077
27396,nsavelyeva,1,0.00006,396328,25.38811,1561077
27397,nsballmann,1,0.00006,396329,25.38818,1561077
27398,nschad,1,0.00006,396330,25.38824,1561077
27399,nschuc,1,0.00006,396331,25.38831,1561077
27400,ns-gsa,1,0.00006,396332,25.38837,1561077
27401,ns-hlam,1,0.00006,396333,25.38843,1561077
27402,nsigarora,1,0.00006,396334,25.38850,1561077
27403,ns-jlizarraga,1,0.00006,396335,25.38856,1561077
27404,ns-mjagtap,1,0.00006,396336,25.38863,1561077
27405,nsraghu,1,0.00006,396337,25.38869,1561077
27406,nsreddydevops,1,0.00006,396338,25.38875,1561077
27407,ns-rwang,1,0.00006,396339,25.38882,1561077
27408,ns-ssrivastava,1,0.00006,396340,25.38888,1561077
27409,nstankov-bg,1,0.00006,396341,25.38895,1561077
27410,nstufano,1,0.00006,396342,25.38901,1561077
27411,nsurleraux-railnova,1,0.00006,396343,25.38907,1561077
27412,ntelisil,1,0.00006,396344,25.38914,1561077
27413,nthykier,1,0.00006,396345,25.38920,1561077
27414,ntindle,1,0.00006,396346,25.38927,1561077
27415,ntmggr,1,0.00006,396347,25.38933,1561077
27416,ntonx,1,0.00006,396348,25.38939,1561077
27417,ntufnel11,1,0.00006,396349,25.38946,1561077
27418,nuBacuk,1,0.00006,396350,25.38952,1561077
27419,NUEB3,1,0.00006,396351,25.38959,1561077
27420,nugaon,1,0.00006,396352,25.38965,1561077
27421,NukeAOSP,1,0.00006,396353,25.38971,1561077
27422,Numan1617,1,0.00006,396354,25.38978,1561077
27423,number5,1,0.00006,396355,25.38984,1561077
27424,numpon014,1,0.00006,396356,25.38991,1561077
27425,nunidoron,1,0.00006,396357,25.38997,1561077
27426,NunoMaga,1,0.00006,396358,25.39004,1561077
27427,nunosilvaaa,1,0.00006,396359,25.39010,1561077
27428,nurerken,1,0.00006,396360,25.39016,1561077
27429,nurgul212,1,0.00006,396361,25.39023,1561077
27430,nurhun,1,0.00006,396362,25.39029,1561077
27431,Nurmukhamed02,1,0.00006,396363,25.39036,1561077
27432,NurPech,1,0.00006,396364,25.39042,1561077
27433,NuvotonMG,1,0.00006,396365,25.39048,1561077
27434,nvasion,1,0.00006,396366,25.39055,1561077
27435,nvasudevan,1,0.00006,396367,25.39061,1561077
27436,nvgoldin,1,0.00006,396368,25.39068,1561077
27437,nvwls,1,0.00006,396369,25.39074,1561077
27438,NwawelAIroume,1,0.00006,396370,25.39080,1561077
27439,nweiler,1,0.00006,396371,25.39087,1561077
27440,nWhitehill,1,0.00006,396372,25.39093,1561077
27441,nwlunatic,1,0.00006,396373,25.39100,1561077
27442,nwps8716,1,0.00006,396374,25.39106,1561077
27443,nyamaste,1,0.00006,396375,25.39112,1561077
27444,nyarasha,1,0.00006,396376,25.39119,1561077
27445,o1egl,1,0.00006,396377,25.39125,1561077
27446,o5,1,0.00006,396378,25.39132,1561077
27447,o8o,1,0.00006,396379,25.39138,1561077
27448,oanogin,1,0.00006,396380,25.39144,1561077
27449,oben-resp,1,0.00006,396381,25.39151,1561077
27450,obenziane2,1,0.00006,396382,25.39157,1561077
27451,oberones,1,0.00006,396383,25.39164,1561077
27452,OBorce,1,0.00006,396384,25.39170,1561077
27453,ObviousDWest,1,0.00006,396385,25.39176,1561077
27454,occasl,1,0.00006,396386,25.39183,1561077
27455,oceangle,1,0.00006,396387,25.39189,1561077
27456,oceanicpanda,1,0.00006,396388,25.39196,1561077
27457,oceanjxbot,1,0.00006,396389,25.39202,1561077
27458,oconnormi,1,0.00006,396390,25.39209,1561077
27459,ocsig,1,0.00006,396391,25.39215,1561077
27460,octopus-prime,1,0.00006,396392,25.39221,1561077
27461,odedgol,1,0.00006,396393,25.39228,1561077
27462,odilontalk,1,0.00006,396394,25.39234,1561077
27463,odin-,1,0.00006,396395,25.39241,1561077
27464,odini,1,0.00006,396396,25.39247,1561077
27465,odockal,1,0.00006,396397,25.39253,1561077
27466,odolbeau,1,0.00006,396398,25.39260,1561077
27467,oe-hbk,1,0.00006,396399,25.39266,1561077
27468,oehme,1,0.00006,396400,25.39273,1561077
27469,OElabed,1,0.00006,396401,25.39279,1561077
27470,oemeryPS,1,0.00006,396402,25.39285,1561077
27471,ofekinger,1,0.00006,396403,25.39292,1561077
27472,offonepoint,1,0.00006,396404,25.39298,1561077
27473,ofirgut007,1,0.00006,396405,25.39305,1561077
27474,ofirmamo,1,0.00006,396406,25.39311,1561077
27475,ogavrisevs,1,0.00006,396407,25.39317,1561077
27476,ogg1e,1,0.00006,396408,25.39324,1561077
27477,ogirardot,1,0.00006,396409,25.39330,1561077
27478,ohadpartuck,1,0.00006,396410,25.39337,1561077
27479,ohauer,1,0.00006,396411,25.39343,1561077
27480,OhTanishJain,1,0.00006,396412,25.39349,1561077
27481,oier,1,0.00006,396413,25.39356,1561077
27482,ojacobson,1,0.00006,396414,25.39362,1561077
27483,ojacquemart,1,0.00006,396415,25.39369,1561077
27484,okansahiner,1,0.00006,396416,25.39375,1561077
27485,okapies,1,0.00006,396417,25.39381,1561077
27486,okeren-cx,1,0.00006,396418,25.39388,1561077
27487,okor,1,0.00006,396419,25.39394,1561077
27488,Oktaliem,1,0.00006,396420,25.39401,1561077
27489,okutane,1,0.00006,396421,25.39407,1561077
27490,okutasan,1,0.00006,396422,25.39413,1561077
27491,ok-world,1,0.00006,396423,25.39420,1561077
27492,olarivain,1,0.00006,396424,25.39426,1561077
27493,olegsmall,1,0.00006,396425,25.39433,1561077
27494,Oleksandr-Silin,1,0.00006,396426,25.39439,1561077
27495,oleksiizozulenko,1,0.00006,396427,25.39446,1561077
27496,oleksiykamenyev,1,0.00006,396428,25.39452,1561077
27497,olen2006,1,0.00006,396429,25.39458,1561077
27498,olevezinho,1,0.00006,396430,25.39465,1561077
27499,olexandrd,1,0.00006,396431,25.39471,1561077
27500,OlgaPaw,1,0.00006,396432,25.39478,1561077
27501,olgunkaya,1,0.00006,396433,25.39484,1561077
27502,olibob,1,0.00006,396434,25.39490,1561077
27503,Olipro,1,0.00006,396435,25.39497,1561077
27504,Oliv95,1,0.00006,396436,25.39503,1561077
27505,oliva123456,1,0.00006,396437,25.39510,1561077
27506,oli-ver,1,0.00006,396438,25.39516,1561077
27507,oliverlife,1,0.00006,396439,25.39522,1561077
27508,olivernaaris,1,0.00006,396440,25.39529,1561077
27509,OliverNiebsch,1,0.00006,396441,25.39535,1561077
27510,oliviamueller,1,0.00006,396442,25.39542,1561077
27511,OlivierPT,1,0.00006,396443,25.39548,1561077
27512,OlivierP-VPG,1,0.00006,396444,25.39554,1561077
27513,OlivierRevial,1,0.00006,396445,25.39561,1561077
27514,olivierto,1,0.00006,396446,25.39567,1561077
27515,ollietb,1,0.00006,396447,25.39574,1561077
27516,olluri,1,0.00006,396448,25.39580,1561077
27517,ollypom,1,0.00006,396449,25.39586,1561077
27518,olmectech,1,0.00006,396450,25.39593,1561077
27519,olsonjac,1,0.00006,396451,25.39599,1561077
27520,OlympusMonds,1,0.00006,396452,25.39606,1561077
27521,om2m,1,0.00006,396453,25.39612,1561077
27522,omaraladin,1,0.00006,396454,25.39618,1561077
27523,Omar-El,1,0.00006,396455,25.39625,1561077
27524,omarnk,1,0.00006,396456,25.39631,1561077
27525,o-marshmallow,1,0.00006,396457,25.39638,1561077
27526,ombmax,1,0.00006,396458,25.39644,1561077
27527,omegadash,1,0.00006,396459,25.39651,1561077
27528,Omeramsc,1,0.00006,396460,25.39657,1561077
27529,omerbsezer,1,0.00006,396461,25.39663,1561077
27530,omerfarukdogan,1,0.00006,396462,25.39670,1561077
27531,omerh1,1,0.00006,396463,25.39676,1561077
27532,omermazig,1,0.00006,396464,25.39683,1561077
27533,omics42,1,0.00006,396465,25.39689,1561077
27534,omiicron,1,0.00006,396466,25.39695,1561077
27535,omishagupta,1,0.00006,396467,25.39702,1561077
27536,OmkarAmberkar,1,0.00006,396468,25.39708,1561077
27537,OmkarSrivastava,1,0.00006,396469,25.39715,1561077
27538,omkartelang,1,0.00006,396470,25.39721,1561077
27539,omnicitadel,1,0.00006,396471,25.39727,1561077
27540,omritoptix,1,0.00006,396472,25.39734,1561077
27541,Onager,1,0.00006,396473,25.39740,1561077
27542,OndraZizka,1,0.00006,396474,25.39747,1561077
27543,OneBadSanta,1,0.00006,396475,25.39753,1561077
27544,onedumslack,1,0.00006,396476,25.39759,1561077
27545,onejli,1,0.00006,396477,25.39766,1561077
27546,OnePointLine,1,0.00006,396478,25.39772,1561077
27547,onethefuture,1,0.00006,396479,25.39779,1561077
27548,OneXeor,1,0.00006,396480,25.39785,1561077
27549,onigoetz,1,0.00006,396481,25.39791,1561077
27550,onlyou2030,1,0.00006,396482,25.39798,1561077
27551,onlywade,1,0.00006,396483,25.39804,1561077
27552,OnPure,1,0.00006,396484,25.39811,1561077
27553,OnTitansShoulder,1,0.00006,396485,25.39817,1561077
27554,oops-oom,1,0.00006,396486,25.39823,1561077
27555,op-ct,1,0.00006,396487,25.39830,1561077
27556,opello,1,0.00006,396488,25.39836,1561077
27557,opeomotayo-n-able,1,0.00006,396489,25.39843,1561077
27558,operatiay,1,0.00006,396490,25.39849,1561077
27559,oppai,1,0.00006,396491,25.39855,1561077
27560,oppodeldoc,1,0.00006,396492,25.39862,1561077
27561,Oppodelldog,1,0.00006,396493,25.39868,1561077
27562,opsroller,1,0.00006,396494,25.39875,1561077
27563,opticabjohannsen,1,0.00006,396495,25.39881,1561077
27564,optimistdk,1,0.00006,396496,25.39888,1561077
27565,optix2000,1,0.00006,396497,25.39894,1561077
27566,Oragoss,1,0.00006,396498,25.39900,1561077
27567,orang3-juic3,1,0.00006,396499,25.39907,1561077
27568,orbis-devops,1,0.00006,396500,25.39913,1561077
27569,orbitwebsig,1,0.00006,396501,25.39920,1561077
27570,orcswang-lang,1,0.00006,396502,25.39926,1561077
27571,oreinert,1,0.00006,396503,25.39932,1561077
27572,OrenAshkenazy,1,0.00006,396504,25.39939,1561077
27573,oren-sava,1,0.00006,396505,25.39945,1561077
27574,or-he-MA,1,0.00006,396506,25.39952,1561077
27575,oriolete,1,0.00006,396507,25.39958,1561077
27576,ori-stoliar,1,0.00006,396508,25.39964,1561077
27577,orj,1,0.00006,396509,25.39971,1561077
27578,orlandoacevedo-pge,1,0.00006,396510,25.39977,1561077
27579,orlra,1,0.00006,396511,25.39984,1561077
27580,Orlys,1,0.00006,396512,25.39990,1561077
27581,orosen,1,0.00006,396513,25.39996,1561077
27582,orovp,1,0.00006,396514,25.40003,1561077
27583,oryulin,1,0.00006,396515,25.40009,1561077
27584,orzechszek,1,0.00006,396516,25.40016,1561077
27585,osamaahf,1,0.00006,396517,25.40022,1561077
27586,osbornk,1,0.00006,396518,25.40028,1561077
27587,OscarBarrett,1,0.00006,396519,25.40035,1561077
27588,Oscarjia,1,0.00006,396520,25.40041,1561077
27589,oscarpicasso-intact,1,0.00006,396521,25.40048,1561077
27590,oschvr,1,0.00006,396522,25.40054,1561077
27591,OskarsPakers,1,0.00006,396523,25.40060,1561077
27592,OSMeteor,1,0.00006,396524,25.40067,1561077
27593,ospector,1,0.00006,396525,25.40073,1561077
27594,ossdhaval,1,0.00006,396526,25.40080,1561077
27595,OstapYeris,1,0.00006,396527,25.40086,1561077
27596,ostera,1,0.00006,396528,25.40093,1561077
27597,ostlerc,1,0.00006,396529,25.40099,1561077
27598,ostueker,1,0.00006,396530,25.40105,1561077
27599,oswaldohp,1,0.00006,396531,25.40112,1561077
27600,otherdave,1,0.00006,396532,25.40118,1561077
27601,othomas,1,0.00006,396533,25.40125,1561077
27602,otodorov,1,0.00006,396534,25.40131,1561077
27603,otrejoso,1,0.00006,396535,25.40137,1561077
27604,otter606,1,0.00006,396536,25.40144,1561077
27605,ottoaho,1,0.00006,396537,25.40150,1561077
27606,otyaglo,1,0.00006,396538,25.40157,1561077
27607,oubre,1,0.00006,396539,25.40163,1561077
27608,OurFriendIrony,1,0.00006,396540,25.40169,1561077
27609,oussama1983,1,0.00006,396541,25.40176,1561077
27610,outman2008,1,0.00006,396542,25.40182,1561077
27611,Overbryd,1,0.00006,396543,25.40189,1561077
27612,OxingchenO,1,0.00006,396544,25.40195,1561077
27613,oxjar,1,0.00006,396545,25.40201,1561077
27614,Oxymoron290,1,0.00006,396546,25.40208,1561077
27615,oxynux,1,0.00006,396547,25.40214,1561077
27616,oyvindrobertsen,1,0.00006,396548,25.40221,1561077
27617,P0sa,1,0.00006,396549,25.40227,1561077
27618,p120ph37,1,0.00006,396550,25.40233,1561077
27619,p3ck,1,0.00006,396551,25.40240,1561077
27620,p3rshin,1,0.00006,396552,25.40246,1561077
27621,p3t3rp3pp3r,1,0.00006,396553,25.40253,1561077
27622,p4kevin,1,0.00006,396554,25.40259,1561077
27623,pabichw,1,0.00006,396555,25.40265,1561077
27624,pablaasmo,1,0.00006,396556,25.40272,1561077
27625,pablito85,1,0.00006,396557,25.40278,1561077
27626,PablloMatheus,1,0.00006,396558,25.40285,1561077
27627,pabloajz,1,0.00006,396559,25.40291,1561077
27628,pablobayarri,1,0.00006,396560,25.40297,1561077
27629,pablobhn,1,0.00006,396561,25.40304,1561077
27630,pabloli84,1,0.00006,396562,25.40310,1561077
27631,pablomesa22,1,0.00006,396563,25.40317,1561077
27632,pablonunezg,1,0.00006,396564,25.40323,1561077
27633,pablorf-dev,1,0.00006,396565,25.40330,1561077
27634,padepokan79dev,1,0.00006,396566,25.40336,1561077
27635,Padhh,1,0.00006,396567,25.40342,1561077
27636,Padma91,1,0.00006,396568,25.40349,1561077
27637,padmanabhps,1,0.00006,396569,25.40355,1561077
27638,pagalavans,1,0.00006,396570,25.40362,1561077
27639,pahsan,1,0.00006,396571,25.40368,1561077
27640,paigashaona,1,0.00006,396572,25.40374,1561077
27641,PAKalucki,1,0.00006,396573,25.40381,1561077
27642,pakoAku,1,0.00006,396574,25.40387,1561077
27643,pakore,1,0.00006,396575,25.40394,1561077
27644,palamvmw,1,0.00006,396576,25.40400,1561077
27645,palashhedau,1,0.00006,396577,25.40406,1561077
27646,pam-,1,0.00006,396578,25.40413,1561077
27647,Pamir,1,0.00006,396579,25.40419,1561077
27648,PanC123,1,0.00006,396580,25.40426,1561077
27649,pandaasu,1,0.00006,396581,25.40432,1561077
27650,pandady,1,0.00006,396582,25.40438,1561077
27651,pandorasbox963,1,0.00006,396583,25.40445,1561077
27652,pandrez,1,0.00006,396584,25.40451,1561077
27653,panelladavide,1,0.00006,396585,25.40458,1561077
27654,pangzheng,1,0.00006,396586,25.40464,1561077
27655,pankaj186,1,0.00006,396587,25.40470,1561077
27656,pankaj301994,1,0.00006,396588,25.40477,1561077
27657,pankajbaman,1,0.00006,396589,25.40483,1561077
27658,pankajjoshi-hub,1,0.00006,396590,25.40490,1561077
27659,PankajS24,1,0.00006,396591,25.40496,1561077
27660,pantosha,1,0.00006,396592,25.40502,1561077
27661,panyis,1,0.00006,396593,25.40509,1561077
27662,paoloventriglia,1,0.00006,396594,25.40515,1561077
27663,paovitali,1,0.00006,396595,25.40522,1561077
27664,papadpanais9,1,0.00006,396596,25.40528,1561077
27665,papaiatis,1,0.00006,396597,25.40535,1561077
27666,papeh,1,0.00006,396598,25.40541,1561077
27667,papemamadou91,1,0.00006,396599,25.40547,1561077
27668,paperino74,1,0.00006,396600,25.40554,1561077
27669,paperPenguin,1,0.00006,396601,25.40560,1561077
27670,paperplane,1,0.00006,396602,25.40567,1561077
27671,papioyue,1,0.00006,396603,25.40573,1561077
27672,papitoio,1,0.00006,396604,25.40579,1561077
27673,PapoyEdits,1,0.00006,396605,25.40586,1561077
27674,parabuzzle,1,0.00006,396606,25.40592,1561077
27675,ParadoxShmaradox,1,0.00006,396607,25.40599,1561077
27676,paragon1987,1,0.00006,396608,25.40605,1561077
27677,parale,1,0.00006,396609,25.40611,1561077
27678,paramsinghvc,1,0.00006,396610,25.40618,1561077
27679,parapunzi,1,0.00006,396611,25.40624,1561077
27680,paraut,1,0.00006,396612,25.40631,1561077
27681,pargev,1,0.00006,396613,25.40637,1561077
27682,parhedberg,1,0.00006,396614,25.40643,1561077
27683,parimala910,1,0.00006,396615,25.40650,1561077
27684,parkycai,1,0.00006,396616,25.40656,1561077
27685,Parlane,1,0.00006,396617,25.40663,1561077
27686,parrisvarney,1,0.00006,396618,25.40669,1561077
27687,parsa20001999,1,0.00006,396619,25.40675,1561077
27688,partounian,1,0.00006,396620,25.40682,1561077
27689,parvathycec,1,0.00006,396621,25.40688,1561077
27690,ParvejAutomation,1,0.00006,396622,25.40695,1561077
27691,PaSaSaP,1,0.00006,396623,25.40701,1561077
27692,pascal01,1,0.00006,396624,25.40707,1561077
27693,passliang,1,0.00006,396625,25.40714,1561077
27694,paszczak3,1,0.00006,396626,25.40720,1561077
27695,pataluc,1,0.00006,396627,25.40727,1561077
27696,patani1,1,0.00006,396628,25.40733,1561077
27697,patbecich,1,0.00006,396629,25.40740,1561077
27698,patbur,1,0.00006,396630,25.40746,1561077
27699,patcon,1,0.00006,396631,25.40752,1561077
27700,patelnidhice,1,0.00006,396632,25.40759,1561077
27701,patguimaraes,1,0.00006,396633,25.40765,1561077
27702,pathakg,1,0.00006,396634,25.40772,1561077
27703,patidarashok,1,0.00006,396635,25.40778,1561077
27704,patn03,1,0.00006,396636,25.40784,1561077
27705,patric42,1,0.00006,396637,25.40791,1561077
27706,PatriceG,1,0.00006,396638,25.40797,1561077
27707,patricematignon,1,0.00006,396639,25.40804,1561077
27708,patricia-mendez-p,1,0.00006,396640,25.40810,1561077
27709,patrickbussmann,1,0.00006,396641,25.40816,1561077
27710,patrickdung,1,0.00006,396642,25.40823,1561077
27711,patrick-higgins,1,0.00006,396643,25.40829,1561077
27712,patrick-hubert-adsk,1,0.00006,396644,25.40836,1561077
27713,patrickjeried,1,0.00006,396645,25.40842,1561077
27714,patrickm630,1,0.00006,396646,25.40848,1561077
27715,patricksnape,1,0.00006,396647,25.40855,1561077
27716,patrickvinas,1,0.00006,396648,25.40861,1561077
27717,patrikn,1,0.00006,396649,25.40868,1561077
27718,PatrikSteuer,1,0.00006,396650,25.40874,1561077
27719,patrmus054,1,0.00006,396651,25.40880,1561077
27720,Pat-Song,1,0.00006,396652,25.40887,1561077
27721,patthoyts,1,0.00006,396653,25.40893,1561077
27722,paulagent,1,0.00006,396654,25.40900,1561077
27723,paulalex,1,0.00006,396655,25.40906,1561077
27724,paulatbipsync,1,0.00006,396656,25.40912,1561077
27725,paulcottin,1,0.00006,396657,25.40919,1561077
27726,pauldamian,1,0.00006,396658,25.40925,1561077
27727,pauldgifford,1,0.00006,396659,25.40932,1561077
27728,paulej,1,0.00006,396660,25.40938,1561077
27729,paulgoh,1,0.00006,396661,25.40944,1561077
27730,paulh86,1,0.00006,396662,25.40951,1561077
27731,paulk8s,1,0.00006,396663,25.40957,1561077
27732,paulletang,1,0.00006,396664,25.40964,1561077
27733,paul-murray-mf,1,0.00006,396665,25.40970,1561077
27734,paulollivier,1,0.00006,396666,25.40977,1561077
27735,paulovittor23,1,0.00006,396667,25.40983,1561077
27736,pavandroggo,1,0.00006,396668,25.40989,1561077
27737,pavani534,1,0.00006,396669,25.40996,1561077
27738,pavankumarbugga,1,0.00006,396670,25.41002,1561077
27739,pavankumarsiliveri,1,0.00006,396671,25.41009,1561077
27740,PavanTatikonda,1,0.00006,396672,25.41015,1561077
27741,pavelbely,1,0.00006,396673,25.41021,1561077
27742,PavelCZE,1,0.00006,396674,25.41028,1561077
27743,pavel-jancik,1,0.00006,396675,25.41034,1561077
27744,pavelpikta,1,0.00006,396676,25.41041,1561077
27745,pavelquezada,1,0.00006,396677,25.41047,1561077
27746,pavelsmolensky,1,0.00006,396678,25.41053,1561077
27747,pavels-zaborovskis-msm,1,0.00006,396679,25.41060,1561077
27748,PavlikPolivka,1,0.00006,396680,25.41066,1561077
27749,pavlobaron,1,0.00006,396681,25.41073,1561077
27750,pavlops,1,0.00006,396682,25.41079,1561077
27751,pavlus,1,0.00006,396683,25.41085,1561077
27752,pavoltravnik,1,0.00006,396684,25.41092,1561077
27753,pawank94,1,0.00006,396685,25.41098,1561077
27754,pawarpriya03,1,0.00006,396686,25.41105,1561077
27755,pawel-furmaniak,1,0.00006,396687,25.41111,1561077
27756,paweljankowski,1,0.00006,396688,25.41117,1561077
27757,pawoh2001,1,0.00006,396689,25.41124,1561077
27758,pax95,1,0.00006,396690,25.41130,1561077
27759,paxos,1,0.00006,396691,25.41137,1561077
27760,payalchhillar,1,0.00006,396692,25.41143,1561077
27761,PayneRose,1,0.00006,396693,25.41149,1561077
27762,pbibra,1,0.00006,396694,25.41156,1561077
27763,pbn04001,1,0.00006,396695,25.41162,1561077
27764,pbowditch,1,0.00006,396696,25.41169,1561077
27765,pbriet,1,0.00006,396697,25.41175,1561077
27766,pbronneberg,1,0.00006,396698,25.41182,1561077
27767,PbTG,1,0.00006,396699,25.41188,1561077
27768,pcanilho,1,0.00006,396700,25.41194,1561077
27769,pcellix,1,0.00006,396701,25.41201,1561077
27770,pchodak,1,0.00006,396702,25.41207,1561077
27771,PClmnt,1,0.00006,396703,25.41214,1561077
27772,pcmanprogrammeur,1,0.00006,396704,25.41220,1561077
27773,pc-tradelab,1,0.00006,396705,25.41226,1561077
27774,pczchen,1,0.00006,396706,25.41233,1561077
27775,pd-andrew-ferguson,1,0.00006,396707,25.41239,1561077
27776,pdefreitas,1,0.00006,396708,25.41246,1561077
27777,pdehlke,1,0.00006,396709,25.41252,1561077
27778,pdenning,1,0.00006,396710,25.41258,1561077
27779,pdev1989,1,0.00006,396711,25.41265,1561077
27780,pdjtrifork,1,0.00006,396712,25.41271,1561077
27781,pdp10,1,0.00006,396713,25.41278,1561077
27782,pdreker,1,0.00006,396714,25.41284,1561077
27783,pdsuwwz,1,0.00006,396715,25.41290,1561077
27784,peachyy,1,0.00006,396716,25.41297,1561077
27785,peclevens,1,0.00006,396717,25.41303,1561077
27786,Peco602,1,0.00006,396718,25.41310,1561077
27787,peddarajugolla1992,1,0.00006,396719,25.41316,1561077
27788,pedersen2Elsevier,1,0.00006,396720,25.41322,1561077
27789,PedesNex,1,0.00006,396721,25.41329,1561077
27790,pedrodelgado81,1,0.00006,396722,25.41335,1561077
27791,pedrodparkes,1,0.00006,396723,25.41342,1561077
27792,PedroGarciaMF,1,0.00006,396724,25.41348,1561077
27793,PedroHeenrique,1,0.00006,396725,25.41354,1561077
27794,pedromartinez11,1,0.00006,396726,25.41361,1561077
27795,pedrooliveira0997,1,0.00006,396727,25.41367,1561077
27796,pedropapa,1,0.00006,396728,25.41374,1561077
27797,pedro-ribeiro,1,0.00006,396729,25.41380,1561077
27798,PedroRodP,1,0.00006,396730,25.41386,1561077
27799,peetzen,1,0.00006,396731,25.41393,1561077
27800,Peggs,1,0.00006,396732,25.41399,1561077
27801,pehaond,1,0.00006,396733,25.41406,1561077
27802,peiying16,1,0.00006,396734,25.41412,1561077
27803,pellcorp,1,0.00006,396735,25.41419,1561077
27804,PenchalTechnologies,1,0.00006,396736,25.41425,1561077
27805,pencui,1,0.00006,396737,25.41431,1561077
27806,penguin02007,1,0.00006,396738,25.41438,1561077
27807,PennyPenny,1,0.00006,396739,25.41444,1561077
27808,penrique,1,0.00006,396740,25.41451,1561077
27809,pepost,1,0.00006,396741,25.41457,1561077
27810,perguth,1,0.00006,396742,25.41463,1561077
27811,perk11,1,0.00006,396743,25.41470,1561077
27812,perkele99,1,0.00006,396744,25.41476,1561077
27813,perkrifj,1,0.00006,396745,25.41483,1561077
27814,Pero110290,1,0.00006,396746,25.41489,1561077
27815,perplexabot,1,0.00006,396747,25.41495,1561077
27816,perrine022,1,0.00006,396748,25.41502,1561077
27817,perryan,1,0.00006,396749,25.41508,1561077
27818,perry-mitchell,1,0.00006,396750,25.41515,1561077
27819,petamas,1,0.00006,396751,25.41521,1561077
27820,petehastwofeet,1,0.00006,396752,25.41527,1561077
27821,peter4431,1,0.00006,396753,25.41534,1561077
27822,peter-banfield-fc,1,0.00006,396754,25.41540,1561077
27823,peterbroadhurst,1,0.00006,396755,25.41547,1561077
27824,peter-daplyn-mortgagegym-com,1,0.00006,396756,25.41553,1561077
27825,peterdporter,1,0.00006,396757,25.41559,1561077
27826,PeterFCaswell,1,0.00006,396758,25.41566,1561077
27827,peter-formlogic,1,0.00006,396759,25.41572,1561077
27828,peterfranks,1,0.00006,396760,25.41579,1561077
27829,peter-k1997,1,0.00006,396761,25.41585,1561077
27830,PeterKneale,1,0.00006,396762,25.41591,1561077
27831,peterkomar,1,0.00006,396763,25.41598,1561077
27832,peterlai-roboops,1,0.00006,396764,25.41604,1561077
27833,petermcj,1,0.00006,396765,25.41611,1561077
27834,PeterMikuska,1,0.00006,396766,25.41617,1561077
27835,peter-mount,1,0.00006,396767,25.41624,1561077
27836,peter-mueller,1,0.00006,396768,25.41630,1561077
27837,petermylemans,1,0.00006,396769,25.41636,1561077
27838,peternelissen,1,0.00006,396770,25.41643,1561077
27839,peter-nordquist,1,0.00006,396771,25.41649,1561077
27840,PeterProbst,1,0.00006,396772,25.41656,1561077
27841,PeterRSVP,1,0.00006,396773,25.41662,1561077
27842,petersendidit,1,0.00006,396774,25.41668,1561077
27843,petersenya,1,0.00006,396775,25.41675,1561077
27844,petershaw,1,0.00006,396776,25.41681,1561077
27845,petertweed,1,0.00006,396777,25.41688,1561077
27846,peteruhnak,1,0.00006,396778,25.41694,1561077
27847,peterwalkley,1,0.00006,396779,25.41700,1561077
27848,peterwiebe,1,0.00006,396780,25.41707,1561077
27849,PeterWippermann,1,0.00006,396781,25.41713,1561077
27850,peterzhuamazon,1,0.00006,396782,25.41720,1561077
27851,peteyako,1,0.00006,396783,25.41726,1561077
27852,Petezah,1,0.00006,396784,25.41732,1561077
27853,PetherPettersson,1,0.00006,396785,25.41739,1561077
27854,pethers,1,0.00006,396786,25.41745,1561077
27855,Petre7,1,0.00006,396787,25.41752,1561077
27856,pety3bi,1,0.00006,396788,25.41758,1561077
27857,pfbco,1,0.00006,396789,25.41764,1561077
27858,pfee,1,0.00006,396790,25.41771,1561077
27859,pfelwor,1,0.00006,396791,25.41777,1561077
27860,pfhayes,1,0.00006,396792,25.41784,1561077
27861,pfink,1,0.00006,396793,25.41790,1561077
27862,pfisher,1,0.00006,396794,25.41796,1561077
27863,Pfiver,1,0.00006,396795,25.41803,1561077
27864,pfleish,1,0.00006,396796,25.41809,1561077
27865,pfong168,1,0.00006,396797,25.41816,1561077
27866,pfrickcol,1,0.00006,396798,25.41822,1561077
27867,PG2000,1,0.00006,396799,25.41828,1561077
27868,pgaucherand,1,0.00006,396800,25.41835,1561077
27869,pghaemi,1,0.00006,396801,25.41841,1561077
27870,pgnunes,1,0.00006,396802,25.41848,1561077
27871,pgressa,1,0.00006,396803,25.41854,1561077
27872,pgulanetsk,1,0.00006,396804,25.41861,1561077
27873,ph228228,1,0.00006,396805,25.41867,1561077
27874,ph4r5h4d,1,0.00006,396806,25.41873,1561077
27875,PhamJay,1,0.00006,396807,25.41880,1561077
27876,phani420,1,0.00006,396808,25.41886,1561077
27877,phanisowjanyavutukuri,1,0.00006,396809,25.41893,1561077
27878,phanitnm,1,0.00006,396810,25.41899,1561077
27879,phantom-d,1,0.00006,396811,25.41905,1561077
27880,phaze-,1,0.00006,396812,25.41912,1561077
27881,phbaer,1,0.00006,396813,25.41918,1561077
27882,pheanex,1,0.00006,396814,25.41925,1561077
27883,pheeel,1,0.00006,396815,25.41931,1561077
27884,PH-F,1,0.00006,396816,25.41937,1561077
27885,phibo23,1,0.00006,396817,25.41944,1561077
27886,phikui,1,0.00006,396818,25.41950,1561077
27887,Phil-11,1,0.00006,396819,25.41957,1561077
27888,philandstuff,1,0.00006,396820,25.41963,1561077
27889,philbrown-mdt,1,0.00006,396821,25.41969,1561077
27890,philfry,1,0.00006,396822,25.41976,1561077
27891,philhof,1,0.00006,396823,25.41982,1561077
27892,philipleetaylor,1,0.00006,396824,25.41989,1561077
27893,philip-nicholls,1,0.00006,396825,25.41995,1561077
27894,philippelabat,1,0.00006,396826,25.42001,1561077
27895,philippe-lavoie,1,0.00006,396827,25.42008,1561077
27896,philippeouellette,1,0.00006,396828,25.42014,1561077
27897,philippo987,1,0.00006,396829,25.42021,1561077
27898,philipp-rs,1,0.00006,396830,25.42027,1561077
27899,philippthun,1,0.00006,396831,25.42033,1561077
27900,PhilLab,1,0.00006,396832,25.42040,1561077
27901,philleonard,1,0.00006,396833,25.42046,1561077
27902,phillipweston,1,0.00006,396834,25.42053,1561077
27903,phillylovepark,1,0.00006,396835,25.42059,1561077
27904,philmosquera,1,0.00006,396836,25.42066,1561077
27905,philnalwalker,1,0.00006,396837,25.42072,1561077
27906,philosowaffle,1,0.00006,396838,25.42078,1561077
27907,philpem,1,0.00006,396839,25.42085,1561077
27908,philsegal,1,0.00006,396840,25.42091,1561077
27909,phi-mah,1,0.00006,396841,25.42098,1561077
27910,phinguyenit,1,0.00006,396842,25.42104,1561077
27911,phippu,1,0.00006,396843,25.42110,1561077
27912,phk0,1,0.00006,396844,25.42117,1561077
27913,phl0,1,0.00006,396845,25.42123,1561077
27914,phmaeso,1,0.00006,396846,25.42130,1561077
27915,Phoenix09,1,0.00006,396847,25.42136,1561077
27916,Phoenix616,1,0.00006,396848,25.42142,1561077
27917,phoerselmann,1,0.00006,396849,25.42149,1561077
27918,phongsiri-tr,1,0.00006,396850,25.42155,1561077
27919,photonecomm,1,0.00006,396851,25.42162,1561077
27920,phpwutz,1,0.00006,396852,25.42168,1561077
27921,phr3nzii,1,0.00006,396853,25.42174,1561077
27922,phra,1,0.00006,396854,25.42181,1561077
27923,phucuong,1,0.00006,396855,25.42187,1561077
27924,phulst,1,0.00006,396856,25.42194,1561077
27925,phystem,1,0.00006,396857,25.42200,1561077
27926,phytoporg,1,0.00006,396858,25.42206,1561077
27927,pianyao,1,0.00006,396859,25.42213,1561077
27928,pictolearn,1,0.00006,396860,25.42219,1561077
27929,pieron187,1,0.00006,396861,25.42226,1561077
27930,pierreboudreau,1,0.00006,396862,25.42232,1561077
27931,pierreboutet,1,0.00006,396863,25.42238,1561077
27932,pierre-guillot-sonarsource,1,0.00006,396864,25.42245,1561077
27933,pierrelemay,1,0.00006,396865,25.42251,1561077
27934,PierrePX,1,0.00006,396866,25.42258,1561077
27935,Pieter007,1,0.00006,396867,25.42264,1561077
27936,pieterdt,1,0.00006,396868,25.42270,1561077
27937,pieterpaladin,1,0.00006,396869,25.42277,1561077
27938,Pietro28,1,0.00006,396870,25.42283,1561077
27939,pietroaragona,1,0.00006,396871,25.42290,1561077
27940,pietromarchesani,1,0.00006,396872,25.42296,1561077
27941,pik0,1,0.00006,396873,25.42303,1561077
27942,Pikabanga,1,0.00006,396874,25.42309,1561077
27943,pilere,1,0.00006,396875,25.42315,1561077
27944,pillarsdotnet,1,0.00006,396876,25.42322,1561077
27945,pilz,1,0.00006,396877,25.42328,1561077
27946,pingram3030,1,0.00006,396878,25.42335,1561077
27947,pinguo-zhouwei,1,0.00006,396879,25.42341,1561077
27948,pingwhistle,1,0.00006,396880,25.42347,1561077
27949,pinkyo,1,0.00006,396881,25.42354,1561077
27950,pinterb,1,0.00006,396882,25.42360,1561077
27951,pinturic,1,0.00006,396883,25.42367,1561077
27952,piokania,1,0.00006,396884,25.42373,1561077
27953,piotrbrzuska,1,0.00006,396885,25.42379,1561077
27954,piotrsulej,1,0.00006,396886,25.42386,1561077
27955,Pipen,1,0.00006,396887,25.42392,1561077
27956,Pipikachu,1,0.00006,396888,25.42399,1561077
27957,Pirabarlen-Cheenaramen,1,0.00006,396889,25.42405,1561077
27958,pispico,1,0.00006,396890,25.42411,1561077
27959,pitargue,1,0.00006,396891,25.42418,1561077
27960,PiterGoCompany,1,0.00006,396892,25.42424,1561077
27961,piteros83,1,0.00006,396893,25.42431,1561077
27962,Pitority,1,0.00006,396894,25.42437,1561077
27963,pittavini,1,0.00006,396895,25.42443,1561077
27964,pixelbaker,1,0.00006,396896,25.42450,1561077
27965,PixleProgrambetaxl,1,0.00006,396897,25.42456,1561077
27966,pixrl,1,0.00006,396898,25.42463,1561077
27967,piyas33,1,0.00006,396899,25.42469,1561077
27968,piyushk,1,0.00006,396900,25.42475,1561077
27969,pjaffe,1,0.00006,396901,25.42482,1561077
27970,pjanuario,1,0.00006,396902,25.42488,1561077
27971,pjayago,1,0.00006,396903,25.42495,1561077
27972,pjfila,1,0.00006,396904,25.42501,1561077
27973,PJHRobles,1,0.00006,396905,25.42508,1561077
27974,PJ-ISC,1,0.00006,396906,25.42514,1561077
27975,pjmtdw,1,0.00006,396907,25.42520,1561077
27976,pjnozisk,1,0.00006,396908,25.42527,1561077
27977,pjuarezd,1,0.00006,396909,25.42533,1561077
27978,pjuarez-tiempo,1,0.00006,396910,25.42540,1561077
27979,pk,1,0.00006,396911,25.42546,1561077
27980,PK89SC,1,0.00006,396912,25.42552,1561077
27981,pkandarpa-cs,1,0.00006,396913,25.42559,1561077
27982,pkania,1,0.00006,396914,25.42565,1561077
27983,pkhruasu-ui,1,0.00006,396915,25.42572,1561077
27984,pkkummermo,1,0.00006,396916,25.42578,1561077
27985,pkordes,1,0.00006,396917,25.42584,1561077
27986,pkr1234,1,0.00006,396918,25.42591,1561077
27987,pkrall520,1,0.00006,396919,25.42597,1561077
27988,pkrssl,1,0.00006,396920,25.42604,1561077
27989,pkshort,1,0.00006,396921,25.42610,1561077
27990,pkthunda,1,0.00006,396922,25.42616,1561077
27991,pkubatrh,1,0.00006,396923,25.42623,1561077
27992,pkumarbe,1,0.00006,396924,25.42629,1561077
27993,plainwu,1,0.00006,396925,25.42636,1561077
27994,planesweep,1,0.00006,396926,25.42642,1561077
27995,Planet2010,1,0.00006,396927,25.42648,1561077
27996,platof,1,0.00006,396928,25.42655,1561077
27997,PlaytonicLtd,1,0.00006,396929,25.42661,1561077
27998,pleimer,1,0.00006,396930,25.42668,1561077
27999,plenart,1,0.00006,396931,25.42674,1561077
28000,plentifullee,1,0.00006,396932,25.42680,1561077
28001,plentz,1,0.00006,396933,25.42687,1561077
28002,Pleshchuk,1,0.00006,396934,25.42693,1561077
28003,pligor,1,0.00006,396935,25.42700,1561077
28004,pliniusblah,1,0.00006,396936,25.42706,1561077
28005,plonser,1,0.00006,396937,25.42712,1561077
28006,plukevdh,1,0.00006,396938,25.42719,1561077
28007,Pluteus,1,0.00006,396939,25.42725,1561077
28008,pmahajan-ee,1,0.00006,396940,25.42732,1561077
28009,pmanlukas,1,0.00006,396941,25.42738,1561077
28010,pmblanco,1,0.00006,396942,25.42745,1561077
28011,pmckeown,1,0.00006,396943,25.42751,1561077
28012,pmedapuram,1,0.00006,396944,25.42757,1561077
28013,pmn3232,1,0.00006,396945,25.42764,1561077
28014,pmoosh,1,0.00006,396946,25.42770,1561077
28015,pmoranga,1,0.00006,396947,25.42777,1561077
28016,pm-priyesh-potdar,1,0.00006,396948,25.42783,1561077
28017,Pnchal,1,0.00006,396949,25.42789,1561077
28018,PNikolenko,1,0.00006,396950,25.42796,1561077
28019,pnosovets-sc,1,0.00006,396951,25.42802,1561077
28020,pnvnd,1,0.00006,396952,25.42809,1561077
28021,poflynn,1,0.00006,396953,25.42815,1561077
28022,poikilotherm,1,0.00006,396954,25.42821,1561077
28023,poizonhack,1,0.00006,396955,25.42828,1561077
28024,pokekrishna,1,0.00006,396956,25.42834,1561077
28025,Pokom,1,0.00006,396957,25.42841,1561077
28026,poliveira-fuze,1,0.00006,396958,25.42847,1561077
28027,polok,1,0.00006,396959,25.42853,1561077
28028,polRk,1,0.00006,396960,25.42860,1561077
28029,pombaer,1,0.00006,396961,25.42866,1561077
28030,pomrw,1,0.00006,396962,25.42873,1561077
28031,pooja24n,1,0.00006,396963,25.42879,1561077
28032,pooja-hub200,1,0.00006,396964,25.42885,1561077
28033,poojaofficial-git,1,0.00006,396965,25.42892,1561077
28034,poongundrang,1,0.00006,396966,25.42898,1561077
28035,porcupie,1,0.00006,396967,25.42905,1561077
28036,portenez,1,0.00006,396968,25.42911,1561077
28037,porto88,1,0.00006,396969,25.42917,1561077
28038,PoseyZhong,1,0.00006,396970,25.42924,1561077
28039,poshak003,1,0.00006,396971,25.42930,1561077
28040,posinaga-demo,1,0.00006,396972,25.42937,1561077
28041,PositiveControl,1,0.00006,396973,25.42943,1561077
28042,Potoman,1,0.00006,396974,25.42950,1561077
28043,poxu,1,0.00006,396975,25.42956,1561077
28044,ppadialitrs,1,0.00006,396976,25.42962,1561077
28045,ppattard,1,0.00006,396977,25.42969,1561077
28046,ppaul-square,1,0.00006,396978,25.42975,1561077
28047,PP-DanielB,1,0.00006,396979,25.42982,1561077
28048,ppeterka,1,0.00006,396980,25.42988,1561077
28049,ppodbielski-cloudentity,1,0.00006,396981,25.42994,1561077
28050,ppRadu,1,0.00006,396982,25.43001,1561077
28051,ppthegp,1,0.00006,396983,25.43007,1561077
28052,Pr60,1,0.00006,396984,25.43014,1561077
28053,prabaharang,1,0.00006,396985,25.43020,1561077
28054,prabha077,1,0.00006,396986,25.43026,1561077
28055,prabhuj10,1,0.00006,396987,25.43033,1561077
28056,prabhurs123,1,0.00006,396988,25.43039,1561077
28057,prabhutw,1,0.00006,396989,25.43046,1561077
28058,pradeepcaleb,1,0.00006,396990,25.43052,1561077
28059,Pradeepmaregowda24,1,0.00006,396991,25.43058,1561077
28060,PradeepSubramani21,1,0.00006,396992,25.43065,1561077
28061,pradeepTechStream,1,0.00006,396993,25.43071,1561077
28062,pradeep-uipath,1,0.00006,396994,25.43078,1561077
28063,Pradeeshbm,1,0.00006,396995,25.43084,1561077
28064,Pradnya2103,1,0.00006,396996,25.43090,1561077
28065,pradyumna1979,1,0.00006,396997,25.43097,1561077
28066,PragyaJain23,1,0.00006,396998,25.43103,1561077
28067,prakashgula,1,0.00006,396999,25.43110,1561077
28068,prakashpqa,1,0.00006,397000,25.43116,1561077
28069,prakashul,1,0.00006,397001,25.43122,1561077
28070,prakrit55,1,0.00006,397002,25.43129,1561077
28071,pramodhkp,1,0.00006,397003,25.43135,1561077
28072,PramodhKumarM,1,0.00006,397004,25.43142,1561077
28073,pramodnimmagadda-kore,1,0.00006,397005,25.43148,1561077
28074,Pranathi0608,1,0.00006,397006,25.43155,1561077
28075,pranavmody,1,0.00006,397007,25.43161,1561077
28076,pranay230,1,0.00006,397008,25.43167,1561077
28077,pranay511,1,0.00006,397009,25.43174,1561077
28078,PraneshAnandhan,1,0.00006,397010,25.43180,1561077
28079,PrasadKapa,1,0.00006,397011,25.43187,1561077
28080,PrasadP744,1,0.00006,397012,25.43193,1561077
28081,PrasannaAtLearnyst,1,0.00006,397013,25.43199,1561077
28082,prasanna-sk,1,0.00006,397014,25.43206,1561077
28083,prasanthpola25,1,0.00006,397015,25.43212,1561077
28084,prasanthrubyist,1,0.00006,397016,25.43219,1561077
28085,prashant-bande,1,0.00006,397017,25.43225,1561077
28086,prashantd31,1,0.00006,397018,25.43231,1561077
28087,prashanthh727,1,0.00006,397019,25.43238,1561077
28088,prashanthkasoju,1,0.00006,397020,25.43244,1561077
28089,prashant-kumar-exa,1,0.00006,397021,25.43251,1561077
28090,prashantmv,1,0.00006,397022,25.43257,1561077
28091,PrashantSabnekar,1,0.00006,397023,25.43263,1561077
28092,prateekjesingh,1,0.00006,397024,25.43270,1561077
28093,prateeksarda,1,0.00006,397025,25.43276,1561077
28094,pratidnya2019,1,0.00006,397026,25.43283,1561077
28095,pratik60,1,0.00006,397027,25.43289,1561077
28096,Pratishvg,1,0.00006,397028,25.43295,1561077
28097,pratts,1,0.00006,397029,25.43302,1561077
28098,Pravallika4,1,0.00006,397030,25.43308,1561077
28099,PravallikaDin,1,0.00006,397031,25.43315,1561077
28100,pravargauba,1,0.00006,397032,25.43321,1561077
28101,praveen31,1,0.00006,397033,25.43327,1561077
28102,Praveenkumar99,1,0.00006,397034,25.43334,1561077
28103,PraveenMetri,1,0.00006,397035,25.43340,1561077
28104,praveen-mummasani,1,0.00006,397036,25.43347,1561077
28105,praveensatti,1,0.00006,397037,25.43353,1561077
28106,praves77,1,0.00006,397038,25.43359,1561077
28107,PraveshDev,1,0.00006,397039,25.43366,1561077
28108,PravinaBhatt,1,0.00006,397040,25.43372,1561077
28109,pravinkadu,1,0.00006,397041,25.43379,1561077
28110,preconceptstech84,1,0.00006,397042,25.43385,1561077
28111,predivo,1,0.00006,397043,25.43392,1561077
28112,preet1309,1,0.00006,397044,25.43398,1561077
28113,preethamrao829,1,0.00006,397045,25.43404,1561077
28114,PreetiCK,1,0.00006,397046,25.43411,1561077
28115,preetsindhal,1,0.00006,397047,25.43417,1561077
28116,premgangana-xlnx,1,0.00006,397048,25.43424,1561077
28117,premroxx,1,0.00006,397049,25.43430,1561077
28118,premsair,1,0.00006,397050,25.43436,1561077
28119,prem-subramanyam,1,0.00006,397051,25.43443,1561077
28120,pres,1,0.00006,397052,25.43449,1561077
28121,prestontim,1,0.00006,397053,25.43456,1561077
28122,Prezto,1,0.00006,397054,25.43462,1561077
28123,princepaulson1,1,0.00006,397055,25.43468,1561077
28124,priscofarina,1,0.00006,397056,25.43475,1561077
28125,priyab83,1,0.00006,397057,25.43481,1561077
28126,priya-jagyasi011,1,0.00006,397058,25.43488,1561077
28127,PriyankaKoparkar,1,0.00006,397059,25.43494,1561077
28128,priyank-fuel,1,0.00006,397060,25.43500,1561077
28129,priyeshgpatel,1,0.00006,397061,25.43507,1561077
28130,priytamaj,1,0.00006,397062,25.43513,1561077
28131,prjpet,1,0.00006,397063,25.43520,1561077
28132,prkhisti,1,0.00006,397064,25.43526,1561077
28133,probaton,1,0.00006,397065,25.43532,1561077
28134,procodr,1,0.00006,397066,25.43539,1561077
28135,proferit,1,0.00006,397067,25.43545,1561077
28136,ProfessorDeGraw,1,0.00006,397068,25.43552,1561077
28137,professoryaffl,1,0.00006,397069,25.43558,1561077
28138,Proger666,1,0.00006,397070,25.43564,1561077
28139,programeriss,1,0.00006,397071,25.43571,1561077
28140,progwml6,1,0.00006,397072,25.43577,1561077
28141,Prometej,1,0.00006,397073,25.43584,1561077
28142,prossaro,1,0.00006,397074,25.43590,1561077
28143,protazy,1,0.00006,397075,25.43597,1561077
28144,protenhan,1,0.00006,397076,25.43603,1561077
28145,proteus-russ,1,0.00006,397077,25.43609,1561077
28146,proth1,1,0.00006,397078,25.43616,1561077
28147,proxity,1,0.00006,397079,25.43622,1561077
28148,prudhvio33,1,0.00006,397080,25.43629,1561077
28149,prumand,1,0.00006,397081,25.43635,1561077
28150,pruthvi6767,1,0.00006,397082,25.43641,1561077
28151,prvnsinghal,1,0.00006,397083,25.43648,1561077
28152,przala,1,0.00006,397084,25.43654,1561077
28153,przemekgaj,1,0.00006,397085,25.43661,1561077
28154,PrzemyslawBlazyca4Exp,1,0.00006,397086,25.43667,1561077
28155,psagrera,1,0.00006,397087,25.43673,1561077
28156,psaini0212,1,0.00006,397088,25.43680,1561077
28157,psa-vthai,1,0.00006,397089,25.43686,1561077
28158,ps-beilers,1,0.00006,397090,25.43693,1561077
28159,pschipitsch,1,0.00006,397091,25.43699,1561077
28160,PseudoNerd,1,0.00006,397092,25.43705,1561077
28161,pseudorand-1,1,0.00006,397093,25.43712,1561077
28162,psgoh,1,0.00006,397094,25.43718,1561077
28163,pshapoval,1,0.00006,397095,25.43725,1561077
28164,pshemass,1,0.00006,397096,25.43731,1561077
28165,pshirshov,1,0.00006,397097,25.43737,1561077
28166,pshynin,1,0.00006,397098,25.43744,1561077
28167,pshynin-pentaho,1,0.00006,397099,25.43750,1561077
28168,psikicktim,1,0.00006,397100,25.43757,1561077
28169,psiservices-aray,1,0.00006,397101,25.43763,1561077
28170,ps-jay,1,0.00006,397102,25.43769,1561077
28171,pskpg86,1,0.00006,397103,25.43776,1561077
28172,ps-rfriesen,1,0.00006,397104,25.43782,1561077
28173,psufoxman,1,0.00006,397105,25.43789,1561077
28174,ptarakes,1,0.00006,397106,25.43795,1561077
28175,Ptho0,1,0.00006,397107,25.43801,1561077
28176,ptkimball,1,0.00006,397108,25.43808,1561077
28177,ptletski,1,0.00006,397109,25.43814,1561077
28178,ptomato,1,0.00006,397110,25.43821,1561077
28179,ptorkko,1,0.00006,397111,25.43827,1561077
28180,ptrthomas,1,0.00006,397112,25.43834,1561077
28181,ptrtonull,1,0.00006,397113,25.43840,1561077
28182,ptusch,1,0.00006,397114,25.43846,1561077
28183,PuckOut,1,0.00006,397115,25.43853,1561077
28184,pudge,1,0.00006,397116,25.43859,1561077
28185,pudi1975,1,0.00006,397117,25.43866,1561077
28186,puel,1,0.00006,397118,25.43872,1561077
28187,pugmas,1,0.00006,397119,25.43878,1561077
28188,pulsaar,1,0.00006,397120,25.43885,1561077
28189,PulsatingStar,1,0.00006,397121,25.43891,1561077
28190,pumazi,1,0.00006,397122,25.43898,1561077
28191,pumba-lt,1,0.00006,397123,25.43904,1561077
28192,puneetpunj,1,0.00006,397124,25.43910,1561077
28193,punkerside,1,0.00006,397125,25.43917,1561077
28194,PuppetA17,1,0.00006,397126,25.43923,1561077
28195,puppetmaster-,1,0.00006,397127,25.43930,1561077
28196,puritys,1,0.00006,397128,25.43936,1561077
28197,Pursuit92,1,0.00006,397129,25.43942,1561077
28198,purushothr,1,0.00006,397130,25.43949,1561077
28199,pushkar2017,1,0.00006,397131,25.43955,1561077
28200,Pushkar-Mahajan4,1,0.00006,397132,25.43962,1561077
28201,pushpamsaxenafl,1,0.00006,397133,25.43968,1561077
28202,putaze,1,0.00006,397134,25.43974,1561077
28203,Puvijo3,1,0.00006,397135,25.43981,1561077
28204,puzzled-lazlo,1,0.00006,397136,25.43987,1561077
28205,puzzup,1,0.00006,397137,25.43994,1561077
28206,pvanhoof,1,0.00006,397138,25.44000,1561077
28207,pviral,1,0.00006,397139,25.44006,1561077
28208,pvkamath,1,0.00006,397140,25.44013,1561077
28209,pvposso,1,0.00006,397141,25.44019,1561077
28210,PW999,1,0.00006,397142,25.44026,1561077
28211,PWalsh3,1,0.00006,397143,25.44032,1561077
28212,pwang2,1,0.00006,397144,25.44039,1561077
28213,pwdebruin1,1,0.00006,397145,25.44045,1561077
28214,pwlmesos,1,0.00006,397146,25.44051,1561077
28215,pwnorbitals,1,0.00006,397147,25.44058,1561077
28216,pychamps,1,0.00006,397148,25.44064,1561077
28217,pyleeric,1,0.00006,397149,25.44071,1561077
28218,pyramid-johng,1,0.00006,397150,25.44077,1561077
28219,Pyrolistical,1,0.00006,397151,25.44083,1561077
28220,pyrrhosii,1,0.00006,397152,25.44090,1561077
28221,pyrsia-devops,1,0.00006,397153,25.44096,1561077
28222,pysiekytel,1,0.00006,397154,25.44103,1561077
28223,p-zilla,1,0.00006,397155,25.44109,1561077
28224,q464pp,1,0.00006,397156,25.44115,1561077
28225,q980916297,1,0.00006,397157,25.44122,1561077
28226,QAAAAAAAA,1,0.00006,397158,25.44128,1561077
28227,qaautomationreqts,1,0.00006,397159,25.44135,1561077
28228,qamatic,1,0.00006,397160,25.44141,1561077
28229,QAston,1,0.00006,397161,25.44147,1561077
28230,QAutomatron,1,0.00006,397162,25.44154,1561077
28231,qbaze,1,0.00006,397163,25.44160,1561077
28232,qbixsd,1,0.00006,397164,25.44167,1561077
28233,qchimera,1,0.00006,397165,25.44173,1561077
28234,qdncs,1,0.00006,397166,25.44179,1561077
28235,QDoubleM,1,0.00006,397167,25.44186,1561077
28236,qeepcologne,1,0.00006,397168,25.44192,1561077
28237,qemtrails,1,0.00006,397169,25.44199,1561077
28238,qermit,1,0.00006,397170,25.44205,1561077
28239,qestoppey,1,0.00006,397171,25.44211,1561077
28240,qgong,1,0.00006,397172,25.44218,1561077
28241,qichensb,1,0.00006,397173,25.44224,1561077
28242,qingdi,1,0.00006,397174,25.44231,1561077
28243,qingwanggo,1,0.00006,397175,25.44237,1561077
28244,qinweiwen,1,0.00006,397176,25.44243,1561077
28245,qiufanchao,1,0.00006,397177,25.44250,1561077
28246,qiupei,1,0.00006,397178,25.44256,1561077
28247,qiushile,1,0.00006,397179,25.44263,1561077
28248,qiuxiafei,1,0.00006,397180,25.44269,1561077
28249,qkslvrwolf,1,0.00006,397181,25.44276,1561077
28250,qlihdunn,1,0.00006,397182,25.44282,1561077
28251,qnox,1,0.00006,397183,25.44288,1561077
28252,qq383199165,1,0.00006,397184,25.44295,1561077
28253,qq7987590,1,0.00006,397185,25.44301,1561077
28254,qq97241481,1,0.00006,397186,25.44308,1561077
28255,qqbuby,1,0.00006,397187,25.44314,1561077
28256,qqian1991,1,0.00006,397188,25.44320,1561077
28257,qqq978786182,1,0.00006,397189,25.44327,1561077
28258,q-rab,1,0.00006,397190,25.44333,1561077
28259,qsiebers,1,0.00006,397191,25.44340,1561077
28260,quad5,1,0.00006,397192,25.44346,1561077
28261,quanvuong24,1,0.00006,397193,25.44352,1561077
28262,Quanyails,1,0.00006,397194,25.44359,1561077
28263,quentin-lpt,1,0.00006,397195,25.44365,1561077
28264,queria,1,0.00006,397196,25.44372,1561077
28265,quick-sort,1,0.00006,397197,25.44378,1561077
28266,quietust,1,0.00006,397198,25.44384,1561077
28267,quike,1,0.00006,397199,25.44391,1561077
28268,quimcalpe,1,0.00006,397200,25.44397,1561077
28269,QuinRogers,1,0.00006,397201,25.44404,1561077
28270,quintinxuan,1,0.00006,397202,25.44410,1561077
28271,Quirexx,1,0.00006,397203,25.44416,1561077
28272,quldude,1,0.00006,397204,25.44423,1561077
28273,Quorce,1,0.00006,397205,25.44429,1561077
28274,quroom,1,0.00006,397206,25.44436,1561077
28275,qvissak,1,0.00006,397207,25.44442,1561077
28276,qwe1290670214,1,0.00006,397208,25.44448,1561077
28277,qwertyI,1,0.00006,397209,25.44455,1561077
28278,qzk,1,0.00006,397210,25.44461,1561077
28279,r00t4ccess,1,0.00006,397211,25.44468,1561077
28280,r00t4dm,1,0.00006,397212,25.44474,1561077
28281,r0bbie,1,0.00006,397213,25.44481,1561077
28282,R0GERIUS,1,0.00006,397214,25.44487,1561077
28283,r1ckyrockz,1,0.00006,397215,25.44493,1561077
28284,r1w1s1,1,0.00006,397216,25.44500,1561077
28285,R2Rs,1,0.00006,397217,25.44506,1561077
28286,r34lm63157,1,0.00006,397218,25.44513,1561077
28287,R4md4c,1,0.00006,397219,25.44519,1561077
28288,raadesh,1,0.00006,397220,25.44525,1561077
28289,rabbbit,1,0.00006,397221,25.44532,1561077
28290,rabel7,1,0.00006,397222,25.44538,1561077
28291,raboy,1,0.00006,397223,25.44545,1561077
28292,rachellerathbone,1,0.00006,397224,25.44551,1561077
28293,rachelslurs,1,0.00006,397225,25.44557,1561077
28294,rachit-gupta,1,0.00006,397226,25.44564,1561077
28295,Rachitmehrotra,1,0.00006,397227,25.44570,1561077
28296,rackstar01,1,0.00006,397228,25.44577,1561077
28297,racsoce,1,0.00006,397229,25.44583,1561077
28298,radeesh,1,0.00006,397230,25.44589,1561077
28299,radhikasivakumar,1,0.00006,397231,25.44596,1561077
28300,radianer,1,0.00006,397232,25.44602,1561077
28301,RadiatorSpring,1,0.00006,397233,25.44609,1561077
28302,radinsky,1,0.00006,397234,25.44615,1561077
28303,radium226,1,0.00006,397235,25.44621,1561077
28304,radius314,1,0.00006,397236,25.44628,1561077
28305,Radoslaw152,1,0.00006,397237,25.44634,1561077
28306,radsoulbeard,1,0.00006,397238,25.44641,1561077
28307,raduhek,1,0.00006,397239,25.44647,1561077
28308,radzimir,1,0.00006,397240,25.44653,1561077
28309,rafabc,1,0.00006,397241,25.44660,1561077
28310,rafaelcaricio,1,0.00006,397242,25.44666,1561077
28311,rafaelmonteiroarj,1,0.00006,397243,25.44673,1561077
28312,rafaelpirolla,1,0.00006,397244,25.44679,1561077
28313,rafaelrliscano,1,0.00006,397245,25.44685,1561077
28314,rafaelsilvaa10,1,0.00006,397246,25.44692,1561077
28315,rafaeltokyo,1,0.00006,397247,25.44698,1561077
28316,rafalfaro18,1,0.00006,397248,25.44705,1561077
28317,rafitur2,1,0.00006,397249,25.44711,1561077
28318,rafi-tvtime,1,0.00006,397250,25.44718,1561077
28319,rafi-whipclip,1,0.00006,397251,25.44724,1561077
28320,rag1998,1,0.00006,397252,25.44730,1561077
28321,rageshns,1,0.00006,397253,25.44737,1561077
28322,raghavendrabijjula,1,0.00006,397254,25.44743,1561077
28323,RaghuNandanBS,1,0.00006,397255,25.44750,1561077
28324,raghupatelraj,1,0.00006,397256,25.44756,1561077
28325,raghur,1,0.00006,397257,25.44762,1561077
28326,raghureddycloud,1,0.00006,397258,25.44769,1561077
28327,raghurok,1,0.00006,397259,25.44775,1561077
28328,raghuvarmabh,1,0.00006,397260,25.44782,1561077
28329,raghuvennam,1,0.00006,397261,25.44788,1561077
28330,Ragin-LundF,1,0.00006,397262,25.44794,1561077
28331,ragm87,1,0.00006,397263,25.44801,1561077
28332,ragnadm,1,0.00006,397264,25.44807,1561077
28333,Ragnaroek,1,0.00006,397265,25.44814,1561077
28334,ragnor,1,0.00006,397266,25.44820,1561077
28335,rags147,1,0.00006,397267,25.44826,1561077
28336,ragumix,1,0.00006,397268,25.44833,1561077
28337,ragu-v,1,0.00006,397269,25.44839,1561077
28338,rahmanaasri95,1,0.00006,397270,25.44846,1561077
28339,rahulbhange,1,0.00006,397271,25.44852,1561077
28340,Rahulkhinchi03,1,0.00006,397272,25.44858,1561077
28341,rahulndr,1,0.00006,397273,25.44865,1561077
28342,RahulSharma19021996,1,0.00006,397274,25.44871,1561077
28343,rahulwagh,1,0.00006,397275,25.44878,1561077
28344,raigon44,1,0.00006,397276,25.44884,1561077
28345,raijinsetsu,1,0.00006,397277,25.44890,1561077
28346,raine,1,0.00006,397278,25.44897,1561077
28347,rainerfrey-inxmail,1,0.00006,397279,25.44903,1561077
28348,raisalpa,1,0.00006,397280,25.44910,1561077
28349,raivil,1,0.00006,397281,25.44916,1561077
28350,raj333921,1,0.00006,397282,25.44923,1561077
28351,rajablackhat,1,0.00006,397283,25.44929,1561077
28352,rajand87,1,0.00006,397284,25.44935,1561077
28353,RajasGujarathi,1,0.00006,397285,25.44942,1561077
28354,rajat3jain,1,0.00006,397286,25.44948,1561077
28355,rajata07,1,0.00006,397287,25.44955,1561077
28356,rajatrawat99,1,0.00006,397288,25.44961,1561077
28357,rajboruah,1,0.00006,397289,25.44967,1561077
28358,rajeevb2,1,0.00006,397290,25.44974,1561077
28359,Rajesh27019994,1,0.00006,397291,25.44980,1561077
28360,rajeshgond,1,0.00006,397292,25.44987,1561077
28361,rajeshgupthar,1,0.00006,397293,25.44993,1561077
28362,rajeshhazari,1,0.00006,397294,25.44999,1561077
28363,rajesh-kumar,1,0.00006,397295,25.45006,1561077
28364,rajeshmandya,1,0.00006,397296,25.45012,1561077
28365,rajeshvaralli,1,0.00006,397297,25.45019,1561077
28366,RajeshwariSubramaniam,1,0.00006,397298,25.45025,1561077
28367,raj-gunda,1,0.00006,397299,25.45031,1561077
28368,raj-inamdar,1,0.00006,397300,25.45038,1561077
28369,rajish,1,0.00006,397301,25.45044,1561077
28370,rajithadhar,1,0.00006,397302,25.45051,1561077
28371,rajivshankar1982,1,0.00006,397303,25.45057,1561077
28372,rajkiran7117,1,0.00006,397304,25.45063,1561077
28373,rajumukkisa1,1,0.00006,397305,25.45070,1561077
28374,rakaupuv,1,0.00006,397306,25.45076,1561077
28375,RakeshAnbu,1,0.00006,397307,25.45083,1561077
28376,rakesharumalla,1,0.00006,397308,25.45089,1561077
28377,RakeshNagarajan,1,0.00006,397309,25.45095,1561077
28378,Raketemensch,1,0.00006,397310,25.45102,1561077
28379,raketenolli,1,0.00006,397311,25.45108,1561077
28380,rakheshn,1,0.00006,397312,25.45115,1561077
28381,ralekseenkov,1,0.00006,397313,25.45121,1561077
28382,Ralf-Te,1,0.00006,397314,25.45127,1561077
28383,Ralkage,1,0.00006,397315,25.45134,1561077
28384,RalphBergmannKMB,1,0.00006,397316,25.45140,1561077
28385,rama-arun,1,0.00006,397317,25.45147,1561077
28386,ramc-n,1,0.00006,397318,25.45153,1561077
28387,ramdops,1,0.00006,397319,25.45160,1561077
28388,rameden,1,0.00006,397320,25.45166,1561077
28389,ramesbury,1,0.00006,397321,25.45172,1561077
28390,ramesh-krishnan-metro,1,0.00006,397322,25.45179,1561077
28391,RameshMuthuraj,1,0.00006,397323,25.45185,1561077
28392,rameshthoomu,1,0.00006,397324,25.45192,1561077
28393,Ramesh-V-R,1,0.00006,397325,25.45198,1561077
28394,ramielrowe,1,0.00006,397326,25.45204,1561077
28395,Raminios,1,0.00006,397327,25.45211,1561077
28396,ramit-rulz,1,0.00006,397328,25.45217,1561077
28397,ramk2020,1,0.00006,397329,25.45224,1561077
28398,ramkama,1,0.00006,397330,25.45230,1561077
28399,ramkrishna2105,1,0.00006,397331,25.45236,1561077
28400,ramoantonioms,1,0.00006,397332,25.45243,1561077
28401,ramprasadgk,1,0.00006,397333,25.45249,1561077
28402,ramsey,1,0.00006,397334,25.45256,1561077
28403,Ramuimmadi,1,0.00006,397335,25.45262,1561077
28404,ramvilas619,1,0.00006,397336,25.45268,1561077
28405,ramyaa,1,0.00006,397337,25.45275,1561077
28406,ramyamango123,1,0.00006,397338,25.45281,1561077
28407,RamyTemim,1,0.00006,397339,25.45288,1561077
28408,ramzimaalej,1,0.00006,397340,25.45294,1561077
28409,ranbirkatal,1,0.00006,397341,25.45300,1561077
28410,Randagio13,1,0.00006,397342,25.45307,1561077
28411,randakar,1,0.00006,397343,25.45313,1561077
28412,randallnowsecure,1,0.00006,397344,25.45320,1561077
28413,RandalTeng,1,0.00006,397345,25.45326,1561077
28414,RandomReaper,1,0.00006,397346,25.45332,1561077
28415,randomvoids,1,0.00006,397347,25.45339,1561077
28416,randygeyer,1,0.00006,397348,25.45345,1561077
28417,ranebull,1,0.00006,397349,25.45352,1561077
28418,rangarb,1,0.00006,397350,25.45358,1561077
28419,Ranjit703,1,0.00006,397351,25.45365,1561077
28420,ranjujohn,1,0.00006,397352,25.45371,1561077
28421,ranma2913,1,0.00006,397353,25.45377,1561077
28422,ranman16,1,0.00006,397354,25.45384,1561077
28423,ranold,1,0.00006,397355,25.45390,1561077
28424,ranouf,1,0.00006,397356,25.45397,1561077
28425,ransom4real,1,0.00006,397357,25.45403,1561077
28426,raolivei,1,0.00006,397358,25.45409,1561077
28427,raphaelbadia,1,0.00006,397359,25.45416,1561077
28428,raphaelsoul,1,0.00006,397360,25.45422,1561077
28429,raphtheb,1,0.00006,397361,25.45429,1561077
28430,raqueldeniz,1,0.00006,397362,25.45435,1561077
28431,rarCI,1,0.00006,397363,25.45441,1561077
28432,rarecrumb,1,0.00006,397364,25.45448,1561077
28433,rares-suciu,1,0.00006,397365,25.45454,1561077
28434,rarspace01,1,0.00006,397366,25.45461,1561077
28435,rashforth,1,0.00006,397367,25.45467,1561077
28436,Rashmih,1,0.00006,397368,25.45473,1561077
28437,rashmi-praveen,1,0.00006,397369,25.45480,1561077
28438,rasjani,1,0.00006,397370,25.45486,1561077
28439,rasmusdencker,1,0.00006,397371,25.45493,1561077
28440,RasmusWernerLarsen,1,0.00006,397372,25.45499,1561077
28441,rasperepodvipodvert,1,0.00006,397373,25.45505,1561077
28442,ratemyduck,1,0.00006,397374,25.45512,1561077
28443,RathaKM,1,0.00006,397375,25.45518,1561077
28444,ratika-12,1,0.00006,397376,25.45525,1561077
28445,raulgd,1,0.00006,397377,25.45531,1561077
28446,raul-gherman,1,0.00006,397378,25.45537,1561077
28447,raul-gherman-idnow,1,0.00006,397379,25.45544,1561077
28448,rauniejha,1,0.00006,397380,25.45550,1561077
28449,rautdeepak55,1,0.00006,397381,25.45557,1561077
28450,ravbaba,1,0.00006,397382,25.45563,1561077
28451,raveathon,1,0.00006,397383,25.45570,1561077
28452,ravidevops3698,1,0.00006,397384,25.45576,1561077
28453,ravidpatel,1,0.00006,397385,25.45582,1561077
28454,ravigomez,1,0.00006,397386,25.45589,1561077
28455,ravikiranbukka,1,0.00006,397387,25.45595,1561077
28456,ravi-mosaicml,1,0.00006,397388,25.45602,1561077
28457,ravindra031,1,0.00006,397389,25.45608,1561077
28458,ravipatel01,1,0.00006,397390,25.45614,1561077
28459,ravi-ramaseshan,1,0.00006,397391,25.45621,1561077
28460,ravirsssrs,1,0.00006,397392,25.45627,1561077
28461,raviseal,1,0.00006,397393,25.45634,1561077
28462,rawadrifai,1,0.00006,397394,25.45640,1561077
28463,rawinng,1,0.00006,397395,25.45646,1561077
28464,ray65536,1,0.00006,397396,25.45653,1561077
28465,RayanMoarkech,1,0.00006,397397,25.45659,1561077
28466,raygolden,1,0.00006,397398,25.45666,1561077
28467,raykoch,1,0.00006,397399,25.45672,1561077
28468,raymond-wells,1,0.00006,397400,25.45678,1561077
28469,raynigon,1,0.00006,397401,25.45685,1561077
28470,Raytion,1,0.00006,397402,25.45691,1561077
28471,raywang945,1,0.00006,397403,25.45698,1561077
28472,RAZA-ABBBASI,1,0.00006,397404,25.45704,1561077
28473,razitz,1,0.00006,397405,25.45710,1561077
28474,razorsk8jz,1,0.00006,397406,25.45717,1561077
28475,rbaillsribatallada,1,0.00006,397407,25.45723,1561077
28476,rbedger,1,0.00006,397408,25.45730,1561077
28477,rbmh,1,0.00006,397409,25.45736,1561077
28478,rb-mwindh,1,0.00006,397410,25.45742,1561077
28479,rbnis,1,0.00006,397411,25.45749,1561077
28480,rbnswartz,1,0.00006,397412,25.45755,1561077
28481,rbradford,1,0.00006,397413,25.45762,1561077
28482,rbrockz,1,0.00006,397414,25.45768,1561077
28483,rburger,1,0.00006,397415,25.45774,1561077
28484,rcaballo,1,0.00006,397416,25.45781,1561077
28485,rchirosca-r7,1,0.00006,397417,25.45787,1561077
28486,rchui,1,0.00006,397418,25.45794,1561077
28487,rchytas,1,0.00006,397419,25.45800,1561077
28488,rcowsill,1,0.00006,397420,25.45807,1561077
28489,rcrocomb,1,0.00006,397421,25.45813,1561077
28490,rcsrao,1,0.00006,397422,25.45819,1561077
28491,rdepke,1,0.00006,397423,25.45826,1561077
28492,rdgreis,1,0.00006,397424,25.45832,1561077
28493,rdicroce,1,0.00006,397425,25.45839,1561077
28494,rdramana85,1,0.00006,397426,25.45845,1561077
28495,rds13,1,0.00006,397427,25.45851,1561077
28496,rdumi7ru,1,0.00006,397428,25.45858,1561077
28497,realdragon70,1,0.00006,397429,25.45864,1561077
28498,realtime-neil,1,0.00006,397430,25.45871,1561077
28499,rebolini-pablo,1,0.00006,397431,25.45877,1561077
28500,rechc,1,0.00006,397432,25.45883,1561077
28501,recurrence,1,0.00006,397433,25.45890,1561077
28502,reddawgt,1,0.00006,397434,25.45896,1561077
28503,reddwarf666,1,0.00006,397435,25.45903,1561077
28504,ReddyKilowatt,1,0.00006,397436,25.45909,1561077
28505,ReddytoRumble,1,0.00006,397437,25.45915,1561077
28506,reder9,1,0.00006,397438,25.45922,1561077
28507,redi-tjandr,1,0.00006,397439,25.45928,1561077
28508,RedouanIR,1,0.00006,397440,25.45935,1561077
28509,RedpointJenkins,1,0.00006,397441,25.45941,1561077
28510,redterror,1,0.00006,397442,25.45947,1561077
28511,ReeceCrossland,1,0.00006,397443,25.45954,1561077
28512,reedmurphy,1,0.00006,397444,25.45960,1561077
28513,reedox,1,0.00006,397445,25.45967,1561077
28514,RefRec97,1,0.00006,397446,25.45973,1561077
28515,Reghill,1,0.00006,397447,25.45979,1561077
28516,regius,1,0.00006,397448,25.45986,1561077
28517,regner,1,0.00006,397449,25.45992,1561077
28518,regrog,1,0.00006,397450,25.45999,1561077
28519,reid,1,0.00006,397451,25.46005,1561077
28520,ReignbowRoad,1,0.00006,397452,25.46012,1561077
28521,reinaldo-pinto,1,0.00006,397453,25.46018,1561077
28522,ReinierWKoops,1,0.00006,397454,25.46024,1561077
28523,reinout,1,0.00006,397455,25.46031,1561077
28524,reison007,1,0.00006,397456,25.46037,1561077
28525,reist,1,0.00006,397457,25.46044,1561077
28526,reitzig,1,0.00006,397458,25.46050,1561077
28527,rejunjie,1,0.00006,397459,25.46056,1561077
28528,RekhaSabbineni22,1,0.00006,397460,25.46063,1561077
28529,reki-cool,1,0.00006,397461,25.46069,1561077
28530,rektide,1,0.00006,397462,25.46076,1561077
28531,RelaRef,1,0.00006,397463,25.46082,1561077
28532,relax-admin,1,0.00006,397464,25.46088,1561077
28533,remcowesterhoud,1,0.00006,397465,25.46095,1561077
28534,remear,1,0.00006,397466,25.46101,1561077
28535,remeltucker,1,0.00006,397467,25.46108,1561077
28536,remi-gelinas,1,0.00006,397468,25.46114,1561077
28537,remmelt,1,0.00006,397469,25.46120,1561077
28538,Renanh,1,0.00006,397470,25.46127,1561077
28539,renatomariscal,1,0.00006,397471,25.46133,1561077
28540,RenderQwerty,1,0.00006,397472,25.46140,1561077
28541,rendion,1,0.00006,397473,25.46146,1561077
28542,renedv2980,1,0.00006,397474,25.46152,1561077
28543,renee2013,1,0.00006,397475,25.46159,1561077
28544,renu561,1,0.00006,397476,25.46165,1561077
28545,renukaholimath,1,0.00006,397477,25.46172,1561077
28546,renyidong,1,0.00006,397478,25.46178,1561077
28547,renyuan78,1,0.00006,397479,25.46184,1561077
28548,RenzHoly,1,0.00006,397480,25.46191,1561077
28549,renzors,1,0.00006,397481,25.46197,1561077
28550,RepublicMaster,1,0.00006,397482,25.46204,1561077
28551,requenym,1,0.00006,397483,25.46210,1561077
28552,reric,1,0.00006,397484,25.46216,1561077
28553,reschex,1,0.00006,397485,25.46223,1561077
28554,research-sudo,1,0.00006,397486,25.46229,1561077
28555,resmo,1,0.00006,397487,25.46236,1561077
28556,resnickdeepfield,1,0.00006,397488,25.46242,1561077
28557,resried,1,0.00006,397489,25.46249,1561077
28558,resrugam,1,0.00006,397490,25.46255,1561077
28559,Restage,1,0.00006,397491,25.46261,1561077
28560,restalion,1,0.00006,397492,25.46268,1561077
28561,rettink,1,0.00006,397493,25.46274,1561077
28562,reubenfirmin,1,0.00006,397494,25.46281,1561077
28563,rev112,1,0.00006,397495,25.46287,1561077
28564,reverendtimm,1,0.00006,397496,25.46293,1561077
28565,rewiredpictures,1,0.00006,397497,25.46300,1561077
28566,rexbut,1,0.00006,397498,25.46306,1561077
28567,rexim,1,0.00006,397499,25.46313,1561077
28568,rexminnis,1,0.00006,397500,25.46319,1561077
28569,ReyChavez,1,0.00006,397501,25.46325,1561077
28570,RezaRahmati,1,0.00006,397502,25.46332,1561077
28571,RezoChiang,1,0.00006,397503,25.46338,1561077
28572,Rfank2021,1,0.00006,397504,25.46345,1561077
28573,rfelgent,1,0.00006,397505,25.46351,1561077
28574,rfrerebe,1,0.00006,397506,25.46357,1561077
28575,rfrister,1,0.00006,397507,25.46364,1561077
28576,rg970197,1,0.00006,397508,25.46370,1561077
28577,rgala,1,0.00006,397509,25.46377,1561077
28578,rgarciape,1,0.00006,397510,25.46383,1561077
28579,rgdoliveira,1,0.00006,397511,25.46389,1561077
28580,rgevaert,1,0.00006,397512,25.46396,1561077
28581,rghunter,1,0.00006,397513,25.46402,1561077
28582,rginga,1,0.00006,397514,25.46409,1561077
28583,rgodishela,1,0.00006,397515,25.46415,1561077
28584,rgrizzell,1,0.00006,397516,25.46421,1561077
28585,rgroszewski,1,0.00006,397517,25.46428,1561077
28586,rgupta8888,1,0.00006,397518,25.46434,1561077
28587,rguruju,1,0.00006,397519,25.46441,1561077
28588,rhaludir,1,0.00006,397520,25.46447,1561077
28589,rhass-r7,1,0.00006,397521,25.46454,1561077
28590,rhatlapa,1,0.00006,397522,25.46460,1561077
28591,rhcammidge,1,0.00006,397523,25.46466,1561077
28592,rhd-gitops-functional,1,0.00006,397524,25.46473,1561077
28593,rhelms,1,0.00006,397525,25.46479,1561077
28594,rhertzog,1,0.00006,397526,25.46486,1561077
28595,rhierlmeier,1,0.00006,397527,25.46492,1561077
28596,rhinosaurus,1,0.00006,397528,25.46498,1561077
28597,rhipaasuser,1,0.00006,397529,25.46505,1561077
28598,rhlpandey1,1,0.00006,397530,25.46511,1561077
28599,rhodrid,1,0.00006,397531,25.46518,1561077
28600,rhollins,1,0.00006,397532,25.46524,1561077
28601,rhuanbarreto,1,0.00006,397533,25.46530,1561077
28602,rhuddleston,1,0.00006,397534,25.46537,1561077
28603,rhysmeister,1,0.00006,397535,25.46543,1561077
28604,RhysMorgan1986,1,0.00006,397536,25.46550,1561077
28605,RiaanLab,1,0.00006,397537,25.46556,1561077
28606,ricardo-aspira,1,0.00006,397538,25.46562,1561077
28607,ricardocosta21,1,0.00006,397539,25.46569,1561077
28608,ricardodestro,1,0.00006,397540,25.46575,1561077
28609,ricardoribas,1,0.00006,397541,25.46582,1561077
28610,ricardoseriani,1,0.00006,397542,25.46588,1561077
28611,ricedavida,1,0.00006,397543,25.46594,1561077
28612,richa-misra,1,0.00006,397544,25.46601,1561077
28613,richard-bt,1,0.00006,397545,25.46607,1561077
28614,richardhopkins,1,0.00006,397546,25.46614,1561077
28615,richardjm,1,0.00006,397547,25.46620,1561077
28616,richardkhardy,1,0.00006,397548,25.46626,1561077
28617,RichardKnowles,1,0.00006,397549,25.46633,1561077
28618,richardmarbach,1,0.00006,397550,25.46639,1561077
28619,RichardMills,1,0.00006,397551,25.46646,1561077
28620,richardwiden,1,0.00006,397552,25.46652,1561077
28621,richarth,1,0.00006,397553,25.46658,1561077
28622,richelliott,1,0.00006,397554,25.46665,1561077
28623,richhan,1,0.00006,397555,25.46671,1561077
28624,richjm,1,0.00006,397556,25.46678,1561077
28625,richleland,1,0.00006,397557,25.46684,1561077
28626,richmarshall68,1,0.00006,397558,25.46691,1561077
28627,ricka,1,0.00006,397559,25.46697,1561077
28628,RickeyWard,1,0.00006,397560,25.46703,1561077
28629,ricklambrechts,1,0.00006,397561,25.46710,1561077
28630,rickschubert,1,0.00006,397562,25.46716,1561077
28631,rickybobpat,1,0.00006,397563,25.46723,1561077
28632,rickynugraha,1,0.00006,397564,25.46729,1561077
28633,ricochet1k,1,0.00006,397565,25.46735,1561077
28634,ricointersys,1,0.00006,397566,25.46742,1561077
28635,ridaeh,1,0.00006,397567,25.46748,1561077
28636,riiiiizzzzzohmmmmm,1,0.00006,397568,25.46755,1561077
28637,rikameajay1,1,0.00006,397569,25.46761,1561077
28638,rikin-patel,1,0.00006,397570,25.46767,1561077
28639,RileyMills,1,0.00006,397571,25.46774,1561077
28640,rimonhanna,1,0.00006,397572,25.46780,1561077
28641,rimvislt,1,0.00006,397573,25.46787,1561077
28642,ringanta,1,0.00006,397574,25.46793,1561077
28643,rinu,1,0.00006,397575,25.46799,1561077
28644,rionazhang,1,0.00006,397576,25.46806,1561077
28645,rioseco23,1,0.00006,397577,25.46812,1561077
28646,riotsamc,1,0.00006,397578,25.46819,1561077
28647,rirl,1,0.00006,397579,25.46825,1561077
28648,rishabhjain05,1,0.00006,397580,25.46831,1561077
28649,RishabKumar,1,0.00006,397581,25.46838,1561077
28650,Rishi0405,1,0.00006,397582,25.46844,1561077
28651,rishichoudary,1,0.00006,397583,25.46851,1561077
28652,rishikeshr,1,0.00006,397584,25.46857,1561077
28653,rishustudent2001,1,0.00006,397585,25.46863,1561077
28654,RitushreePurkait96,1,0.00006,397586,25.46870,1561077
28655,ritzmann,1,0.00006,397587,25.46876,1561077
28656,river-fall,1,0.00006,397588,25.46883,1561077
28657,rivlinp,1,0.00006,397589,25.46889,1561077
28658,riwnodennyk,1,0.00006,397590,25.46896,1561077
28659,Rixten,1,0.00006,397591,25.46902,1561077
28660,riyuuli,1,0.00006,397592,25.46908,1561077
28661,rizi82,1,0.00006,397593,25.46915,1561077
28662,riznob,1,0.00006,397594,25.46921,1561077
28663,rizwan-ishtiaq,1,0.00006,397595,25.46928,1561077
28664,rjl126,1,0.00006,397596,25.46934,1561077
28665,rjonala,1,0.00006,397597,25.46940,1561077
28666,rjtferreira,1,0.00006,397598,25.46947,1561077
28667,rjw1,1,0.00006,397599,25.46953,1561077
28668,rkamisetti792,1,0.00006,397600,25.46960,1561077
28669,rkimmel-hv,1,0.00006,397601,25.46966,1561077
28670,rklak,1,0.00006,397602,25.46972,1561077
28671,rkovalenko,1,0.00006,397603,25.46979,1561077
28672,rkreddypandu,1,0.00006,397604,25.46985,1561077
28673,R-Lam,1,0.00006,397605,25.46992,1561077
28674,rlee-metrodigital,1,0.00006,397606,25.46998,1561077
28675,rlespinasse,1,0.00006,397607,25.47004,1561077
28676,rlfnb,1,0.00006,397608,25.47011,1561077
28677,rmalveis,1,0.00006,397609,25.47017,1561077
28678,rmasclef,1,0.00006,397610,25.47024,1561077
28679,rmie,1,0.00006,397611,25.47030,1561077
28680,rminchev1,1,0.00006,397612,25.47036,1561077
28681,rmkpatchaa,1,0.00006,397613,25.47043,1561077
28682,RMOHANEV,1,0.00006,397614,25.47049,1561077
28683,rmorasse415,1,0.00006,397615,25.47056,1561077
28684,rmshindhe,1,0.00006,397616,25.47062,1561077
28685,rmsys,1,0.00006,397617,25.47068,1561077
28686,rmuhic,1,0.00006,397618,25.47075,1561077
28687,rmusale,1,0.00006,397619,25.47081,1561077
28688,rneatherway,1,0.00006,397620,25.47088,1561077
28689,rnick,1,0.00006,397621,25.47094,1561077
28690,Roach,1,0.00006,397622,25.47100,1561077
28691,roacobb,1,0.00006,397623,25.47107,1561077
28692,rob68,1,0.00006,397624,25.47113,1561077
28693,roband7,1,0.00006,397625,25.47120,1561077
28694,robarros,1,0.00006,397626,25.47126,1561077
28695,RobAWilkinson,1,0.00006,397627,25.47133,1561077
28696,robbytimmermans,1,0.00006,397628,25.47139,1561077
28697,Robeatoz,1,0.00006,397629,25.47145,1561077
28698,robermar23,1,0.00006,397630,25.47152,1561077
28699,robertandrewbain,1,0.00006,397631,25.47158,1561077
28700,robertauer,1,0.00006,397632,25.47165,1561077
28701,robertbus,1,0.00006,397633,25.47171,1561077
28702,robertcepa,1,0.00006,397634,25.47177,1561077
28703,robertcowher,1,0.00006,397635,25.47184,1561077
28704,robertfalconer,1,0.00006,397636,25.47190,1561077
28705,roberthutto,1,0.00006,397637,25.47197,1561077
28706,RobertLask,1,0.00006,397638,25.47203,1561077
28707,robertnowell,1,0.00006,397639,25.47209,1561077
28708,robertoandrade,1,0.00006,397640,25.47216,1561077
28709,RobertoPegoraro,1,0.00006,397641,25.47222,1561077
28710,robertorodrig,1,0.00006,397642,25.47229,1561077
28711,robertsandoval,1,0.00006,397643,25.47235,1561077
28712,robertzakrocki,1,0.00006,397644,25.47241,1561077
28713,RobFl4,1,0.00006,397645,25.47248,1561077
28714,robfraz,1,0.00006,397646,25.47254,1561077
28715,RobGoretsky,1,0.00006,397647,25.47261,1561077
28716,robhunt3r,1,0.00006,397648,25.47267,1561077
28717,robinrob,1,0.00006,397649,25.47273,1561077
28718,robintanner,1,0.00006,397650,25.47280,1561077
28719,robinvalk,1,0.00006,397651,25.47286,1561077
28720,robjsch,1,0.00006,397652,25.47293,1561077
28721,robloxrob,1,0.00006,397653,25.47299,1561077
28722,robmchardy,1,0.00006,397654,25.47305,1561077
28723,robnester-rh,1,0.00006,397655,25.47312,1561077
28724,robodenitro,1,0.00006,397656,25.47318,1561077
28725,robotoMax,1,0.00006,397657,25.47325,1561077
28726,robotsquidward,1,0.00006,397658,25.47331,1561077
28727,robpickerill,1,0.00006,397659,25.47338,1561077
28728,robsykes24,1,0.00006,397660,25.47344,1561077
28729,robventers4,1,0.00006,397661,25.47350,1561077
28730,RobWaterhouse95,1,0.00006,397662,25.47357,1561077
28731,robythomas,1,0.00006,397663,25.47363,1561077
28732,roc1,1,0.00006,397664,25.47370,1561077
28733,rockdreamer,1,0.00006,397665,25.47376,1561077
28734,rockernaxo,1,0.00006,397666,25.47382,1561077
28735,rocketbitz,1,0.00006,397667,25.47389,1561077
28736,Rocketeer007,1,0.00006,397668,25.47395,1561077
28737,rocketeer125,1,0.00006,397669,25.47402,1561077
28738,rockingskier,1,0.00006,397670,25.47408,1561077
28739,rockjing,1,0.00006,397671,25.47414,1561077
28740,RockLobster,1,0.00006,397672,25.47421,1561077
28741,Rocks360,1,0.00006,397673,25.47427,1561077
28742,roded,1,0.00006,397674,25.47434,1561077
28743,roderickrandolph,1,0.00006,397675,25.47440,1561077
28744,rodneygp,1,0.00006,397676,25.47446,1561077
28745,rodrigmb,1,0.00006,397677,25.47453,1561077
28746,rodrigocprates,1,0.00006,397678,25.47459,1561077
28747,rodrigograudo,1,0.00006,397679,25.47466,1561077
28748,rodrigolopes,1,0.00006,397680,25.47472,1561077
28749,rodrigoreis22,1,0.00006,397681,25.47478,1561077
28750,rodrigorfk,1,0.00006,397682,25.47485,1561077
28751,roedler86,1,0.00006,397683,25.47491,1561077
28752,roegema,1,0.00006,397684,25.47498,1561077
28753,roelvdberg,1,0.00006,397685,25.47504,1561077
28754,roennow,1,0.00006,397686,25.47510,1561077
28755,rofl0r,1,0.00006,397687,25.47517,1561077
28756,rogan7n,1,0.00006,397688,25.47523,1561077
28757,rogerprz,1,0.00006,397689,25.47530,1561077
28758,RogersSauravGoyal,1,0.00006,397690,25.47536,1561077
28759,rogoman,1,0.00006,397691,25.47542,1561077
28760,Rogue-14,1,0.00006,397692,25.47549,1561077
28761,roguetech,1,0.00006,397693,25.47555,1561077
28762,rohangoli,1,0.00006,397694,25.47562,1561077
28763,rohanniveus,1,0.00006,397695,25.47568,1561077
28764,rohan-sharma-thbs,1,0.00006,397696,25.47575,1561077
28765,rohatgig,1,0.00006,397697,25.47581,1561077
28766,Rohit2013,1,0.00006,397698,25.47587,1561077
28767,rohit42412,1,0.00006,397699,25.47594,1561077
28768,rohit756,1,0.00006,397700,25.47600,1561077
28769,RohitGagan16,1,0.00006,397701,25.47607,1561077
28770,Rohith13,1,0.00006,397702,25.47613,1561077
28771,rohith2600,1,0.00006,397703,25.47619,1561077
28772,rohitjha,1,0.00006,397704,25.47626,1561077
28773,Rohmad999,1,0.00006,397705,25.47632,1561077
28774,RoiEXLab,1,0.00006,397706,25.47639,1561077
28775,RoiSec,1,0.00006,397707,25.47645,1561077
28776,rojomisin,1,0.00006,397708,25.47651,1561077
28777,rokie582,1,0.00006,397709,25.47658,1561077
28778,Rokko11,1,0.00006,397710,25.47664,1561077
28779,RokkuCode,1,0.00006,397711,25.47671,1561077
28780,Roland0511,1,0.00006,397712,25.47677,1561077
28781,roldevg,1,0.00006,397713,25.47683,1561077
28782,RoloSanchez,1,0.00006,397714,25.47690,1561077
28783,RolphH,1,0.00006,397715,25.47696,1561077
28784,RomainVernoux,1,0.00006,397716,25.47703,1561077
28785,RomanBalata,1,0.00006,397717,25.47709,1561077
28786,romanegorov1016,1,0.00006,397718,25.47715,1561077
28787,roman-grytsay,1,0.00006,397719,25.47722,1561077
28788,romangurevitch,1,0.00006,397720,25.47728,1561077
28789,RomanHiden,1,0.00006,397721,25.47735,1561077
28790,romankor,1,0.00006,397722,25.47741,1561077
28791,romankubu,1,0.00006,397723,25.47747,1561077
28792,romanolux,1,0.00006,397724,25.47754,1561077
28793,roman-ponomarenko,1,0.00006,397725,25.47760,1561077
28794,romary22,1,0.00006,397726,25.47767,1561077
28795,romixch,1,0.00006,397727,25.47773,1561077
28796,romp13,1,0.00006,397728,25.47780,1561077
28797,RonaHirsch,1,0.00006,397729,25.47786,1561077
28798,ronaldslc,1,0.00006,397730,25.47792,1561077
28799,ronanbarrett,1,0.00006,397731,25.47799,1561077
28800,ronanww,1,0.00006,397732,25.47805,1561077
28801,ron-gc,1,0.00006,397733,25.47812,1561077
28802,rongshen,1,0.00006,397734,25.47818,1561077
28803,ron-matsliah,1,0.00006,397735,25.47824,1561077
28804,ronnbcnews,1,0.00006,397736,25.47831,1561077
28805,ronnberg,1,0.00006,397737,25.47837,1561077
28806,ronny,1,0.00006,397738,25.47844,1561077
28807,ronronshaiko,1,0.00006,397739,25.47850,1561077
28808,ronsc,1,0.00006,397740,25.47856,1561077
28809,ronsmits,1,0.00006,397741,25.47863,1561077
28810,rooom13,1,0.00006,397742,25.47869,1561077
28811,Rooomchik,1,0.00006,397743,25.47876,1561077
28812,roopaax,1,0.00006,397744,25.47882,1561077
28813,roopesh90,1,0.00006,397745,25.47888,1561077
28814,RoopeshNair,1,0.00006,397746,25.47895,1561077
28815,root-expert,1,0.00006,397747,25.47901,1561077
28816,Roqche,1,0.00006,397748,25.47908,1561077
28817,roribio,1,0.00006,397749,25.47914,1561077
28818,rorybakerfmr,1,0.00006,397750,25.47920,1561077
28819,rorythorn,1,0.00006,397751,25.47927,1561077
28820,RosenTomov,1,0.00006,397752,25.47933,1561077
28821,roshan1992kr,1,0.00006,397753,25.47940,1561077
28822,roshannaik,1,0.00006,397754,25.47946,1561077
28823,ROSMCCANN,1,0.00006,397755,25.47952,1561077
28824,rosolko,1,0.00006,397756,25.47959,1561077
28825,RotemEmergi,1,0.00006,397757,25.47965,1561077
28826,rouge8,1,0.00006,397758,25.47972,1561077
28827,roxcarpio,1,0.00006,397759,25.47978,1561077
28828,royalsoulmates,1,0.00006,397760,25.47985,1561077
28829,roybaryosef-spotinst,1,0.00006,397761,25.47991,1561077
28830,roykachouh,1,0.00006,397762,25.47997,1561077
28831,roynielsen17,1,0.00006,397763,25.48004,1561077
28832,roy-van-de-korput,1,0.00006,397764,25.48010,1561077
28833,royw,1,0.00006,397765,25.48017,1561077
28834,rozyhead,1,0.00006,397766,25.48023,1561077
28835,rpannek,1,0.00006,397767,25.48029,1561077
28836,rparkhunovskyi,1,0.00006,397768,25.48036,1561077
28837,rpateloak9,1,0.00006,397769,25.48042,1561077
28838,rpelisse,1,0.00006,397770,25.48049,1561077
28839,rpherbig,1,0.00006,397771,25.48055,1561077
28840,rpherrera,1,0.00006,397772,25.48061,1561077
28841,rpiskule,1,0.00006,397773,25.48068,1561077
28842,rpjesivac,1,0.00006,397774,25.48074,1561077
28843,rplauche,1,0.00006,397775,25.48081,1561077
28844,rplevka,1,0.00006,397776,25.48087,1561077
28845,rpmconsulting,1,0.00006,397777,25.48093,1561077
28846,rpore,1,0.00006,397778,25.48100,1561077
28847,rprots,1,0.00006,397779,25.48106,1561077
28848,rpuncel,1,0.00006,397780,25.48113,1561077
28849,rranaoncehub,1,0.00006,397781,25.48119,1561077
28850,rraymundo,1,0.00006,397782,25.48125,1561077
28851,rrehbeindoi,1,0.00006,397783,25.48132,1561077
28852,rrodriguez-logn,1,0.00006,397784,25.48138,1561077
28853,rroques,1,0.00006,397785,25.48145,1561077
28854,rroxysam,1,0.00006,397786,25.48151,1561077
28855,rrroo,1,0.00006,397787,25.48157,1561077
28856,R-Rudolf,1,0.00006,397788,25.48164,1561077
28857,rrussell39,1,0.00006,397789,25.48170,1561077
28858,rsaba5612,1,0.00006,397790,25.48177,1561077
28859,rsawer,1,0.00006,397791,25.48183,1561077
28860,rsazor12,1,0.00006,397792,25.48189,1561077
28861,rschluecker,1,0.00006,397793,25.48196,1561077
28862,rschmied,1,0.00006,397794,25.48202,1561077
28863,rschupp,1,0.00006,397795,25.48209,1561077
28864,rseek,1,0.00006,397796,25.48215,1561077
28865,RSezonenko,1,0.00006,397797,25.48222,1561077
28866,rshah88,1,0.00006,397798,25.48228,1561077
28867,rshurts,1,0.00006,397799,25.48234,1561077
28868,rsilvareberth,1,0.00006,397800,25.48241,1561077
28869,rsmolgovsky-lendage,1,0.00006,397801,25.48247,1561077
28870,rstirling,1,0.00006,397802,25.48254,1561077
28871,rstriedl,1,0.00006,397803,25.48260,1561077
28872,rstutton,1,0.00006,397804,25.48266,1561077
28873,rtaft,1,0.00006,397805,25.48273,1561077
28874,rthuffman,1,0.00006,397806,25.48279,1561077
28875,rtimush,1,0.00006,397807,25.48286,1561077
28876,rtrauntvein,1,0.00006,397808,25.48292,1561077
28877,ruanbekker,1,0.00006,397809,25.48298,1561077
28878,rubao,1,0.00006,397810,25.48305,1561077
28879,rubashanti,1,0.00006,397811,25.48311,1561077
28880,rubberduck203,1,0.00006,397812,25.48318,1561077
28881,rubensyltek,1,0.00006,397813,25.48324,1561077
28882,ruchi15,1,0.00006,397814,25.48330,1561077
28883,ruchita-sheri,1,0.00006,397815,25.48337,1561077
28884,rudenoise,1,0.00006,397816,25.48343,1561077
28885,rudhra13,1,0.00006,397817,25.48350,1561077
28886,rudicba,1,0.00006,397818,25.48356,1561077
28887,rudionrails,1,0.00006,397819,25.48362,1561077
28888,rudub,1,0.00006,397820,25.48369,1561077
28889,rudyde,1,0.00006,397821,25.48375,1561077
28890,rudy-munkyfun,1,0.00006,397822,25.48382,1561077
28891,Rudy-Tmc,1,0.00006,397823,25.48388,1561077
28892,ruediste,1,0.00006,397824,25.48394,1561077
28893,rufatnadir,1,0.00006,397825,25.48401,1561077
28894,Rufics,1,0.00006,397826,25.48407,1561077
28895,rufik,1,0.00006,397827,25.48414,1561077
28896,ruhkopf,1,0.00006,397828,25.48420,1561077
28897,RuiSanches,1,0.00006,397829,25.48427,1561077
28898,rukhmem,1,0.00006,397830,25.48433,1561077
28899,RukkiesMan,1,0.00006,397831,25.48439,1561077
28900,ruler501,1,0.00006,397832,25.48446,1561077
28901,Rulqu,1,0.00006,397833,25.48452,1561077
28902,rumsik,1,0.00006,397834,25.48459,1561077
28903,rumstead,1,0.00006,397835,25.48465,1561077
28904,runningbird,1,0.00006,397836,25.48471,1561077
28905,rupakumar,1,0.00006,397837,25.48478,1561077
28906,rupipal,1,0.00006,397838,25.48484,1561077
28907,rupreck,1,0.00006,397839,25.48491,1561077
28908,rupsray,1,0.00006,397840,25.48497,1561077
28909,Ruruthia,1,0.00006,397841,25.48503,1561077
28910,rushimusmaximus,1,0.00006,397842,25.48510,1561077
28911,russell-johnston-fei,1,0.00006,397843,25.48516,1561077
28912,rustyhowell,1,0.00006,397844,25.48523,1561077
28913,rusty-jules,1,0.00006,397845,25.48529,1561077
28914,ruswerner,1,0.00006,397846,25.48535,1561077
28915,rutvik2611,1,0.00006,397847,25.48542,1561077
28916,rvabrilot,1,0.00006,397848,25.48548,1561077
28917,rvanoo,1,0.00006,397849,25.48555,1561077
28918,rvbmedeiros,1,0.00006,397850,25.48561,1561077
28919,rverma-ccs,1,0.00006,397851,25.48567,1561077
28920,RVoigtHearsay,1,0.00006,397852,25.48574,1561077
28921,rvollmar,1,0.00006,397853,25.48580,1561077
28922,rvpeters,1,0.00006,397854,25.48587,1561077
28923,rvtpro,1,0.00006,397855,25.48593,1561077
28924,rwalsh3711,1,0.00006,397856,25.48599,1561077
28925,rwegmann,1,0.00006,397857,25.48606,1561077
28926,rwilcox,1,0.00006,397858,25.48612,1561077
28927,rwincewicz,1,0.00006,397859,25.48619,1561077
28928,rwitzel,1,0.00006,397860,25.48625,1561077
28929,RWKoops,1,0.00006,397861,25.48631,1561077
28930,rwvandenberg,1,0.00006,397862,25.48638,1561077
28931,rwyss1,1,0.00006,397863,25.48644,1561077
28932,RyanAshley,1,0.00006,397864,25.48651,1561077
28933,ryanback,1,0.00006,397865,25.48657,1561077
28934,ryanbmilbourne,1,0.00006,397866,25.48664,1561077
28935,ryanc-unity,1,0.00006,397867,25.48670,1561077
28936,ryanfitzsimon,1,0.00006,397868,25.48676,1561077
28937,ryangood,1,0.00006,397869,25.48683,1561077
28938,ryangrey,1,0.00006,397870,25.48689,1561077
28939,ryanguest,1,0.00006,397871,25.48696,1561077
28940,ryan-gustafson,1,0.00006,397872,25.48702,1561077
28941,ryaninvents,1,0.00006,397873,25.48708,1561077
28942,ryanmoon,1,0.00006,397874,25.48715,1561077
28943,ryanseanp,1,0.00006,397875,25.48721,1561077
28944,ryan-stateless,1,0.00006,397876,25.48728,1561077
28945,ryantestplant,1,0.00006,397877,25.48734,1561077
28946,ryanwaite28,1,0.00006,397878,25.48740,1561077
28947,ryanwild,1,0.00006,397879,25.48747,1561077
28948,rychuhardy,1,0.00006,397880,25.48753,1561077
28949,rydrman,1,0.00006,397881,25.48760,1561077
28950,ryejoon,1,0.00006,397882,25.48766,1561077
28951,ryncsn,1,0.00006,397883,25.48772,1561077
28952,rynosoft,1,0.00006,397884,25.48779,1561077
28953,ryoga86,1,0.00006,397885,25.48785,1561077
28954,ryparker,1,0.00006,397886,25.48792,1561077
28955,ryron01,1,0.00006,397887,25.48798,1561077
28956,rysenko,1,0.00006,397888,25.48804,1561077
28957,rysuds,1,0.00006,397889,25.48811,1561077
28958,Ryukyo,1,0.00006,397890,25.48817,1561077
28959,rzanner,1,0.00006,397891,25.48824,1561077
28960,S0obi,1,0.00006,397892,25.48830,1561077
28961,s4huey2012,1,0.00006,397893,25.48836,1561077
28962,s4r4r,1,0.00006,397894,25.48843,1561077
28963,s4ros,1,0.00006,397895,25.48849,1561077
28964,s530665,1,0.00006,397896,25.48856,1561077
28965,sa02,1,0.00006,397897,25.48862,1561077
28966,saaadhu,1,0.00006,397898,25.48869,1561077
28967,saadgen,1,0.00006,397899,25.48875,1561077
28968,saadshahd,1,0.00006,397900,25.48881,1561077
28969,saahilbhutwala,1,0.00006,397901,25.48888,1561077
28970,saamorim,1,0.00006,397902,25.48894,1561077
28971,saardemri,1,0.00006,397903,25.48901,1561077
28972,SabirAliyev,1,0.00006,397904,25.48907,1561077
28973,sabjal,1,0.00006,397905,25.48913,1561077
28974,sabrinaluo,1,0.00006,397906,25.48920,1561077
28975,sacchettom,1,0.00006,397907,25.48926,1561077
28976,sachasmart,1,0.00006,397908,25.48933,1561077
28977,sach-edna,1,0.00006,397909,25.48939,1561077
28978,sachinmw,1,0.00006,397910,25.48945,1561077
28979,sachinphogat,1,0.00006,397911,25.48952,1561077
28980,sachinsonu,1,0.00006,397912,25.48958,1561077
28981,sachsenhofer,1,0.00006,397913,25.48965,1561077
28982,sacrebleu,1,0.00006,397914,25.48971,1561077
28983,sadaram144,1,0.00006,397915,25.48977,1561077
28984,sadityalal,1,0.00006,397916,25.48984,1561077
28985,sadjunky,1,0.00006,397917,25.48990,1561077
28986,sagarthorataress,1,0.00006,397918,25.48997,1561077
28987,sagaruttarkar,1,0.00006,397919,25.49003,1561077
28988,sagary2j,1,0.00006,397920,25.49009,1561077
28989,sagi053,1,0.00006,397921,25.49016,1561077
28990,sagnik-opsmx,1,0.00006,397922,25.49022,1561077
28991,sagron,1,0.00006,397923,25.49029,1561077
28992,sagyvm,1,0.00006,397924,25.49035,1561077
28993,sahilkak007,1,0.00006,397925,25.49041,1561077
28994,sahil-zymr,1,0.00006,397926,25.49048,1561077
28995,sai1431,1,0.00006,397927,25.49054,1561077
28996,saigyo,1,0.00006,397928,25.49061,1561077
28997,SaikatDEV,1,0.00006,397929,25.49067,1561077
28998,saikiranp80,1,0.00006,397930,25.49073,1561077
28999,saikrishna86,1,0.00006,397931,25.49080,1561077
29000,saikrishnapalakollu,1,0.00006,397932,25.49086,1561077
29001,Saikumar9959,1,0.00006,397933,25.49093,1561077
29002,sailajalingam,1,0.00006,397934,25.49099,1561077
29003,sailesh97,1,0.00006,397935,25.49106,1561077
29004,sailtwist,1,0.00006,397936,25.49112,1561077
29005,SainediAmbika,1,0.00006,397937,25.49118,1561077
29006,saiparty,1,0.00006,397938,25.49125,1561077
29007,saipava,1,0.00006,397939,25.49131,1561077
29008,sairageorge,1,0.00006,397940,25.49138,1561077
29009,sairajkishore,1,0.00006,397941,25.49144,1561077
29010,saisrinivaskondreddy,1,0.00006,397942,25.49150,1561077
29011,saisunil2303,1,0.00006,397943,25.49157,1561077
29012,saitotqr,1,0.00006,397944,25.49163,1561077
29013,sajalkherde,1,0.00006,397945,25.49170,1561077
29014,sajanep,1,0.00006,397946,25.49176,1561077
29015,sajidvit340,1,0.00006,397947,25.49182,1561077
29016,sajit,1,0.00006,397948,25.49189,1561077
29017,sakamotodesu,1,0.00006,397949,25.49195,1561077
29018,sakhi-arya,1,0.00006,397950,25.49202,1561077
29019,sakomws,1,0.00006,397951,25.49208,1561077
29020,sakshisood,1,0.00006,397952,25.49214,1561077
29021,salcatroppa,1,0.00006,397953,25.49221,1561077
29022,salemgolemugoo,1,0.00006,397954,25.49227,1561077
29023,SalKhan2015,1,0.00006,397955,25.49234,1561077
29024,sallyzhaohz,1,0.00006,397956,25.49240,1561077
29025,salslab,1,0.00006,397957,25.49246,1561077
29026,SaltedEggIndomee,1,0.00006,397958,25.49253,1561077
29027,salzig,1,0.00006,397959,25.49259,1561077
29028,Sam1414,1,0.00006,397960,25.49266,1561077
29029,sam808,1,0.00006,397961,25.49272,1561077
29030,samarthsaxena,1,0.00006,397962,25.49278,1561077
29031,sambapython,1,0.00006,397963,25.49285,1561077
29032,samdammers,1,0.00006,397964,25.49291,1561077
29033,SamDeBlock,1,0.00006,397965,25.49298,1561077
29034,sameek,1,0.00006,397966,25.49304,1561077
29035,sameeracherukuri,1,0.00006,397967,25.49311,1561077
29036,sameerb29,1,0.00006,397968,25.49317,1561077
29037,sameergn,1,0.00006,397969,25.49323,1561077
29038,sameer-shukur,1,0.00006,397970,25.49330,1561077
29039,samgomena,1,0.00006,397971,25.49336,1561077
29040,samhain1138,1,0.00006,397972,25.49343,1561077
29041,samhe,1,0.00006,397973,25.49349,1561077
29042,samifruit514,1,0.00006,397974,25.49355,1561077
29043,samirthebti,1,0.00006,397975,25.49362,1561077
29044,samississipi,1,0.00006,397976,25.49368,1561077
29045,Samistine,1,0.00006,397977,25.49375,1561077
29046,samitok,1,0.00006,397978,25.49381,1561077
29047,samjmarshall,1,0.00006,397979,25.49387,1561077
29048,sam-mckay,1,0.00006,397980,25.49394,1561077
29049,sammosov,1,0.00006,397981,25.49400,1561077
29050,Sam-Mumm,1,0.00006,397982,25.49407,1561077
29051,samoilenko,1,0.00006,397983,25.49413,1561077
29052,Sampath5581,1,0.00006,397984,25.49419,1561077
29053,samplenull,1,0.00006,397985,25.49426,1561077
29054,SamRaina,1,0.00006,397986,25.49432,1561077
29055,samrumold-oldfield-serato,1,0.00006,397987,25.49439,1561077
29056,Sam-SFO,1,0.00006,397988,25.49445,1561077
29057,samsharp99,1,0.00006,397989,25.49451,1561077
29058,samsonmaconi,1,0.00006,397990,25.49458,1561077
29059,sam-spain,1,0.00006,397991,25.49464,1561077
29060,samsun387,1,0.00006,397992,25.49471,1561077
29061,samucapuc,1,0.00006,397993,25.49477,1561077
29062,samuelbraley,1,0.00006,397994,25.49483,1561077
29063,samuellhombal,1,0.00006,397995,25.49490,1561077
29064,samuelmasuy,1,0.00006,397996,25.49496,1561077
29065,samuelnevesAC,1,0.00006,397997,25.49503,1561077
29066,SamuelNorbury,1,0.00006,397998,25.49509,1561077
29067,samuelportela,1,0.00006,397999,25.49515,1561077
29068,samuhepp,1,0.00006,398000,25.49522,1561077
29069,samyak-jn,1,0.00006,398001,25.49528,1561077
29070,sanasz91mdev,1,0.00006,398002,25.49535,1561077
29071,sancex,1,0.00006,398003,25.49541,1561077
29072,sanchit07,1,0.00006,398004,25.49548,1561077
29073,sandbox,1,0.00006,398005,25.49554,1561077
29074,SandeepGolla,1,0.00006,398006,25.49560,1561077
29075,sandeep-qantas,1,0.00006,398007,25.49567,1561077
29076,sandeep-rawat-xebia,1,0.00006,398008,25.49573,1561077
29077,SanderElsen,1,0.00006,398009,25.49580,1561077
29078,Sander-Hoogendoorn,1,0.00006,398010,25.49586,1561077
29079,SanderMachado,1,0.00006,398011,25.49592,1561077
29080,sanderwubs,1,0.00006,398012,25.49599,1561077
29081,sandipchatterjee540,1,0.00006,398013,25.49605,1561077
29082,sandro-felicioni,1,0.00006,398014,25.49612,1561077
29083,sandtrout-github,1,0.00006,398015,25.49618,1561077
29084,Sandu1213,1,0.00006,398016,25.49624,1561077
29085,sandyrayala,1,0.00006,398017,25.49631,1561077
29086,sandyzden,1,0.00006,398018,25.49637,1561077
29087,SangaviJayagopi,1,0.00006,398019,25.49644,1561077
29088,Sangeethavisa,1,0.00006,398020,25.49650,1561077
29089,sangimed,1,0.00006,398021,25.49656,1561077
29090,sanguis,1,0.00006,398022,25.49663,1561077
29091,sanhup,1,0.00006,398023,25.49669,1561077
29092,sanjaydhawangale,1,0.00006,398024,25.49676,1561077
29093,Sanjaykurra,1,0.00006,398025,25.49682,1561077
29094,sanjeev-lbg,1,0.00006,398026,25.49688,1561077
29095,sanjusss,1,0.00006,398027,25.49695,1561077
29096,sankar-natarajan,1,0.00006,398028,25.49701,1561077
29097,sanmat-nbs,1,0.00006,398029,25.49708,1561077
29098,sanpatnaik,1,0.00006,398030,25.49714,1561077
29099,sansanta,1,0.00006,398031,25.49720,1561077
29100,Sanskar95,1,0.00006,398032,25.49727,1561077
29101,sanstty27,1,0.00006,398033,25.49733,1561077
29102,santasub,1,0.00006,398034,25.49740,1561077
29103,santhoshksgit,1,0.00006,398035,25.49746,1561077
29104,santhosh-opsmx,1,0.00006,398036,25.49753,1561077
29105,santhoshpola-git,1,0.00006,398037,25.49759,1561077
29106,SanthoshRaju91,1,0.00006,398038,25.49765,1561077
29107,santiagocanti,1,0.00006,398039,25.49772,1561077
29108,santosh3702,1,0.00006,398040,25.49778,1561077
29109,santosh-v,1,0.00006,398041,25.49785,1561077
29110,santoshv98,1,0.00006,398042,25.49791,1561077
29111,sanyamaz,1,0.00006,398043,25.49797,1561077
29112,sanyer,1,0.00006,398044,25.49804,1561077
29113,sapdas1977,1,0.00006,398045,25.49810,1561077
29114,sapomh,1,0.00006,398046,25.49817,1561077
29115,saquibtmf,1,0.00006,398047,25.49823,1561077
29116,sarabeshravi,1,0.00006,398048,25.49829,1561077
29117,sarahBuisson,1,0.00006,398049,25.49836,1561077
29118,sarah-oakes,1,0.00006,398050,25.49842,1561077
29119,saraogivinay,1,0.00006,398051,25.49849,1561077
29120,saraswathicv,1,0.00006,398052,25.49855,1561077
29121,saravanan-devops,1,0.00006,398053,25.49861,1561077
29122,saravelm,1,0.00006,398054,25.49868,1561077
29123,saresh,1,0.00006,398055,25.49874,1561077
29124,sarkas52,1,0.00006,398056,25.49881,1561077
29125,sarmit-aliaswire,1,0.00006,398057,25.49887,1561077
29126,sarulatha333,1,0.00006,398058,25.49893,1561077
29127,sasha-bachurin,1,0.00006,398059,25.49900,1561077
29128,sashokbg,1,0.00006,398060,25.49906,1561077
29129,sasinda,1,0.00006,398061,25.49913,1561077
29130,sassda,1,0.00006,398062,25.49919,1561077
29131,Saswat93,1,0.00006,398063,25.49925,1561077
29132,satata-clgx,1,0.00006,398064,25.49932,1561077
29133,sathishkumar64,1,0.00006,398065,25.49938,1561077
29134,sathwiksharma,1,0.00006,398066,25.49945,1561077
29135,SathyaBhat,1,0.00006,398067,25.49951,1561077
29136,sathya-seruku2,1,0.00006,398068,25.49957,1561077
29137,satishj2ee,1,0.00006,398069,25.49964,1561077
29138,satishjs2297,1,0.00006,398070,25.49970,1561077
29139,SatishSympli,1,0.00006,398071,25.49977,1561077
29140,SATMAN778,1,0.00006,398072,25.49983,1561077
29141,satoshikumano,1,0.00006,398073,25.49990,1561077
29142,satya-alapati-einfochips,1,0.00006,398074,25.49996,1561077
29143,satyajitb007,1,0.00006,398075,25.50002,1561077
29144,satyamkapoor,1,0.00006,398076,25.50009,1561077
29145,Satyamkumarnavneet,1,0.00006,398077,25.50015,1561077
29146,satyanarayanareddytadi,1,0.00006,398078,25.50022,1561077
29147,saubhagya-gupta,1,0.00006,398079,25.50028,1561077
29148,saucyFellow760,1,0.00006,398080,25.50034,1561077
29149,saulbein,1,0.00006,398081,25.50041,1561077
29150,saurabh-agarwals,1,0.00006,398082,25.50047,1561077
29151,saurabh-sp-tripathi,1,0.00006,398083,25.50054,1561077
29152,saurav12345,1,0.00006,398084,25.50060,1561077
29153,saurav9878,1,0.00006,398085,25.50066,1561077
29154,sauravassuritynz,1,0.00006,398086,25.50073,1561077
29155,Savag3life,1,0.00006,398087,25.50079,1561077
29156,savinov,1,0.00006,398088,25.50086,1561077
29157,savishy,1,0.00006,398089,25.50092,1561077
29158,savoiringfaire,1,0.00006,398090,25.50098,1561077
29159,savon40,1,0.00006,398091,25.50105,1561077
29160,savornicesei,1,0.00006,398092,25.50111,1561077
29161,sawhneygunjan,1,0.00006,398093,25.50118,1561077
29162,sawyerwu,1,0.00006,398094,25.50124,1561077
29163,SaxenaAnushka102,1,0.00006,398095,25.50130,1561077
29164,sayom88,1,0.00006,398096,25.50137,1561077
29165,saz,1,0.00006,398097,25.50143,1561077
29166,sazzadNascenia,1,0.00006,398098,25.50150,1561077
29167,SB0-Lee,1,0.00006,398099,25.50156,1561077
29168,sb3lbx,1,0.00006,398100,25.50162,1561077
29169,sbadakhc,1,0.00006,398101,25.50169,1561077
29170,s-baier,1,0.00006,398102,25.50175,1561077
29171,sbaier1,1,0.00006,398103,25.50182,1561077
29172,sbamani,1,0.00006,398104,25.50188,1561077
29173,sbaxter,1,0.00006,398105,25.50195,1561077
29174,sbeckwithiii,1,0.00006,398106,25.50201,1561077
29175,sbenish,1,0.00006,398107,25.50207,1561077
29176,sberer,1,0.00006,398108,25.50214,1561077
29177,sb-ev,1,0.00006,398109,25.50220,1561077
29178,sbgertp,1,0.00006,398110,25.50227,1561077
29179,sbhr574,1,0.00006,398111,25.50233,1561077
29180,sbollap1,1,0.00006,398112,25.50239,1561077
29181,sbonasu,1,0.00006,398113,25.50246,1561077
29182,sboris-git,1,0.00006,398114,25.50252,1561077
29183,sbuisson,1,0.00006,398115,25.50259,1561077
29184,sbutalia,1,0.00006,398116,25.50265,1561077
29185,scapewang,1,0.00006,398117,25.50271,1561077
29186,scarolan,1,0.00006,398118,25.50278,1561077
29187,scheduler-lyz,1,0.00006,398119,25.50284,1561077
29188,schiasileon,1,0.00006,398120,25.50291,1561077
29189,schipiga,1,0.00006,398121,25.50297,1561077
29190,schitti2,1,0.00006,398122,25.50303,1561077
29191,schlachtzeuger,1,0.00006,398123,25.50310,1561077
29192,schlamar,1,0.00006,398124,25.50316,1561077
29193,schmichri,1,0.00006,398125,25.50323,1561077
29194,schmidtl25,1,0.00006,398126,25.50329,1561077
29195,schmidtp0740,1,0.00006,398127,25.50335,1561077
29196,schmitmd,1,0.00006,398128,25.50342,1561077
29197,schoripaz,1,0.00006,398129,25.50348,1561077
29198,schrepfler,1,0.00006,398130,25.50355,1561077
29199,sch-spinnaker,1,0.00006,398131,25.50361,1561077
29200,Schwaller,1,0.00006,398132,25.50367,1561077
29201,scic,1,0.00006,398133,25.50374,1561077
29202,ScienJus,1,0.00006,398134,25.50380,1561077
29203,scinfu,1,0.00006,398135,25.50387,1561077
29204,scirneanu,1,0.00006,398136,25.50393,1561077
29205,scizo,1,0.00006,398137,25.50399,1561077
29206,scm-admin-invn,1,0.00006,398138,25.50406,1561077
29207,scmgalaxy,1,0.00006,398139,25.50412,1561077
29208,scndel,1,0.00006,398140,25.50419,1561077
29209,scophotog,1,0.00006,398141,25.50425,1561077
29210,scornejob,1,0.00006,398142,25.50432,1561077
29211,scornelissen85,1,0.00006,398143,25.50438,1561077
29212,scorpion35,1,0.00006,398144,25.50444,1561077
29213,scott2449,1,0.00006,398145,25.50451,1561077
29214,scottanderson,1,0.00006,398146,25.50457,1561077
29215,scottcarey,1,0.00006,398147,25.50464,1561077
29216,scottdonaldau,1,0.00006,398148,25.50470,1561077
29217,scottgreenup,1,0.00006,398149,25.50476,1561077
29218,scottj97,1,0.00006,398150,25.50483,1561077
29219,scott-kausler,1,0.00006,398151,25.50489,1561077
29220,scott-kawaguchi,1,0.00006,398152,25.50496,1561077
29221,scottp-dpaw,1,0.00006,398153,25.50502,1561077
29222,scottschulthess,1,0.00006,398154,25.50508,1561077
29223,scott-sherwood,1,0.00006,398155,25.50515,1561077
29224,scottTomaszewski,1,0.00006,398156,25.50521,1561077
29225,scottylogan,1,0.00006,398157,25.50528,1561077
29226,scr,1,0.00006,398158,25.50534,1561077
29227,screamingskulls,1,0.00006,398159,25.50540,1561077
29228,screighton13,1,0.00006,398160,25.50547,1561077
29229,scrhall,1,0.00006,398161,25.50553,1561077
29230,scrichar,1,0.00006,398162,25.50560,1561077
29231,SDCFWM,1,0.00006,398163,25.50566,1561077
29232,SDedik,1,0.00006,398164,25.50572,1561077
29233,sdinakar85,1,0.00006,398165,25.50579,1561077
29234,sdinay,1,0.00006,398166,25.50585,1561077
29235,sdossoak9,1,0.00006,398167,25.50592,1561077
29236,sdyrotronc,1,0.00006,398168,25.50598,1561077
29237,se7enj,1,0.00006,398169,25.50604,1561077
29238,sea36,1,0.00006,398170,25.50611,1561077
29239,seam33,1,0.00006,398171,25.50617,1561077
29240,sean797,1,0.00006,398172,25.50624,1561077
29241,Sean89us,1,0.00006,398173,25.50630,1561077
29242,sean-brandt,1,0.00006,398174,25.50637,1561077
29243,seandtaber,1,0.00006,398175,25.50643,1561077
29244,SeanEire,1,0.00006,398176,25.50649,1561077
29245,SeanFarrow,1,0.00006,398177,25.50656,1561077
29246,seanleblanc,1,0.00006,398178,25.50662,1561077
29247,seansaleh,1,0.00006,398179,25.50669,1561077
29248,seanshankus,1,0.00006,398180,25.50675,1561077
29249,SeanStewart37,1,0.00006,398181,25.50681,1561077
29250,seansummers,1,0.00006,398182,25.50688,1561077
29251,seantalts,1,0.00006,398183,25.50694,1561077
29252,SeanZatRGA,1,0.00006,398184,25.50701,1561077
29253,seanzoucn,1,0.00006,398185,25.50707,1561077
29254,seattletechie,1,0.00006,398186,25.50713,1561077
29255,seawatts,1,0.00006,398187,25.50720,1561077
29256,Seb147,1,0.00006,398188,25.50726,1561077
29257,sebarre-talend,1,0.00006,398189,25.50733,1561077
29258,Sebas7ien,1,0.00006,398190,25.50739,1561077
29259,sebastiancadena,1,0.00006,398191,25.50745,1561077
29260,sebastiangl,1,0.00006,398192,25.50752,1561077
29261,sebastianhutter,1,0.00006,398193,25.50758,1561077
29262,SebastianVilstrup,1,0.00006,398194,25.50765,1561077
29263,sebastianzillessen,1,0.00006,398195,25.50771,1561077
29264,SebastienFlochlay,1,0.00006,398196,25.50777,1561077
29265,sebastien-helbert,1,0.00006,398197,25.50784,1561077
29266,sebawo,1,0.00006,398198,25.50790,1561077
29267,sebeichholz,1,0.00006,398199,25.50797,1561077
29268,sebge2emasphere,1,0.00006,398200,25.50803,1561077
29269,sebhmg,1,0.00006,398201,25.50809,1561077
29270,sebinbenjamin,1,0.00006,398202,25.50816,1561077
29271,sebkraemer,1,0.00006,398203,25.50822,1561077
29272,seboudry,1,0.00006,398204,25.50829,1561077
29273,seb-pax,1,0.00006,398205,25.50835,1561077
29274,secbug,1,0.00006,398206,25.50842,1561077
29275,SectorNine50,1,0.00006,398207,25.50848,1561077
29276,sedninja,1,0.00006,398208,25.50854,1561077
29277,Sedwick,1,0.00006,398209,25.50861,1561077
29278,seeker25,1,0.00006,398210,25.50867,1561077
29279,Seeron,1,0.00006,398211,25.50874,1561077
29280,seesemichaelj,1,0.00006,398212,25.50880,1561077
29281,seffparker,1,0.00006,398213,25.50886,1561077
29282,seflue,1,0.00006,398214,25.50893,1561077
29283,segabor,1,0.00006,398215,25.50899,1561077
29284,SE-Gaurav,1,0.00006,398216,25.50906,1561077
29285,segersb,1,0.00006,398217,25.50912,1561077
29286,segfault,1,0.00006,398218,25.50918,1561077
29287,SegFaultAX,1,0.00006,398219,25.50925,1561077
29288,Seitanas,1,0.00006,398220,25.50931,1561077
29289,seittema,1,0.00006,398221,25.50938,1561077
29290,Sekhar-Kumar-Dash,1,0.00006,398222,25.50944,1561077
29291,seleniumBatch2017,1,0.00006,398223,25.50950,1561077
29292,seligmanc,1,0.00006,398224,25.50957,1561077
29293,selininwonderland,1,0.00006,398225,25.50963,1561077
29294,selslack,1,0.00006,398226,25.50970,1561077
29295,selurvedu,1,0.00006,398227,25.50976,1561077
29296,seman,1,0.00006,398228,25.50982,1561077
29297,semedyspace,1,0.00006,398229,25.50989,1561077
29298,SemenovAlexander,1,0.00006,398230,25.50995,1561077
29299,SemmelJochen,1,0.00006,398231,25.51002,1561077
29300,semyonslepov,1,0.00006,398232,25.51008,1561077
29301,senditsai,1,0.00006,398233,25.51014,1561077
29302,senf-f,1,0.00006,398234,25.51021,1561077
29303,senthilnathanrajendran,1,0.00006,398235,25.51027,1561077
29304,sentimenti-it,1,0.00006,398236,25.51034,1561077
29305,Senza-Paura,1,0.00006,398237,25.51040,1561077
29306,seong-chang-ah,1,0.00006,398238,25.51046,1561077
29307,sepa-joe,1,0.00006,398239,25.51053,1561077
29308,sepehr-lorestani,1,0.00006,398240,25.51059,1561077
29309,seprokof,1,0.00006,398241,25.51066,1561077
29310,sepulrator,1,0.00006,398242,25.51072,1561077
29311,sequences-io,1,0.00006,398243,25.51079,1561077
29312,serdar-luminar,1,0.00006,398244,25.51085,1561077
29313,SeregaANT,1,0.00006,398245,25.51091,1561077
29314,SergeiSaraev,1,0.00006,398246,25.51098,1561077
29315,serges147,1,0.00006,398247,25.51104,1561077
29316,sergevs,1,0.00006,398248,25.51111,1561077
29317,SergeyDjam,1,0.00006,398249,25.51117,1561077
29318,sergeyklay,1,0.00006,398250,25.51123,1561077
29319,sergeykranga,1,0.00006,398251,25.51130,1561077
29320,sergeymatsak87,1,0.00006,398252,25.51136,1561077
29321,sergey-shuyskiy,1,0.00006,398253,25.51143,1561077
29322,SergeyUkraine,1,0.00006,398254,25.51149,1561077
29323,sergey-verevkin,1,0.00006,398255,25.51155,1561077
29324,sergeyzavadski,1,0.00006,398256,25.51162,1561077
29325,sergeyzenchenko,1,0.00006,398257,25.51168,1561077
29326,sergiik,1,0.00006,398258,25.51175,1561077
29327,Serginho,1,0.00006,398259,25.51181,1561077
29328,SergioBorgia,1,0.00006,398260,25.51187,1561077
29329,sergiofagostinho,1,0.00006,398261,25.51194,1561077
29330,Sergiy1987,1,0.00006,398262,25.51200,1561077
29331,SergiyBeno,1,0.00006,398263,25.51207,1561077
29332,SergiyMakarenko,1,0.00006,398264,25.51213,1561077
29333,serhiiKalchenko,1,0.00006,398265,25.51219,1561077
29334,serialskiller,1,0.00006,398266,25.51226,1561077
29335,Serjster,1,0.00006,398267,25.51232,1561077
29336,Seros,1,0.00006,398268,25.51239,1561077
29337,servo1x,1,0.00006,398269,25.51245,1561077
29338,sestary,1,0.00006,398270,25.51251,1561077
29339,setasan,1,0.00006,398271,25.51258,1561077
29340,seta-tuha,1,0.00006,398272,25.51264,1561077
29341,seterrychen,1,0.00006,398273,25.51271,1561077
29342,sethfloydjr,1,0.00006,398274,25.51277,1561077
29343,SeTSeR,1,0.00006,398275,25.51284,1561077
29344,SevakAvet,1,0.00006,398276,25.51290,1561077
29345,Sevelantis,1,0.00006,398277,25.51296,1561077
29346,seveneleven,1,0.00006,398278,25.51303,1561077
29347,sevikarakose,1,0.00006,398279,25.51309,1561077
29348,sevilS,1,0.00006,398280,25.51316,1561077
29349,seym45,1,0.00006,398281,25.51322,1561077
29350,seymen,1,0.00006,398282,25.51328,1561077
29351,sfarhin-riot,1,0.00006,398283,25.51335,1561077
29352,sfat,1,0.00006,398284,25.51341,1561077
29353,sfea,1,0.00006,398285,25.51348,1561077
29354,s-fedosov,1,0.00006,398286,25.51354,1561077
29355,sfenton7,1,0.00006,398287,25.51360,1561077
29356,SfietKonstantin,1,0.00006,398288,25.51367,1561077
29357,sfjava,1,0.00006,398289,25.51373,1561077
29358,sflint,1,0.00006,398290,25.51380,1561077
29359,sf-nh,1,0.00006,398291,25.51386,1561077
29360,sford,1,0.00006,398292,25.51392,1561077
29361,sfraga94,1,0.00006,398293,25.51399,1561077
29362,sfright,1,0.00006,398294,25.51405,1561077
29363,sf-riqbal,1,0.00006,398295,25.51412,1561077
29364,sfuser16,1,0.00006,398296,25.51418,1561077
29365,sgajjar,1,0.00006,398297,25.51424,1561077
29366,sgalaviz,1,0.00006,398298,25.51431,1561077
29367,sgargan,1,0.00006,398299,25.51437,1561077
29368,SGastons,1,0.00006,398300,25.51444,1561077
29369,sgilroy,1,0.00006,398301,25.51450,1561077
29370,sgnl19,1,0.00006,398302,25.51456,1561077
29371,sgrmgj-quotient,1,0.00006,398303,25.51463,1561077
29372,sgruby,1,0.00006,398304,25.51469,1561077
29373,sguedj,1,0.00006,398305,25.51476,1561077
29374,s-gusev,1,0.00006,398306,25.51482,1561077
29375,sgutermann,1,0.00006,398307,25.51488,1561077
29376,sgykfjsm,1,0.00006,398308,25.51495,1561077
29377,sh0ffmann,1,0.00006,398309,25.51501,1561077
29378,sh0rt2020,1,0.00006,398310,25.51508,1561077
29379,sh1mmer,1,0.00006,398311,25.51514,1561077
29380,shadoath,1,0.00006,398312,25.51521,1561077
29381,shadow1163,1,0.00006,398313,25.51527,1561077
29382,shadow999,1,0.00006,398314,25.51533,1561077
29383,ShadowNev,1,0.00006,398315,25.51540,1561077
29384,shaffi,1,0.00006,398316,25.51546,1561077
29385,shagr4th,1,0.00006,398317,25.51553,1561077
29386,shaharb-hs,1,0.00006,398318,25.51559,1561077
29387,Shaharf-satori,1,0.00006,398319,25.51565,1561077
29388,shahp00ja,1,0.00006,398320,25.51572,1561077
29389,shahzad-bhatti,1,0.00006,398321,25.51578,1561077
29390,shaiazulay,1,0.00006,398322,25.51585,1561077
29391,shaiguitar,1,0.00006,398323,25.51591,1561077
29392,shaijujanardhanan,1,0.00006,398324,25.51597,1561077
29393,shail0dm,1,0.00006,398325,25.51604,1561077
29394,shailesh-vaidya,1,0.00006,398326,25.51610,1561077
29395,shailleshtannu,1,0.00006,398327,25.51617,1561077
29396,Shail-Thacker-einfochips,1,0.00006,398328,25.51623,1561077
29397,ShailyAggarwalK,1,0.00006,398329,25.51629,1561077
29398,shailzachaudhry,1,0.00006,398330,25.51636,1561077
29399,shaji-bct,1,0.00006,398331,25.51642,1561077
29400,shakedlokits,1,0.00006,398332,25.51649,1561077
29401,shakenfr,1,0.00006,398333,25.51655,1561077
29402,ShaktiAhad,1,0.00006,398334,25.51661,1561077
29403,shaktiug,1,0.00006,398335,25.51668,1561077
29404,shalev123d,1,0.00006,398336,25.51674,1561077
29405,shalimreza13,1,0.00006,398337,25.51681,1561077
29406,shandowsoftware,1,0.00006,398338,25.51687,1561077
29407,shanedroid,1,0.00006,398339,25.51693,1561077
29408,shanekwheeler,1,0.00006,398340,25.51700,1561077
29409,shanemcd,1,0.00006,398341,25.51706,1561077
29410,shaneray,1,0.00006,398342,25.51713,1561077
29411,shanewarner,1,0.00006,398343,25.51719,1561077
29412,ShanHuang,1,0.00006,398344,25.51726,1561077
29413,shanidar,1,0.00006,398345,25.51732,1561077
29414,shankar4a1,1,0.00006,398346,25.51738,1561077
29415,shankarmravi,1,0.00006,398347,25.51745,1561077
29416,shankar-sundaram,1,0.00006,398348,25.51751,1561077
29417,ShanmugaSivapragasam,1,0.00006,398349,25.51758,1561077
29418,Shantanu10101,1,0.00006,398350,25.51764,1561077
29419,Shanthini2710,1,0.00006,398351,25.51770,1561077
29420,shao123,1,0.00006,398352,25.51777,1561077
29421,sharathgrao,1,0.00006,398353,25.51783,1561077
29422,sharathreddyreddy,1,0.00006,398354,25.51790,1561077
29423,shariqmus,1,0.00006,398355,25.51796,1561077
29424,sharkister,1,0.00006,398356,25.51802,1561077
29425,sharmaishan1729,1,0.00006,398357,25.51809,1561077
29426,sha-root,1,0.00006,398358,25.51815,1561077
29427,shartte,1,0.00006,398359,25.51822,1561077
29428,sharva-scio,1,0.00006,398360,25.51828,1561077
29429,shashank-k,1,0.00006,398361,25.51834,1561077
29430,shashidharp2020,1,0.00006,398362,25.51841,1561077
29431,shaunbugler,1,0.00006,398363,25.51847,1561077
29432,shawnwhit,1,0.00006,398364,25.51854,1561077
29433,ShayanSolid,1,0.00006,398365,25.51860,1561077
29434,shaybc,1,0.00006,398366,25.51866,1561077
29435,shayharush,1,0.00006,398367,25.51873,1561077
29436,shayoun,1,0.00006,398368,25.51879,1561077
29437,shazic,1,0.00006,398369,25.51886,1561077
29438,sh-ch,1,0.00006,398370,25.51892,1561077
29439,shdlee,1,0.00006,398371,25.51898,1561077
29440,SheffBRC,1,0.00006,398372,25.51905,1561077
29441,sheg,1,0.00006,398373,25.51911,1561077
29442,shehanmdev,1,0.00006,398374,25.51918,1561077
29443,sheldonhall,1,0.00006,398375,25.51924,1561077
29444,shelene31400,1,0.00006,398376,25.51930,1561077
29445,shellymangla,1,0.00006,398377,25.51937,1561077
29446,Shelna-GCP,1,0.00006,398378,25.51943,1561077
29447,shemlick,1,0.00006,398379,25.51950,1561077
29448,shenghuofei,1,0.00006,398380,25.51956,1561077
29449,shenliuyang,1,0.00006,398381,25.51963,1561077
29450,SheplX,1,0.00006,398382,25.51969,1561077
29451,sherlock1982,1,0.00006,398383,25.51975,1561077
29452,sheromon,1,0.00006,398384,25.51982,1561077
29453,shettyjm,1,0.00006,398385,25.51988,1561077
29454,shgattu,1,0.00006,398386,25.51995,1561077
29455,shiaohuihoh,1,0.00006,398387,25.52001,1561077
29456,shierro,1,0.00006,398388,25.52007,1561077
29457,shikloshi,1,0.00006,398389,25.52014,1561077
29458,shikofx,1,0.00006,398390,25.52020,1561077
29459,ShilpaBL,1,0.00006,398391,25.52027,1561077
29460,shimatai-mobees,1,0.00006,398392,25.52033,1561077
29461,shinjaechang,1,0.00006,398393,25.52039,1561077
29462,shinpou,1,0.00006,398394,25.52046,1561077
29463,shinusuresh,1,0.00006,398395,25.52052,1561077
29464,shinuza,1,0.00006,398396,25.52059,1561077
29465,shipit,1,0.00006,398397,25.52065,1561077
29466,shipperizer,1,0.00006,398398,25.52071,1561077
29467,shishirms,1,0.00006,398399,25.52078,1561077
29468,shiv-alana,1,0.00006,398400,25.52084,1561077
29469,shivamgupta211,1,0.00006,398401,25.52091,1561077
29470,shivan,1,0.00006,398402,25.52097,1561077
29471,shivanisrivastava30,1,0.00006,398403,25.52103,1561077
29472,shivasaxena,1,0.00006,398404,25.52110,1561077
29473,shivknight,1,0.00006,398405,25.52116,1561077
29474,Shivkumar13,1,0.00006,398406,25.52123,1561077
29475,shizhice,1,0.00006,398407,25.52129,1561077
29476,shlomibe,1,0.00006,398408,25.52135,1561077
29477,shmarsy,1,0.00006,398409,25.52142,1561077
29478,shmkrause,1,0.00006,398410,25.52148,1561077
29479,shneha,1,0.00006,398411,25.52155,1561077
29480,SHoar,1,0.00006,398412,25.52161,1561077
29481,shockrifleut,1,0.00006,398413,25.52168,1561077
29482,ShoJinto,1,0.00006,398414,25.52174,1561077
29483,sholsapp,1,0.00006,398415,25.52180,1561077
29484,shonfeder-da,1,0.00006,398416,25.52187,1561077
29485,shoogendoorn,1,0.00006,398417,25.52193,1561077
29486,showpony,1,0.00006,398418,25.52200,1561077
29487,shpsec-blaisep,1,0.00006,398419,25.52206,1561077
29488,shqear93,1,0.00006,398420,25.52212,1561077
29489,shreelola,1,0.00006,398421,25.52219,1561077
29490,shreyansp,1,0.00006,398422,25.52225,1561077
29491,shrnetomi,1,0.00006,398423,25.52232,1561077
29492,shrutiaggarwal3012,1,0.00006,398424,25.52238,1561077
29493,shrutika10,1,0.00006,398425,25.52244,1561077
29494,shrutisheoran,1,0.00006,398426,25.52251,1561077
29495,Shtutnik,1,0.00006,398427,25.52257,1561077
29496,shubham4delhivery,1,0.00006,398428,25.52264,1561077
29497,Shubhama-nd,1,0.00006,398429,25.52270,1561077
29498,shubhamgoel4aug,1,0.00006,398430,25.52276,1561077
29499,Shubham-Laddha,1,0.00006,398431,25.52283,1561077
29500,shubhampa,1,0.00006,398432,25.52289,1561077
29501,Shubham-Sakhuja-Bose,1,0.00006,398433,25.52296,1561077
29502,shubhamsre,1,0.00006,398434,25.52302,1561077
29503,shubhansha21,1,0.00006,398435,25.52308,1561077
29504,shubsaini09,1,0.00006,398436,25.52315,1561077
29505,shuchitatripathi,1,0.00006,398437,25.52321,1561077
29506,shuckc,1,0.00006,398438,25.52328,1561077
29507,ShukiPesso,1,0.00006,398439,25.52334,1561077
29508,shunsubramanian,1,0.00006,398440,25.52340,1561077
29509,Shurakshya,1,0.00006,398441,25.52347,1561077
29510,shureek,1,0.00006,398442,25.52353,1561077
29511,shuvo1016,1,0.00006,398443,25.52360,1561077
29512,shwangste,1,0.00006,398444,25.52366,1561077
29513,shwetali-123,1,0.00006,398445,25.52372,1561077
29514,ShwetaMagar,1,0.00006,398446,25.52379,1561077
29515,shyamshinde008,1,0.00006,398447,25.52385,1561077
29516,shyandsy,1,0.00006,398448,25.52392,1561077
29517,shyela,1,0.00006,398449,25.52398,1561077
29518,shynkevich-alex,1,0.00006,398450,25.52405,1561077
29519,shywei,1,0.00006,398451,25.52411,1561077
29520,siasia,1,0.00006,398452,25.52417,1561077
29521,Sicarri,1,0.00006,398453,25.52424,1561077
29522,sichao-uber,1,0.00006,398454,25.52430,1561077
29523,sicnervo,1,0.00006,398455,25.52437,1561077
29524,sicode,1,0.00006,398456,25.52443,1561077
29525,sic-z,1,0.00006,398457,25.52449,1561077
29526,siddhant-deepsource,1,0.00006,398458,25.52456,1561077
29527,siddhantika,1,0.00006,398459,25.52462,1561077
29528,siddheshmalpani,1,0.00006,398460,25.52469,1561077
29529,siddheshwar6622,1,0.00006,398461,25.52475,1561077
29530,siddhu208,1,0.00006,398462,25.52481,1561077
29531,siddjere,1,0.00006,398463,25.52488,1561077
29532,sideokyou-ucla,1,0.00006,398464,25.52494,1561077
29533,sidick,1,0.00006,398465,25.52501,1561077
29534,sidre9k,1,0.00006,398466,25.52507,1561077
29535,sidyhe,1,0.00006,398467,25.52513,1561077
29536,sielay,1,0.00006,398468,25.52520,1561077
29537,sig-crande,1,0.00006,398469,25.52526,1561077
29538,signed,1,0.00006,398470,25.52533,1561077
29539,sikos,1,0.00006,398471,25.52539,1561077
29540,silencev,1,0.00006,398472,25.52545,1561077
29541,SilentSib,1,0.00006,398473,25.52552,1561077
29542,SilentTiger,1,0.00006,398474,25.52558,1561077
29543,Sileymanedianka,1,0.00006,398475,25.52565,1561077
29544,silverdork,1,0.00006,398476,25.52571,1561077
29545,silverfort-eyal,1,0.00006,398477,25.52577,1561077
29546,silvester747,1,0.00006,398478,25.52584,1561077
29547,simbelmas,1,0.00006,398479,25.52590,1561077
29548,simeonlam,1,0.00006,398480,25.52597,1561077
29549,simholte,1,0.00006,398481,25.52603,1561077
29550,SimiFrancis,1,0.00006,398482,25.52610,1561077
29551,simisoz,1,0.00006,398483,25.52616,1561077
29552,simoarpe,1,0.00006,398484,25.52622,1561077
29553,simon-andrews,1,0.00006,398485,25.52629,1561077
29554,simoncadman,1,0.00006,398486,25.52635,1561077
29555,simoncowie,1,0.00006,398487,25.52642,1561077
29556,simonepigazzini,1,0.00006,398488,25.52648,1561077
29557,simonhaenisch,1,0.00006,398489,25.52654,1561077
29558,simon-harvey-msm,1,0.00006,398490,25.52661,1561077
29559,simonh-mmw,1,0.00006,398491,25.52667,1561077
29560,Simon-Ince,1,0.00006,398492,25.52674,1561077
29561,SimonPNorra,1,0.00006,398493,25.52680,1561077
29562,simon-said,1,0.00006,398494,25.52686,1561077
29563,SimonWillemsen,1,0.00006,398495,25.52693,1561077
29564,simpod6,1,0.00006,398496,25.52699,1561077
29565,simrobin,1,0.00006,398497,25.52706,1561077
29566,SimSloon,1,0.00006,398498,25.52712,1561077
29567,simtel12,1,0.00006,398499,25.52718,1561077
29568,sing011,1,0.00006,398500,25.52725,1561077
29569,singhajit89,1,0.00006,398501,25.52731,1561077
29570,singh-ashutosh1,1,0.00006,398502,25.52738,1561077
29571,singhmanpreet2,1,0.00006,398503,25.52744,1561077
29572,singjie,1,0.00006,398504,25.52750,1561077
29573,sinisterchipmunk,1,0.00006,398505,25.52757,1561077
29574,sinisterrook,1,0.00006,398506,25.52763,1561077
29575,sinn1,1,0.00006,398507,25.52770,1561077
29576,sionoc270779,1,0.00006,398508,25.52776,1561077
29577,sirajmansour,1,0.00006,398509,25.52782,1561077
29578,sirmax123,1,0.00006,398510,25.52789,1561077
29579,SirR4T,1,0.00006,398511,25.52795,1561077
29580,sisrael-dn,1,0.00006,398512,25.52802,1561077
29581,Sistach,1,0.00006,398513,25.52808,1561077
29582,sit,1,0.00006,398514,25.52814,1561077
29583,sithiksm,1,0.00006,398515,25.52821,1561077
29584,sitofabi,1,0.00006,398516,25.52827,1561077
29585,sitzko-sap,1,0.00006,398517,25.52834,1561077
29586,sivas053,1,0.00006,398518,25.52840,1561077
29587,SivaTharun,1,0.00006,398519,25.52847,1561077
29588,siwet,1,0.00006,398520,25.52853,1561077
29589,sixsix6,1,0.00006,398521,25.52859,1561077
29590,sixsixtrample,1,0.00006,398522,25.52866,1561077
29591,sixty4k,1,0.00006,398523,25.52872,1561077
29592,siyas13,1,0.00006,398524,25.52879,1561077
29593,sjaensch,1,0.00006,398525,25.52885,1561077
29594,sjhitchner,1,0.00006,398526,25.52891,1561077
29595,sjkummer,1,0.00006,398527,25.52898,1561077
29596,Sjnahak,1,0.00006,398528,25.52904,1561077
29597,sjoerdmulder,1,0.00006,398529,25.52911,1561077
29598,sk1talets,1,0.00006,398530,25.52917,1561077
29599,skaczmarczyk-cloudera,1,0.00006,398531,25.52923,1561077
29600,skaempfe,1,0.00006,398532,25.52930,1561077
29601,skalangi-clh,1,0.00006,398533,25.52936,1561077
29602,skarltjr,1,0.00006,398534,25.52943,1561077
29603,skasmai,1,0.00006,398535,25.52949,1561077
29604,skastel,1,0.00006,398536,25.52955,1561077
29605,sk-credify,1,0.00006,398537,25.52962,1561077
29606,skeeterx88,1,0.00006,398538,25.52968,1561077
29607,Skelv,1,0.00006,398539,25.52975,1561077
29608,Skerberus,1,0.00006,398540,25.52981,1561077
29609,skhedim,1,0.00006,398541,25.52987,1561077
29610,skholod,1,0.00006,398542,25.52994,1561077
29611,skiedrowski,1,0.00006,398543,25.53000,1561077
29612,skieras,1,0.00006,398544,25.53007,1561077
29613,skiingandhiking,1,0.00006,398545,25.53013,1561077
29614,skinnyjames,1,0.00006,398546,25.53019,1561077
29615,skjolber,1,0.00006,398547,25.53026,1561077
29616,sklirg,1,0.00006,398548,25.53032,1561077
29617,sklrsn,1,0.00006,398549,25.53039,1561077
29618,skmichaelson,1,0.00006,398550,25.53045,1561077
29619,skobarx,1,0.00006,398551,25.53052,1561077
29620,skolomiiets,1,0.00006,398552,25.53058,1561077
29621,Skosnowich,1,0.00006,398553,25.53064,1561077
29622,s-kotte,1,0.00006,398554,25.53071,1561077
29623,skruijt,1,0.00006,398555,25.53077,1561077
29624,skuppuswamy,1,0.00006,398556,25.53084,1561077
29625,skwp,1,0.00006,398557,25.53090,1561077
29626,skydavidshen,1,0.00006,398558,25.53096,1561077
29627,Skyebold,1,0.00006,398559,25.53103,1561077
29628,skylarmt,1,0.00006,398560,25.53109,1561077
29629,skyline-gleb,1,0.00006,398561,25.53116,1561077
29630,Skylsmoi,1,0.00006,398562,25.53122,1561077
29631,skymyyang,1,0.00006,398563,25.53128,1561077
29632,skyways,1,0.00006,398564,25.53135,1561077
29633,slackerbob,1,0.00006,398565,25.53141,1561077
29634,SlackOng95,1,0.00006,398566,25.53148,1561077
29635,sladkoff,1,0.00006,398567,25.53154,1561077
29636,slahlou-airbox,1,0.00006,398568,25.53160,1561077
29637,SlamaFR,1,0.00006,398569,25.53167,1561077
29638,slamont,1,0.00006,398570,25.53173,1561077
29639,slamp,1,0.00006,398571,25.53180,1561077
29640,slangdaddy,1,0.00006,398572,25.53186,1561077
29641,slashk,1,0.00006,398573,25.53192,1561077
29642,slaunay,1,0.00006,398574,25.53199,1561077
29643,slavag-altiscale,1,0.00006,398575,25.53205,1561077
29644,slavik57,1,0.00006,398576,25.53212,1561077
29645,slavyan85,1,0.00006,398577,25.53218,1561077
29646,slayer201,1,0.00006,398578,25.53224,1561077
29647,slee-a1,1,0.00006,398579,25.53231,1561077
29648,slempinen,1,0.00006,398580,25.53237,1561077
29649,slevchenko1,1,0.00006,398581,25.53244,1561077
29650,slewis74,1,0.00006,398582,25.53250,1561077
29651,slfotg,1,0.00006,398583,25.53257,1561077
29652,sliide-jay,1,0.00006,398584,25.53263,1561077
29653,SlipkHunter,1,0.00006,398585,25.53269,1561077
29654,slipy12,1,0.00006,398586,25.53276,1561077
29655,sliu2013,1,0.00006,398587,25.53282,1561077
29656,slopez-lmes,1,0.00006,398588,25.53289,1561077
29657,slsh,1,0.00006,398589,25.53295,1561077
29658,slukes,1,0.00006,398590,25.53301,1561077
29659,slum44,1,0.00006,398591,25.53308,1561077
29660,slyalin,1,0.00006,398592,25.53314,1561077
29661,smahakal,1,0.00006,398593,25.53321,1561077
29662,smahbod2014,1,0.00006,398594,25.53327,1561077
29663,smalik86,1,0.00006,398595,25.53333,1561077
29664,Smalkoy,1,0.00006,398596,25.53340,1561077
29665,SmallConcern,1,0.00006,398597,25.53346,1561077
29666,small-melon,1,0.00006,398598,25.53353,1561077
29667,smallmiro,1,0.00006,398599,25.53359,1561077
29668,smarlaku820,1,0.00006,398600,25.53365,1561077
29669,SmartassSkeleton,1,0.00006,398601,25.53372,1561077
29670,SmartHoneybee,1,0.00006,398602,25.53378,1561077
29671,smartime,1,0.00006,398603,25.53385,1561077
29672,smartlizzard,1,0.00006,398604,25.53391,1561077
29673,smartmeta,1,0.00006,398605,25.53397,1561077
29674,smashou,1,0.00006,398606,25.53404,1561077
29675,smccarthy-godaddy,1,0.00006,398607,25.53410,1561077
29676,smedefind,1,0.00006,398608,25.53417,1561077
29677,smekkley,1,0.00006,398609,25.53423,1561077
29678,smh,1,0.00006,398610,25.53429,1561077
29679,smily75,1,0.00006,398611,25.53436,1561077
29680,smiskiewicz1,1,0.00006,398612,25.53442,1561077
29681,smitaskamat,1,0.00006,398613,25.53449,1561077
29682,smithj4,1,0.00006,398614,25.53455,1561077
29683,Smit-tay,1,0.00006,398615,25.53461,1561077
29684,smmckay,1,0.00006,398616,25.53468,1561077
29685,smocanu,1,0.00006,398617,25.53474,1561077
29686,smohammed09,1,0.00006,398618,25.53481,1561077
29687,smokingroosters,1,0.00006,398619,25.53487,1561077
29688,SmokyNight,1,0.00006,398620,25.53494,1561077
29689,smolster,1,0.00006,398621,25.53500,1561077
29690,smoser-ibm,1,0.00006,398622,25.53506,1561077
29691,smpavlenko,1,0.00006,398623,25.53513,1561077
29692,sm-powell,1,0.00006,398624,25.53519,1561077
29693,smr99,1,0.00006,398625,25.53526,1561077
29694,smulikHakipod,1,0.00006,398626,25.53532,1561077
29695,smurfy1,1,0.00006,398627,25.53538,1561077
29696,snackycracky,1,0.00006,398628,25.53545,1561077
29697,snailzzj,1,0.00006,398629,25.53551,1561077
29698,snajo,1,0.00006,398630,25.53558,1561077
29699,SnazzyBootMan,1,0.00006,398631,25.53564,1561077
29700,SneakieGargamel,1,0.00006,398632,25.53570,1561077
29701,sneerin,1,0.00006,398633,25.53577,1561077
29702,snehil2112,1,0.00006,398634,25.53583,1561077
29703,Snergster,1,0.00006,398635,25.53590,1561077
29704,sniederb,1,0.00006,398636,25.53596,1561077
29705,snimark,1,0.00006,398637,25.53602,1561077
29706,sniperyen,1,0.00006,398638,25.53609,1561077
29707,sn-jason-newblanc,1,0.00006,398639,25.53615,1561077
29708,snk26,1,0.00006,398640,25.53622,1561077
29709,snmnr,1,0.00006,398641,25.53628,1561077
29710,snoop244,1,0.00006,398642,25.53634,1561077
29711,Snoopinator,1,0.00006,398643,25.53641,1561077
29712,snoozan,1,0.00006,398644,25.53647,1561077
29713,snorthov,1,0.00006,398645,25.53654,1561077
29714,SnowCait,1,0.00006,398646,25.53660,1561077
29715,snowe2010,1,0.00006,398647,25.53666,1561077
29716,snth-bhicks,1,0.00006,398648,25.53673,1561077
29717,snufalufagus,1,0.00006,398649,25.53679,1561077
29718,snuggie12,1,0.00006,398650,25.53686,1561077
29719,snycloud,1,0.00006,398651,25.53692,1561077
29720,soartseng,1,0.00006,398652,25.53699,1561077
29721,sobczyk,1,0.00006,398653,25.53705,1561077
29722,sobrique,1,0.00006,398654,25.53711,1561077
29723,socheat1994,1,0.00006,398655,25.53718,1561077
29724,socket70,1,0.00006,398656,25.53724,1561077
29725,sodajones,1,0.00006,398657,25.53731,1561077
29726,sodhia17,1,0.00006,398658,25.53737,1561077
29727,Sofi1410,1,0.00006,398659,25.53743,1561077
29728,softjake,1,0.00006,398660,25.53750,1561077
29729,softreigns,1,0.00006,398661,25.53756,1561077
29730,sofusalbertsen,1,0.00006,398662,25.53763,1561077
29731,sogajeffrey,1,0.00006,398663,25.53769,1561077
29732,sohanlon07,1,0.00006,398664,25.53775,1561077
29733,sohan-vidado,1,0.00006,398665,25.53782,1561077
29734,SokolovPavel,1,0.00006,398666,25.53788,1561077
29735,solacelost,1,0.00006,398667,25.53795,1561077
29736,solairerove,1,0.00006,398668,25.53801,1561077
29737,solaMai,1,0.00006,398669,25.53807,1561077
29738,solarsoft0,1,0.00006,398670,25.53814,1561077
29739,solderjs,1,0.00006,398671,25.53820,1561077
29740,solimant,1,0.00006,398672,25.53827,1561077
29741,soloitguy,1,0.00006,398673,25.53833,1561077
29742,solomongifford,1,0.00006,398674,25.53839,1561077
29743,solresol,1,0.00006,398675,25.53846,1561077
29744,somayajulas,1,0.00006,398676,25.53852,1561077
29745,SombatThomoh,1,0.00006,398677,25.53859,1561077
29746,somsingh-oath,1,0.00006,398678,25.53865,1561077
29747,somyagarg94,1,0.00006,398679,25.53871,1561077
29748,song-liang,1,0.00006,398680,25.53878,1561077
29749,soni-ankur,1,0.00006,398681,25.53884,1561077
29750,sonicfly,1,0.00006,398682,25.53891,1561077
29751,sonyali01,1,0.00006,398683,25.53897,1561077
29752,SonyViao,1,0.00006,398684,25.53903,1561077
29753,soodr,1,0.00006,398685,25.53910,1561077
29754,soofff,1,0.00006,398686,25.53916,1561077
29755,soondl,1,0.00006,398687,25.53923,1561077
29756,soondo21,1,0.00006,398688,25.53929,1561077
29757,SoOrAj247,1,0.00006,398689,25.53936,1561077
29758,soosgyul,1,0.00006,398690,25.53942,1561077
29759,sopeal,1,0.00006,398691,25.53948,1561077
29760,sopel,1,0.00006,398692,25.53955,1561077
29761,sophia-guo,1,0.00006,398693,25.53961,1561077
29762,sophoulis,1,0.00006,398694,25.53968,1561077
29763,sorenfriis,1,0.00006,398695,25.53974,1561077
29764,Sorion,1,0.00006,398696,25.53980,1561077
29765,sortidocop,1,0.00006,398697,25.53987,1561077
29766,soster,1,0.00006,398698,25.53993,1561077
29767,sostrich,1,0.00006,398699,25.54000,1561077
29768,sotayamashita,1,0.00006,398700,25.54006,1561077
29769,soul3510,1,0.00006,398701,25.54012,1561077
29770,soulechives,1,0.00006,398702,25.54019,1561077
29771,soulkyiro,1,0.00006,398703,25.54025,1561077
29772,soulus13,1,0.00006,398704,25.54032,1561077
29773,soumya-devops,1,0.00006,398705,25.54038,1561077
29774,soundstripe,1,0.00006,398706,25.54044,1561077
29775,souris4science,1,0.00006,398707,25.54051,1561077
29776,Soviut,1,0.00006,398708,25.54057,1561077
29777,SowkundiSuneel,1,0.00006,398709,25.54064,1561077
29778,soycapitan,1,0.00006,398710,25.54070,1561077
29779,SoyElJota,1,0.00006,398711,25.54076,1561077
29780,spacediver,1,0.00006,398712,25.54083,1561077
29781,Spacefish,1,0.00006,398713,25.54089,1561077
29782,spacemoose,1,0.00006,398714,25.54096,1561077
29783,spacev0yager,1,0.00006,398715,25.54102,1561077
29784,spacreau,1,0.00006,398716,25.54108,1561077
29785,spali,1,0.00006,398717,25.54115,1561077
29786,Spamme1,1,0.00006,398718,25.54121,1561077
29787,spandey280191,1,0.00006,398719,25.54128,1561077
29788,spanneberg,1,0.00006,398720,25.54134,1561077
29789,sparciii,1,0.00006,398721,25.54141,1561077
29790,spark-sse,1,0.00006,398722,25.54147,1561077
29791,sparkstar,1,0.00006,398723,25.54153,1561077
29792,Spartanflyer,1,0.00006,398724,25.54160,1561077
29793,sparty02,1,0.00006,398725,25.54166,1561077
29794,Spaum145,1,0.00006,398726,25.54173,1561077
29795,spavez,1,0.00006,398727,25.54179,1561077
29796,spazm,1,0.00006,398728,25.54185,1561077
29797,sp-click2cloud,1,0.00006,398729,25.54192,1561077
29798,speakmore,1,0.00006,398730,25.54198,1561077
29799,specinatti,1,0.00006,398731,25.54205,1561077
29800,Spedge,1,0.00006,398732,25.54211,1561077
29801,spencer-edh,1,0.00006,398733,25.54217,1561077
29802,spengilley,1,0.00006,398734,25.54224,1561077
29803,spetrov,1,0.00006,398735,25.54230,1561077
29804,spetrucev,1,0.00006,398736,25.54237,1561077
29805,spidaman,1,0.00006,398737,25.54243,1561077
29806,SpiderX,1,0.00006,398738,25.54249,1561077
29807,spijs,1,0.00006,398739,25.54256,1561077
29808,spikhterev,1,0.00006,398740,25.54262,1561077
29809,Spinkelben,1,0.00006,398741,25.54269,1561077
29810,spirylics,1,0.00006,398742,25.54275,1561077
29811,spjich,1,0.00006,398743,25.54281,1561077
29812,s-pk,1,0.00006,398744,25.54288,1561077
29813,spkrishnankutty,1,0.00006,398745,25.54294,1561077
29814,spluthlu,1,0.00006,398746,25.54301,1561077
29815,spmason,1,0.00006,398747,25.54307,1561077
29816,spolischook,1,0.00006,398748,25.54313,1561077
29817,spoon99,1,0.00006,398749,25.54320,1561077
29818,spotoczny,1,0.00006,398750,25.54326,1561077
29819,spredfast-tugboat,1,0.00006,398751,25.54333,1561077
29820,springasa,1,0.00006,398752,25.54339,1561077
29821,sprsquish,1,0.00006,398753,25.54345,1561077
29822,spullagura,1,0.00006,398754,25.54352,1561077
29823,spuniun,1,0.00006,398755,25.54358,1561077
29824,spwilson2,1,0.00006,398756,25.54365,1561077
29825,spyhunter99,1,0.00006,398757,25.54371,1561077
29826,spyken7,1,0.00006,398758,25.54378,1561077
29827,SpyroTEQ,1,0.00006,398759,25.54384,1561077
29828,sqa-consulting,1,0.00006,398760,25.54390,1561077
29829,SQLEmil,1,0.00006,398761,25.54397,1561077
29830,SQLExceptionPhil,1,0.00006,398762,25.54403,1561077
29831,sqmer,1,0.00006,398763,25.54410,1561077
29832,sqr,1,0.00006,398764,25.54416,1561077
29833,squallsiow,1,0.00006,398765,25.54422,1561077
29834,sra,1,0.00006,398766,25.54429,1561077
29835,sraghu1c,1,0.00006,398767,25.54435,1561077
29836,sraisl,1,0.00006,398768,25.54442,1561077
29837,sravanlakkimsetti,1,0.00006,398769,25.54448,1561077
29838,Sravan-yarlagadda,1,0.00006,398770,25.54454,1561077
29839,sravella-hub,1,0.00006,398771,25.54461,1561077
29840,sreedhap,1,0.00006,398772,25.54467,1561077
29841,sreejith421,1,0.00006,398773,25.54474,1561077
29842,sreekanthreddyggk,1,0.00006,398774,25.54480,1561077
29843,SreenivasReddy12,1,0.00006,398775,25.54486,1561077
29844,sreenuyedavalli,1,0.00006,398776,25.54493,1561077
29845,sreich,1,0.00006,398777,25.54499,1561077
29846,srethira,1,0.00006,398778,25.54506,1561077
29847,SreyemSOR,1,0.00006,398779,25.54512,1561077
29848,srf-pull-request-builder,1,0.00006,398780,25.54518,1561077
29849,SriGitHubSri,1,0.00006,398781,25.54525,1561077
29850,sriharim,1,0.00006,398782,25.54531,1561077
29851,srijanr,1,0.00006,398783,25.54538,1561077
29852,sri-ka1ki,1,0.00006,398784,25.54544,1561077
29853,srikanthareddy,1,0.00006,398785,25.54550,1561077
29854,srilakalways,1,0.00006,398786,25.54557,1561077
29855,SrimanPadmanabanReleaseiq,1,0.00006,398787,25.54563,1561077
29856,srinarayanant,1,0.00006,398788,25.54570,1561077
29857,srini1984,1,0.00006,398789,25.54576,1561077
29858,srini289,1,0.00006,398790,25.54583,1561077
29859,srinidhibs,1,0.00006,398791,25.54589,1561077
29860,srinidhis05,1,0.00006,398792,25.54595,1561077
29861,srinivas2501,1,0.00006,398793,25.54602,1561077
29862,srinivas9595,1,0.00006,398794,25.54608,1561077
29863,SrinivasaGoteti,1,0.00006,398795,25.54615,1561077
29864,SrinivasanTarget,1,0.00006,398796,25.54621,1561077
29865,srinivasareddyasha,1,0.00006,398797,25.54627,1561077
29866,srinivas-hub,1,0.00006,398798,25.54634,1561077
29867,srinivasraja54,1,0.00006,398799,25.54640,1561077
29868,sriram-mv,1,0.00006,398800,25.54647,1561077
29869,srirseshadri,1,0.00006,398801,25.54653,1561077
29870,srisrimani88,1,0.00006,398802,25.54659,1561077
29871,srlochen,1,0.00006,398803,25.54666,1561077
29872,SrLTF,1,0.00006,398804,25.54672,1561077
29873,srneer,1,0.00006,398805,25.54679,1561077
29874,SRombautsU,1,0.00006,398806,25.54685,1561077
29875,sross07,1,0.00006,398807,25.54691,1561077
29876,srotsch,1,0.00006,398808,25.54698,1561077
29877,srounce,1,0.00006,398809,25.54704,1561077
29878,srpago,1,0.00006,398810,25.54711,1561077
29879,srt-jflord,1,0.00006,398811,25.54717,1561077
29880,sruthicps,1,0.00006,398812,25.54723,1561077
29881,ss22219,1,0.00006,398813,25.54730,1561077
29882,ssahisnu,1,0.00006,398814,25.54736,1561077
29883,ssakizread,1,0.00006,398815,25.54743,1561077
29884,ssala7,1,0.00006,398816,25.54749,1561077
29885,sschakraborty,1,0.00006,398817,25.54755,1561077
29886,ssedrick,1,0.00006,398818,25.54762,1561077
29887,sshaghafi,1,0.00006,398819,25.54768,1561077
29888,ssharmaexp,1,0.00006,398820,25.54775,1561077
29889,sshorkey,1,0.00006,398821,25.54781,1561077
29890,ssj17vegeta,1,0.00006,398822,25.54787,1561077
29891,sskorol,1,0.00006,398823,25.54794,1561077
29892,sso679,1,0.00006,398824,25.54800,1561077
29893,ssp,1,0.00006,398825,25.54807,1561077
29894,ssreyah,1,0.00006,398826,25.54813,1561077
29895,ssskit,1,0.00006,398827,25.54820,1561077
29896,st0rmi,1,0.00006,398828,25.54826,1561077
29897,staastas,1,0.00006,398829,25.54832,1561077
29898,stabarinde,1,0.00006,398830,25.54839,1561077
29899,stacyodell,1,0.00006,398831,25.54845,1561077
29900,StailGot,1,0.00006,398832,25.54852,1561077
29901,stallapalli20,1,0.00006,398833,25.54858,1561077
29902,stang-tgs,1,0.00006,398834,25.54864,1561077
29903,stappersg,1,0.00006,398835,25.54871,1561077
29904,starchen,1,0.00006,398836,25.54877,1561077
29905,stardothosting,1,0.00006,398837,25.54884,1561077
29906,Starfight,1,0.00006,398838,25.54890,1561077
29907,starkca90,1,0.00006,398839,25.54896,1561077
29908,stark-eth,1,0.00006,398840,25.54903,1561077
29909,starlightknight,1,0.00006,398841,25.54909,1561077
29910,starrett67,1,0.00006,398842,25.54916,1561077
29911,starrlingo,1,0.00006,398843,25.54922,1561077
29912,starstuffharvestingstarlight,1,0.00006,398844,25.54928,1561077
29913,starwarsfan,1,0.00006,398845,25.54935,1561077
29914,stbuehler,1,0.00006,398846,25.54941,1561077
29915,ste26054,1,0.00006,398847,25.54948,1561077
29916,stebadge,1,0.00006,398848,25.54954,1561077
29917,steephart,1,0.00006,398849,25.54960,1561077
29918,stefanax,1,0.00006,398850,25.54967,1561077
29919,stefanboicu,1,0.00006,398851,25.54973,1561077
29920,stefanDeveloper,1,0.00006,398852,25.54980,1561077
29921,stefangr,1,0.00006,398853,25.54986,1561077
29922,stefanhoth,1,0.00006,398854,25.54992,1561077
29923,StefanIricinschi,1,0.00006,398855,25.54999,1561077
29924,StefanKoenen,1,0.00006,398856,25.55005,1561077
29925,stefankruijt,1,0.00006,398857,25.55012,1561077
29926,stefanmcshane,1,0.00006,398858,25.55018,1561077
29927,stefanocke,1,0.00006,398859,25.55025,1561077
29928,stefanos-kalantzis,1,0.00006,398860,25.55031,1561077
29929,stefanteixeira,1,0.00006,398861,25.55037,1561077
29930,stefanthurnherr,1,0.00006,398862,25.55044,1561077
29931,stefaro,1,0.00006,398863,25.55050,1561077
29932,steffenrumpf,1,0.00006,398864,25.55057,1561077
29933,steffenwald,1,0.00006,398865,25.55063,1561077
29934,SteggyLeggy,1,0.00006,398866,25.55069,1561077
29935,steinerthomas,1,0.00006,398867,25.55076,1561077
29936,stella-lyra,1,0.00006,398868,25.55082,1561077
29937,stepancar,1,0.00006,398869,25.55089,1561077
29938,stephanebouchard,1,0.00006,398870,25.55095,1561077
29939,StephaneG31,1,0.00006,398871,25.55101,1561077
29940,stephanheilner,1,0.00006,398872,25.55108,1561077
29941,stephanvalentan,1,0.00006,398873,25.55114,1561077
29942,stephanvd-thedelta,1,0.00006,398874,25.55121,1561077
29943,Stephanzf,1,0.00006,398875,25.55127,1561077
29944,stephenbyrne-mfj,1,0.00006,398876,25.55133,1561077
29945,stephenlavery,1,0.00006,398877,25.55140,1561077
29946,stephenlawrence,1,0.00006,398878,25.55146,1561077
29947,stephenlclarke,1,0.00006,398879,25.55153,1561077
29948,stephenmelrose,1,0.00006,398880,25.55159,1561077
29949,stephensh,1,0.00006,398881,25.55165,1561077
29950,stephenthornhill,1,0.00006,398882,25.55172,1561077
29951,stephenzr,1,0.00006,398883,25.55178,1561077
29952,steromano87,1,0.00006,398884,25.55185,1561077
29953,stesieber,1,0.00006,398885,25.55191,1561077
29954,steve-dwyer-itdev,1,0.00006,398886,25.55197,1561077
29955,stevefortier,1,0.00006,398887,25.55204,1561077
29956,stevegolton,1,0.00006,398888,25.55210,1561077
29957,stevehouel,1,0.00006,398889,25.55217,1561077
29958,stevejuma,1,0.00006,398890,25.55223,1561077
29959,SteveKennedy,1,0.00006,398891,25.55229,1561077
29960,SteveLas,1,0.00006,398892,25.55236,1561077
29961,SteveMoyer,1,0.00006,398893,25.55242,1561077
29962,stevenacalhoun,1,0.00006,398894,25.55249,1561077
29963,steven-collins-omega,1,0.00006,398895,25.55255,1561077
29964,StevenGiguere76,1,0.00006,398896,25.55262,1561077
29965,steve-norman-rft,1,0.00006,398897,25.55268,1561077
29966,steven-sortable,1,0.00006,398898,25.55274,1561077
29967,steven-vogogo,1,0.00006,398899,25.55281,1561077
29968,steve-stonehouse,1,0.00006,398900,25.55287,1561077
29969,steve-sumner,1,0.00006,398901,25.55294,1561077
29970,stevethe-sap,1,0.00006,398902,25.55300,1561077
29971,stevezxu,1,0.00006,398903,25.55306,1561077
29972,stewsnooze,1,0.00006,398904,25.55313,1561077
29973,stfl,1,0.00006,398905,25.55319,1561077
29974,sthaeling,1,0.00006,398906,25.55326,1561077
29975,sthuber90,1,0.00006,398907,25.55332,1561077
29976,stijnb1234,1,0.00006,398908,25.55338,1561077
29977,stijnvanbever,1,0.00006,398909,25.55345,1561077
29978,stijnvandrunen,1,0.00006,398910,25.55351,1561077
29979,stijnvn,1,0.00006,398911,25.55358,1561077
29980,StKob,1,0.00006,398912,25.55364,1561077
29981,stmontgomery,1,0.00006,398913,25.55370,1561077
29982,stocc,1,0.00006,398914,25.55377,1561077
29983,Stocksy-IT,1,0.00006,398915,25.55383,1561077
29984,stodmis,1,0.00006,398916,25.55390,1561077
29985,stokerd,1,0.00006,398917,25.55396,1561077
29986,Stokvisss,1,0.00006,398918,25.55402,1561077
29987,stolinzeev,1,0.00006,398919,25.55409,1561077
29988,Stonie,1,0.00006,398920,25.55415,1561077
29989,stop-cran,1,0.00006,398921,25.55422,1561077
29990,stormbeta,1,0.00006,398922,25.55428,1561077
29991,storpeyCHT,1,0.00006,398923,25.55434,1561077
29992,Stovoy,1,0.00006,398924,25.55441,1561077
29993,str3tch,1,0.00006,398925,25.55447,1561077
29994,str4d,1,0.00006,398926,25.55454,1561077
29995,Str8AWay,1,0.00006,398927,25.55460,1561077
29996,Strayer,1,0.00006,398928,25.55467,1561077
29997,strazh,1,0.00006,398929,25.55473,1561077
29998,stretch327,1,0.00006,398930,25.55479,1561077
29999,strich,1,0.00006,398931,25.55486,1561077
30000,strngr,1,0.00006,398932,25.55492,1561077
30001,strongholder,1,0.00006,398933,25.55499,1561077
30002,strpeter,1,0.00006,398934,25.55505,1561077
30003,stuart-c,1,0.00006,398935,25.55511,1561077
30004,stuartgrice,1,0.00006,398936,25.55518,1561077
30005,stuartgrieve,1,0.00006,398937,25.55524,1561077
30006,stuarthendren,1,0.00006,398938,25.55531,1561077
30007,stuarthu,1,0.00006,398939,25.55537,1561077
30008,stuaxo,1,0.00006,398940,25.55543,1561077
30009,stubrowncloudbees,1,0.00006,398941,25.55550,1561077
30010,student-06,1,0.00006,398942,25.55556,1561077
30011,stujb,1,0.00006,398943,25.55563,1561077
30012,StummeJ,1,0.00006,398944,25.55569,1561077
30013,st-unico,1,0.00006,398945,25.55575,1561077
30014,stupied4ever,1,0.00006,398946,25.55582,1561077
30015,sturfee-petrl,1,0.00006,398947,25.55588,1561077
30016,SuayipTekin,1,0.00006,398948,25.55595,1561077
30017,Subashgs95,1,0.00006,398949,25.55601,1561077
30018,subeeshes,1,0.00006,398950,25.55607,1561077
30019,subhammisra45,1,0.00006,398951,25.55614,1561077
30020,subhamproject,1,0.00006,398952,25.55620,1561077
30021,subhashchand,1,0.00006,398953,25.55627,1561077
30022,Subhist,1,0.00006,398954,25.55633,1561077
30023,Subilan,1,0.00006,398955,25.55639,1561077
30024,subir0071,1,0.00006,398956,25.55646,1561077
30025,subodhp,1,0.00006,398957,25.55652,1561077
30026,subodhraj,1,0.00006,398958,25.55659,1561077
30027,SubOptimal,1,0.00006,398959,25.55665,1561077
30028,Suchismita1tutun,1,0.00006,398960,25.55672,1561077
30029,suchitpuri,1,0.00006,398961,25.55678,1561077
30030,SUDARSHANCHAUDHARI,1,0.00006,398962,25.55684,1561077
30031,sudarshan-ctl,1,0.00006,398963,25.55691,1561077
30032,sudarshandk,1,0.00006,398964,25.55697,1561077
30033,SudarshanNarasimha,1,0.00006,398965,25.55704,1561077
30034,sudeepjana,1,0.00006,398966,25.55710,1561077
30035,sudha50,1,0.00006,398967,25.55716,1561077
30036,sudhanshusr,1,0.00006,398968,25.55723,1561077
30037,sudheerduba,1,0.00006,398969,25.55729,1561077
30038,sudhirdhankhar,1,0.00006,398970,25.55736,1561077
30039,sueastside,1,0.00006,398971,25.55742,1561077
30040,suhas1git,1,0.00006,398972,25.55748,1561077
30041,suhasln,1,0.00006,398973,25.55755,1561077
30042,suijlenm,1,0.00006,398974,25.55761,1561077
30043,Suil3File,1,0.00006,398975,25.55768,1561077
30044,sujit-kulkarni,1,0.00006,398976,25.55774,1561077
30045,sujumayas,1,0.00006,398977,25.55780,1561077
30046,sukhen75,1,0.00006,398978,25.55787,1561077
30047,Sukiyakijango,1,0.00006,398979,25.55793,1561077
30048,sulaweyo,1,0.00006,398980,25.55800,1561077
30049,sulaxchane,1,0.00006,398981,25.55806,1561077
30050,SullivanWls,1,0.00006,398982,25.55812,1561077
30051,sulx,1,0.00006,398983,25.55819,1561077
30052,SumanDas94,1,0.00006,398984,25.55825,1561077
30053,SumanthBurla,1,0.00006,398985,25.55832,1561077
30054,sumanthkatti,1,0.00006,398986,25.55838,1561077
30055,sumanthkumarc,1,0.00006,398987,25.55844,1561077
30056,sumeshkanayi,1,0.00006,398988,25.55851,1561077
30057,sumeshsudhakr,1,0.00006,398989,25.55857,1561077
30058,sumitdahatonde,1,0.00006,398990,25.55864,1561077
30059,sumitsharma16,1,0.00006,398991,25.55870,1561077
30060,sumodirjo,1,0.00006,398992,25.55876,1561077
30061,sun79Aj,1,0.00006,398993,25.55883,1561077
30062,sunbabyQ,1,0.00006,398994,25.55889,1561077
30063,sunbienhoa,1,0.00006,398995,25.55896,1561077
30064,suncodeer,1,0.00006,398996,25.55902,1561077
30065,Sunderfield,1,0.00006,398997,25.55909,1561077
30066,sunfaces,1,0.00006,398998,25.55915,1561077
30067,sungbine,1,0.00006,398999,25.55921,1561077
30068,SunHuawei,1,0.00006,399000,25.55928,1561077
30069,Sunil777,1,0.00006,399001,25.55934,1561077
30070,sunilbeheracet,1,0.00006,399002,25.55941,1561077
30071,sunilpandanl,1,0.00006,399003,25.55947,1561077
30072,sunliang77169,1,0.00006,399004,25.55953,1561077
30073,sunnycmf,1,0.00006,399005,25.55960,1561077
30074,SunnyYun,1,0.00006,399006,25.55966,1561077
30075,sunprophit,1,0.00006,399007,25.55973,1561077
30076,Sunrry,1,0.00006,399008,25.55979,1561077
30077,sunsear,1,0.00006,399009,25.55985,1561077
30078,sunvenka,1,0.00006,399010,25.55992,1561077
30079,Sup3rGeo,1,0.00006,399011,25.55998,1561077
30080,superbarne,1,0.00006,399012,25.56005,1561077
30081,superlama,1,0.00006,399013,25.56011,1561077
30082,Superluli,1,0.00006,399014,25.56017,1561077
30083,Supernomad,1,0.00006,399015,25.56024,1561077
30084,SuperSandro2000,1,0.00006,399016,25.56030,1561077
30085,supersonicclay,1,0.00006,399017,25.56037,1561077
30086,SuperSpectre,1,0.00006,399018,25.56043,1561077
30087,SupremeVab,1,0.00006,399019,25.56049,1561077
30088,Supun94,1,0.00006,399020,25.56056,1561077
30089,surajdevops18,1,0.00006,399021,25.56062,1561077
30090,surajm097,1,0.00006,399022,25.56069,1561077
30091,Suraj-Project,1,0.00006,399023,25.56075,1561077
30092,surajr,1,0.00006,399024,25.56081,1561077
30093,surajr3,1,0.00006,399025,25.56088,1561077
30094,Surajrvi,1,0.00006,399026,25.56094,1561077
30095,surcouf,1,0.00006,399027,25.56101,1561077
30096,surendar-rajasekaran,1,0.00006,399028,25.56107,1561077
30097,sureshchoudhary,1,0.00006,399029,25.56114,1561077
30098,sureshdevops99,1,0.00006,399030,25.56120,1561077
30099,sureshselvam01,1,0.00006,399031,25.56126,1561077
30100,surgat,1,0.00006,399032,25.56133,1561077
30101,suridge,1,0.00006,399033,25.56139,1561077
30102,surin77,1,0.00006,399034,25.56146,1561077
30103,surlyengineer,1,0.00006,399035,25.56152,1561077
30104,surry,1,0.00006,399036,25.56158,1561077
30105,Surya4DevOps,1,0.00006,399037,25.56165,1561077
30106,SuryaShailendra,1,0.00006,399038,25.56171,1561077
30107,suseendare,1,0.00006,399039,25.56178,1561077
30108,sushanco,1,0.00006,399040,25.56184,1561077
30109,sushan-ghimire,1,0.00006,399041,25.56190,1561077
30110,sushanth08,1,0.00006,399042,25.56197,1561077
30111,sushantk,1,0.00006,399043,25.56203,1561077
30112,Susheel5445,1,0.00006,399044,25.56210,1561077
30113,sushil10jadhav,1,0.00006,399045,25.56216,1561077
30114,sushilHpal,1,0.00006,399046,25.56222,1561077
30115,sushilman,1,0.00006,399047,25.56229,1561077
30116,Sushmavn,1,0.00006,399048,25.56235,1561077
30117,susmithagankidi,1,0.00006,399049,25.56242,1561077
30118,svachmic,1,0.00006,399050,25.56248,1561077
30119,svante66,1,0.00006,399051,25.56254,1561077
30120,svargasConnexta,1,0.00006,399052,25.56261,1561077
30121,svasylenkiv,1,0.00006,399053,25.56267,1561077
30122,svc-cloudops-bose,1,0.00006,399054,25.56274,1561077
30123,svdHero,1,0.00006,399055,25.56280,1561077
30124,svetlimladenov,1,0.00006,399056,25.56286,1561077
30125,svg7,1,0.00006,399057,25.56293,1561077
30126,svivekkrishna,1,0.00006,399058,25.56299,1561077
30127,svmundada,1,0.00006,399059,25.56306,1561077
30128,svnhubhub,1,0.00006,399060,25.56312,1561077
30129,svnlto,1,0.00006,399061,25.56318,1561077
30130,svparijs,1,0.00006,399062,25.56325,1561077
30131,svrc-pivotal,1,0.00006,399063,25.56331,1561077
30132,SVusal,1,0.00006,399064,25.56338,1561077
30133,SvyatoslavRazmyslov,1,0.00006,399065,25.56344,1561077
30134,sw,1,0.00006,399066,25.56351,1561077
30135,sw97272,1,0.00006,399067,25.56357,1561077
30136,swaggy,1,0.00006,399068,25.56363,1561077
30137,swain,1,0.00006,399069,25.56370,1561077
30138,swanandvg,1,0.00006,399070,25.56376,1561077
30139,swang304,1,0.00006,399071,25.56383,1561077
30140,swapnilbharshankar,1,0.00006,399072,25.56389,1561077
30141,swapnilnandane,1,0.00006,399073,25.56395,1561077
30142,swapnilsworld,1,0.00006,399074,25.56402,1561077
30143,swarajhub,1,0.00006,399075,25.56408,1561077
30144,swarkentin,1,0.00006,399076,25.56415,1561077
30145,swateek,1,0.00006,399077,25.56421,1561077
30146,SweeneyPro,1,0.00006,399078,25.56427,1561077
30147,sweeny-here,1,0.00006,399079,25.56434,1561077
30148,Sweetchuck,1,0.00006,399080,25.56440,1561077
30149,swensorm,1,0.00006,399081,25.56447,1561077
30150,swidbsk,1,0.00006,399082,25.56453,1561077
30151,swiip81,1,0.00006,399083,25.56459,1561077
30152,swills,1,0.00006,399084,25.56466,1561077
30153,SwirMix,1,0.00006,399085,25.56472,1561077
30154,swissgit,1,0.00006,399086,25.56479,1561077
30155,switchtrue,1,0.00006,399087,25.56485,1561077
30156,swnathan,1,0.00006,399088,25.56491,1561077
30157,swrap,1,0.00006,399089,25.56498,1561077
30158,sxamit,1,0.00006,399090,25.56504,1561077
30159,sxmichael,1,0.00006,399091,25.56511,1561077
30160,sxmon,1,0.00006,399092,25.56517,1561077
30161,sxsmg,1,0.00006,399093,25.56523,1561077
30162,sxt90128,1,0.00006,399094,25.56530,1561077
30163,sxxr,1,0.00006,399095,25.56536,1561077
30164,syahril920827,1,0.00006,399096,25.56543,1561077
30165,syck40,1,0.00006,399097,25.56549,1561077
30166,syedsfayaz,1,0.00006,399098,25.56556,1561077
30167,sylvain-combe-sonarsource,1,0.00006,399099,25.56562,1561077
30168,sylwek845,1,0.00006,399100,25.56568,1561077
30169,symlinx,1,0.00006,399101,25.56575,1561077
30170,sympathy2408,1,0.00006,399102,25.56581,1561077
30171,symphony-yanice,1,0.00006,399103,25.56588,1561077
30172,symus,1,0.00006,399104,25.56594,1561077
30173,syndicut,1,0.00006,399105,25.56600,1561077
30174,Synida,1,0.00006,399106,25.56607,1561077
30175,syoung108,1,0.00006,399107,25.56613,1561077
30176,syphernl,1,0.00006,399108,25.56620,1561077
30177,sysadm-dev,1,0.00006,399109,25.56626,1561077
30178,syslogic,1,0.00006,399110,25.56632,1561077
30179,system77771,1,0.00006,399111,25.56639,1561077
30180,Sytzeandreae,1,0.00006,399112,25.56645,1561077
30181,szakrewsky,1,0.00006,399113,25.56652,1561077
30182,szandany,1,0.00006,399114,25.56658,1561077
30183,szarlatan,1,0.00006,399115,25.56664,1561077
30184,szarya,1,0.00006,399116,25.56671,1561077
30185,szbjb,1,0.00006,399117,25.56677,1561077
30186,Szbuli,1,0.00006,399118,25.56684,1561077
30187,szczad,1,0.00006,399119,25.56690,1561077
30188,Szeraax,1,0.00006,399120,25.56696,1561077
30189,szgabsz91,1,0.00006,399121,25.56703,1561077
30190,szymon-owczarzak,1,0.00006,399122,25.56709,1561077
30191,t0klian,1,0.00006,399123,25.56716,1561077
30192,t0mdev,1,0.00006,399124,25.56722,1561077
30193,t5unamie,1,0.00006,399125,25.56728,1561077
30194,t794104,1,0.00006,399126,25.56735,1561077
30195,t851029,1,0.00006,399127,25.56741,1561077
30196,taa-autorola-com,1,0.00006,399128,25.56748,1561077
30197,tabeyti,1,0.00006,399129,25.56754,1561077
30198,tabrez067,1,0.00006,399130,25.56760,1561077
30199,TaceyWong,1,0.00006,399131,25.56767,1561077
30200,tacnoma,1,0.00006,399132,25.56773,1561077
30201,tacoben,1,0.00006,399133,25.56780,1561077
30202,tacumai,1,0.00006,399134,25.56786,1561077
30203,tadgh,1,0.00006,399135,25.56793,1561077
30204,tadrian88,1,0.00006,399136,25.56799,1561077
30205,Taffarel,1,0.00006,399137,25.56805,1561077
30206,TafThorne,1,0.00006,399138,25.56812,1561077
30207,Taha-Chaudhry,1,0.00006,399139,25.56818,1561077
30208,tahersb,1,0.00006,399140,25.56825,1561077
30209,Tahseen508,1,0.00006,399141,25.56831,1561077
30210,tajh,1,0.00006,399142,25.56837,1561077
30211,take-a27,1,0.00006,399143,25.56844,1561077
30212,taketwopayone,1,0.00006,399144,25.56850,1561077
30213,takomyr,1,0.00006,399145,25.56857,1561077
30214,TaliBerkovich,1,0.00006,399146,25.56863,1561077
30215,talife,1,0.00006,399147,25.56869,1561077
30216,talk2aanand,1,0.00006,399148,25.56876,1561077
30217,Talkerbox,1,0.00006,399149,25.56882,1561077
30218,talktopiyush,1,0.00006,399150,25.56889,1561077
30219,talktorana,1,0.00006,399151,25.56895,1561077
30220,Tallisado,1,0.00006,399152,25.56901,1561077
30221,talmarco,1,0.00006,399153,25.56908,1561077
30222,tamilselvanmp,1,0.00006,399154,25.56914,1561077
30223,tamir-allc,1,0.00006,399155,25.56921,1561077
30224,TamirHAhmed,1,0.00006,399156,25.56927,1561077
30225,Tammeny,1,0.00006,399157,25.56933,1561077
30226,tamvo94,1,0.00006,399158,25.56940,1561077
30227,Tanarri,1,0.00006,399159,25.56946,1561077
30228,tanderer,1,0.00006,399160,25.56953,1561077
30229,tanelitaipale,1,0.00006,399161,25.56959,1561077
30230,Tang8330,1,0.00006,399162,25.56965,1561077
30231,tangdu,1,0.00006,399163,25.56972,1561077
30232,tangguocai,1,0.00006,399164,25.56978,1561077
30233,Tangkc,1,0.00006,399165,25.56985,1561077
30234,tangtaoit,1,0.00006,399166,25.56991,1561077
30235,tanimientras,1,0.00006,399167,25.56998,1561077
30236,tankhuu,1,0.00006,399168,25.57004,1561077
30237,tankilo,1,0.00006,399169,25.57010,1561077
30238,tanmaybaranwal,1,0.00006,399170,25.57017,1561077
30239,tanne222,1,0.00006,399171,25.57023,1561077
30240,tannerjfco,1,0.00006,399172,25.57030,1561077
30241,tanpattaya,1,0.00006,399173,25.57036,1561077
30242,Tanushree1989,1,0.00006,399174,25.57042,1561077
30243,TaopaiC,1,0.00006,399175,25.57049,1561077
30244,TapanGujjar,1,0.00006,399176,25.57055,1561077
30245,tapanhalani,1,0.00006,399177,25.57062,1561077
30246,taptue-devopsenginner,1,0.00006,399178,25.57068,1561077
30247,taraoumx,1,0.00006,399179,25.57074,1561077
30248,TaraRegmi,1,0.00006,399180,25.57081,1561077
30249,taras-klym,1,0.00006,399181,25.57087,1561077
30250,tarasmytlovych,1,0.00006,399182,25.57094,1561077
30251,Tarasovych,1,0.00006,399183,25.57100,1561077
30252,tarcisioe,1,0.00006,399184,25.57106,1561077
30253,tarikdem,1,0.00006,399185,25.57113,1561077
30254,tarrall,1,0.00006,399186,25.57119,1561077
30255,tarunarora20,1,0.00006,399187,25.57126,1561077
30256,TASSDevon,1,0.00006,399188,25.57132,1561077
30257,tassioplima,1,0.00006,399189,25.57138,1561077
30258,tataraov,1,0.00006,399190,25.57145,1561077
30259,Tatev2000,1,0.00006,399191,25.57151,1561077
30260,Tau34RUS,1,0.00006,399192,25.57158,1561077
30261,taugerbeck,1,0.00006,399193,25.57164,1561077
30262,Tautvis,1,0.00006,399194,25.57170,1561077
30263,TAvardit,1,0.00006,399195,25.57177,1561077
30264,tavisca-amitesh,1,0.00006,399196,25.57183,1561077
30265,tavisca-divya,1,0.00006,399197,25.57190,1561077
30266,tavisca-himani,1,0.00006,399198,25.57196,1561077
30267,tavisca-IdrisW,1,0.00006,399199,25.57202,1561077
30268,tavisto,1,0.00006,399200,25.57209,1561077
30269,tavolodobela,1,0.00006,399201,25.57215,1561077
30270,taylorludwig,1,0.00006,399202,25.57222,1561077
30271,taymoor89,1,0.00006,399203,25.57228,1561077
30272,tbain98,1,0.00006,399204,25.57235,1561077
30273,tbartley,1,0.00006,399205,25.57241,1561077
30274,tbdasap,1,0.00006,399206,25.57247,1561077
30275,tbernacchi,1,0.00006,399207,25.57254,1561077
30276,tbickford,1,0.00006,399208,25.57260,1561077
30277,tbores,1,0.00006,399209,25.57267,1561077
30278,tbrady765,1,0.00006,399210,25.57273,1561077
30279,tbsandee,1,0.00006,399211,25.57279,1561077
30280,tbvl,1,0.00006,399212,25.57286,1561077
30281,tcappetto,1,0.00006,399213,25.57292,1561077
30282,tchemineau,1,0.00006,399214,25.57299,1561077
30283,tchernogod,1,0.00006,399215,25.57305,1561077
30284,tchiaspko,1,0.00006,399216,25.57311,1561077
30285,tclaudino,1,0.00006,399217,25.57318,1561077
30286,tcpgnl,1,0.00006,399218,25.57324,1561077
30287,TCPhelps,1,0.00006,399219,25.57331,1561077
30288,tcrusson,1,0.00006,399220,25.57337,1561077
30289,tculp,1,0.00006,399221,25.57343,1561077
30290,tdbgamer,1,0.00006,399222,25.57350,1561077
30291,tdesvenain,1,0.00006,399223,25.57356,1561077
30292,tdonia,1,0.00006,399224,25.57363,1561077
30293,tdsmith,1,0.00006,399225,25.57369,1561077
30294,tdtappe,1,0.00006,399226,25.57375,1561077
30295,team-church,1,0.00006,399227,25.57382,1561077
30296,teamdts,1,0.00006,399228,25.57388,1561077
30297,TeamSPoon,1,0.00006,399229,25.57395,1561077
30298,TeamTeaTime,1,0.00006,399230,25.57401,1561077
30299,Tebro,1,0.00006,399231,25.57407,1561077
30300,techarchconsulting,1,0.00006,399232,25.57414,1561077
30301,techmng,1,0.00006,399233,25.57420,1561077
30302,technologypilot,1,0.00006,399234,25.57427,1561077
30303,techqu,1,0.00006,399235,25.57433,1561077
30304,techs2resolve,1,0.00006,399236,25.57440,1561077
30305,TechTrainingCenter,1,0.00006,399237,25.57446,1561077
30306,techwav,1,0.00006,399238,25.57452,1561077
30307,Techwolf12,1,0.00006,399239,25.57459,1561077
30308,tecris,1,0.00006,399240,25.57465,1561077
30309,tedandrew,1,0.00006,399241,25.57472,1561077
30310,Tediferous,1,0.00006,399242,25.57478,1561077
30311,teja56789,1,0.00006,399243,25.57484,1561077
30312,tejaprakashchoudary,1,0.00006,399244,25.57491,1561077
30313,tejast06,1,0.00006,399245,25.57497,1561077
30314,Tejas-Valame,1,0.00006,399246,25.57504,1561077
30315,TejjeT,1,0.00006,399247,25.57510,1561077
30316,TekKanPassion,1,0.00006,399248,25.57516,1561077
30317,teliran,1,0.00006,399249,25.57523,1561077
30318,tellanad,1,0.00006,399250,25.57529,1561077
30319,teloniusz,1,0.00006,399251,25.57536,1561077
30320,temenosjdean,1,0.00006,399252,25.57542,1561077
30321,temidevops,1,0.00006,399253,25.57548,1561077
30322,TemoLomidze,1,0.00006,399254,25.57555,1561077
30323,tempelton27,1,0.00006,399255,25.57561,1561077
30324,temujin,1,0.00006,399256,25.57568,1561077
30325,tenable-buildeng,1,0.00006,399257,25.57574,1561077
30326,tengxunchao,1,0.00006,399258,25.57580,1561077
30327,Tenmak,1,0.00006,399259,25.57587,1561077
30328,tenpaiyomi,1,0.00006,399260,25.57593,1561077
30329,tenshipisu,1,0.00006,399261,25.57600,1561077
30330,TenSt,1,0.00006,399262,25.57606,1561077
30331,teohaik,1,0.00006,399263,25.57612,1561077
30332,teomanS,1,0.00006,399264,25.57619,1561077
30333,teosoft123,1,0.00006,399265,25.57625,1561077
30334,TeresaP,1,0.00006,399266,25.57632,1561077
30335,terminalv1,1,0.00006,399267,25.57638,1561077
30336,terrificdm,1,0.00006,399268,25.57644,1561077
30337,terryxychan,1,0.00006,399269,25.57651,1561077
30338,tesatt,1,0.00006,399270,25.57657,1561077
30339,teseo,1,0.00006,399271,25.57664,1561077
30340,test84magl,1,0.00006,399272,25.57670,1561077
30341,TestAutomation85,1,0.00006,399273,25.57677,1561077
30342,testj,1,0.00006,399274,25.57683,1561077
30343,Tethik,1,0.00006,399275,25.57689,1561077
30344,tevel,1,0.00006,399276,25.57696,1561077
30345,tewner,1,0.00006,399277,25.57702,1561077
30346,teyu0523,1,0.00006,399278,25.57709,1561077
30347,tfasunloadium,1,0.00006,399279,25.57715,1561077
30348,tfeitor,1,0.00006,399280,25.57721,1561077
30349,tfreiling989,1,0.00006,399281,25.57728,1561077
30350,TF-Simon,1,0.00006,399282,25.57734,1561077
30351,tgarc,1,0.00006,399283,25.57741,1561077
30352,tgassman,1,0.00006,399284,25.57747,1561077
30353,t-gebauer,1,0.00006,399285,25.57753,1561077
30354,tgecho,1,0.00006,399286,25.57760,1561077
30355,TGF-CM,1,0.00006,399287,25.57766,1561077
30356,tghastings,1,0.00006,399288,25.57773,1561077
30357,tglbn52,1,0.00006,399289,25.57779,1561077
30358,tgolden-andplus,1,0.00006,399290,25.57785,1561077
30359,tgr,1,0.00006,399291,25.57792,1561077
30360,tguedes,1,0.00006,399292,25.57798,1561077
30361,tgunarat,1,0.00006,399293,25.57805,1561077
30362,tgyurci,1,0.00006,399294,25.57811,1561077
30363,Th3R3p0,1,0.00006,399295,25.57817,1561077
30364,ThaKangBaby,1,0.00006,399296,25.57824,1561077
30365,thakkarsagar12,1,0.00006,399297,25.57830,1561077
30366,thalman,1,0.00006,399298,25.57837,1561077
30367,thangam105,1,0.00006,399299,25.57843,1561077
30368,thangarajbluescape,1,0.00006,399300,25.57849,1561077
30369,thanh3d,1,0.00006,399301,25.57856,1561077
30370,thara,1,0.00006,399302,25.57862,1561077
30371,thardtke-tt,1,0.00006,399303,25.57869,1561077
30372,ThatAIXGuy,1,0.00006,399304,25.57875,1561077
30373,ThatBulgarian,1,0.00006,399305,25.57882,1561077
30374,thatfulvioguy,1,0.00006,399306,25.57888,1561077
30375,thawkins83,1,0.00006,399307,25.57894,1561077
30376,thbowker,1,0.00006,399308,25.57901,1561077
30377,THD-Alex-Lowe,1,0.00006,399309,25.57907,1561077
30378,thdghgns,1,0.00006,399310,25.57914,1561077
30379,the3ver,1,0.00006,399311,25.57920,1561077
30380,the4yeast,1,0.00006,399312,25.57926,1561077
30381,thearthur,1,0.00006,399313,25.57933,1561077
30382,theautoroboto,1,0.00006,399314,25.57939,1561077
30383,theberbie,1,0.00006,399315,25.57946,1561077
30384,TheBlue-1,1,0.00006,399316,25.57952,1561077
30385,TheBrokenRail,1,0.00006,399317,25.57958,1561077
30386,thecraftman,1,0.00006,399318,25.57965,1561077
30387,TheCrockett,1,0.00006,399319,25.57971,1561077
30388,thedarkfalcon,1,0.00006,399320,25.57978,1561077
30389,TheDukeDK,1,0.00006,399321,25.57984,1561077
30390,TheeAndre,1,0.00006,399322,25.57990,1561077
30391,thefood,1,0.00006,399323,25.57997,1561077
30392,TheiLLeniumStudios,1,0.00006,399324,25.58003,1561077
30393,TheIndifferent,1,0.00006,399325,25.58010,1561077
30394,thejimnicholson,1,0.00006,399326,25.58016,1561077
30395,THEjoezack,1,0.00006,399327,25.58022,1561077
30396,thekbb,1,0.00006,399328,25.58029,1561077
30397,Theldris,1,0.00006,399329,25.58035,1561077
30398,thelunch,1,0.00006,399330,25.58042,1561077
30399,TheMagician1,1,0.00006,399331,25.58048,1561077
30400,themalkolm,1,0.00006,399332,25.58054,1561077
30401,TheMatthew,1,0.00006,399333,25.58061,1561077
30402,TheMightyCleft,1,0.00006,399334,25.58067,1561077
30403,TheMint,1,0.00006,399335,25.58074,1561077
30404,thenom,1,0.00006,399336,25.58080,1561077
30405,the-nose-knows,1,0.00006,399337,25.58087,1561077
30406,thenozzl3,1,0.00006,399338,25.58093,1561077
30407,Theo13111,1,0.00006,399339,25.58099,1561077
30408,theomega,1,0.00006,399340,25.58106,1561077
30409,theory,1,0.00006,399341,25.58112,1561077
30410,theotherwhitemeat,1,0.00006,399342,25.58119,1561077
30411,thePhilGuy,1,0.00006,399343,25.58125,1561077
30412,therapy-lf,1,0.00006,399344,25.58131,1561077
30413,therealBennoooo,1,0.00006,399345,25.58138,1561077
30414,Therealmccoy25,1,0.00006,399346,25.58144,1561077
30415,Theresa29,1,0.00006,399347,25.58151,1561077
30416,theriauf,1,0.00006,399348,25.58157,1561077
30417,TheSAS,1,0.00006,399349,25.58163,1561077
30418,the-sea,1,0.00006,399350,25.58170,1561077
30419,theshoals,1,0.00006,399351,25.58176,1561077
30420,the-sibyl,1,0.00006,399352,25.58183,1561077
30421,theSkydiver,1,0.00006,399353,25.58189,1561077
30422,TheSp1der,1,0.00006,399354,25.58195,1561077
30423,TheStormN,1,0.00006,399355,25.58202,1561077
30424,TheTekton,1,0.00006,399356,25.58208,1561077
30425,thetis15,1,0.00006,399357,25.58215,1561077
30426,thetusharr,1,0.00006,399358,25.58221,1561077
30427,TheUltimateDeployer,1,0.00006,399359,25.58227,1561077
30428,theundertakerjr666,1,0.00006,399360,25.58234,1561077
30429,theuring,1,0.00006,399361,25.58240,1561077
30430,TheWallOfDucks,1,0.00006,399362,25.58247,1561077
30431,theWizK,1,0.00006,399363,25.58253,1561077
30432,thexahmed00,1,0.00006,399364,25.58259,1561077
30433,theyoz,1,0.00006,399365,25.58266,1561077
30434,the-zucc,1,0.00006,399366,25.58272,1561077
30435,thiagoinhesta,1,0.00006,399367,25.58279,1561077
30436,thiagoit,1,0.00006,399368,25.58285,1561077
30437,thiagomartos,1,0.00006,399369,25.58291,1561077
30438,thienhuynh88,1,0.00006,399370,25.58298,1561077
30439,thierryd,1,0.00006,399371,25.58304,1561077
30440,Thieum,1,0.00006,399372,25.58311,1561077
30441,ThijsPerk,1,0.00006,399373,25.58317,1561077
30442,thijsvanloef,1,0.00006,399374,25.58324,1561077
30443,ThilinaManamgoda,1,0.00006,399375,25.58330,1561077
30444,thimmy687,1,0.00006,399376,25.58336,1561077
30445,thinhlx1993,1,0.00006,399377,25.58343,1561077
30446,thinkjk,1,0.00006,399378,25.58349,1561077
30447,thirsch,1,0.00006,399379,25.58356,1561077
30448,ThirteenThirtySeven,1,0.00006,399380,25.58362,1561077
30449,thirupathib12,1,0.00006,399381,25.58368,1561077
30450,ThisGuenter,1,0.00006,399382,25.58375,1561077
30451,ThisGuyCodes,1,0.00006,399383,25.58381,1561077
30452,thisisatestuseraccount,1,0.00006,399384,25.58388,1561077
30453,Thitho007,1,0.00006,399385,25.58394,1561077
30454,ThiwankaProdoscore,1,0.00006,399386,25.58400,1561077
30455,thiyagaraj,1,0.00006,399387,25.58407,1561077
30456,thkim256,1,0.00006,399388,25.58413,1561077
30457,thokuest,1,0.00006,399389,25.58420,1561077
30458,tholewebgods,1,0.00006,399390,25.58426,1561077
30459,thomasbergmann,1,0.00006,399391,25.58432,1561077
30460,ThomasBrodtPorabo,1,0.00006,399392,25.58439,1561077
30461,thomas-brx,1,0.00006,399393,25.58445,1561077
30462,thomasburst,1,0.00006,399394,25.58452,1561077
30463,thomasDussossoy,1,0.00006,399395,25.58458,1561077
30464,thomasgo,1,0.00006,399396,25.58464,1561077
30465,ThomasKasene,1,0.00006,399397,25.58471,1561077
30466,thomaskoren,1,0.00006,399398,25.58477,1561077
30467,thomasmay,1,0.00006,399399,25.58484,1561077
30468,ThomasOSI,1,0.00006,399400,25.58490,1561077
30469,ThomasOwens,1,0.00006,399401,25.58496,1561077
30470,thomas-schmid-ubnt,1,0.00006,399402,25.58503,1561077
30471,ThomasThiemann,1,0.00006,399403,25.58509,1561077
30472,ThomasWunderlich,1,0.00006,399404,25.58516,1561077
30473,thomato,1,0.00006,399405,25.58522,1561077
30474,thomps51,1,0.00006,399406,25.58529,1561077
30475,thomrohit,1,0.00006,399407,25.58535,1561077
30476,thomskrtich,1,0.00006,399408,25.58541,1561077
30477,thorbenwillimek,1,0.00006,399409,25.58548,1561077
30478,thorko,1,0.00006,399410,25.58554,1561077
30479,thorseye,1,0.00006,399411,25.58561,1561077
30480,ThoSap,1,0.00006,399412,25.58567,1561077
30481,thoughtarray,1,0.00006,399413,25.58573,1561077
30482,thpert,1,0.00006,399414,25.58580,1561077
30483,thrbowl,1,0.00006,399415,25.58586,1561077
30484,thrucker,1,0.00006,399416,25.58593,1561077
30485,thrushanth,1,0.00006,399417,25.58599,1561077
30486,Thumperrr,1,0.00006,399418,25.58605,1561077
30487,thunderball1,1,0.00006,399419,25.58612,1561077
30488,thuongshoo,1,0.00006,399420,25.58618,1561077
30489,ThusharaAma,1,0.00006,399421,25.58625,1561077
30490,Thylossus,1,0.00006,399422,25.58631,1561077
30491,tiaantiaan,1,0.00006,399423,25.58637,1561077
30492,tiagomlalves,1,0.00006,399424,25.58644,1561077
30493,tiagomsmagalhaes,1,0.00006,399425,25.58650,1561077
30494,tiagon97,1,0.00006,399426,25.58657,1561077
30495,tiago-rocha-gomes,1,0.00006,399427,25.58663,1561077
30496,Tianny,1,0.00006,399428,25.58669,1561077
30497,tianx2,1,0.00006,399429,25.58676,1561077
30498,tibortru,1,0.00006,399430,25.58682,1561077
30499,ticoombs,1,0.00006,399431,25.58689,1561077
30500,tiedev,1,0.00006,399432,25.58695,1561077
30501,tienhngnguyen,1,0.00006,399433,25.58701,1561077
30502,tienlx93,1,0.00006,399434,25.58708,1561077
30503,tiffanyplourde,1,0.00006,399435,25.58714,1561077
30504,tigerquoll,1,0.00006,399436,25.58721,1561077
30505,tiger-seo,1,0.00006,399437,25.58727,1561077
30506,tightime,1,0.00006,399438,25.58733,1561077
30507,Tihz,1,0.00006,399439,25.58740,1561077
30508,tikolakin,1,0.00006,399440,25.58746,1561077
30509,timakhalaya,1,0.00006,399441,25.58753,1561077
30510,timanin,1,0.00006,399442,25.58759,1561077
30511,timbaer,1,0.00006,399443,25.58766,1561077
30512,timbeadle,1,0.00006,399444,25.58772,1561077
30513,timbi4,1,0.00006,399445,25.58778,1561077
30514,timbirk,1,0.00006,399446,25.58785,1561077
30515,timbortnik,1,0.00006,399447,25.58791,1561077
30516,timc3,1,0.00006,399448,25.58798,1561077
30517,Tim-Clifford,1,0.00006,399449,25.58804,1561077
30518,timcoote,1,0.00006,399450,25.58810,1561077
30519,timd112,1,0.00006,399451,25.58817,1561077
30520,tim-dawson-nv,1,0.00006,399452,25.58823,1561077
30521,timdrysdale,1,0.00006,399453,25.58830,1561077
30522,TimDuffy,1,0.00006,399454,25.58836,1561077
30523,timdvail,1,0.00006,399455,25.58842,1561077
30524,timedroid,1,0.00006,399456,25.58849,1561077
30525,TIME-GATE,1,0.00006,399457,25.58855,1561077
30526,TimeKenosh,1,0.00006,399458,25.58862,1561077
30527,timemaster5,1,0.00006,399459,25.58868,1561077
30528,timfallmk,1,0.00006,399460,25.58874,1561077
30529,TimGebhardt,1,0.00006,399461,25.58881,1561077
30530,timharsch,1,0.00006,399462,25.58887,1561077
30531,tim-ireland,1,0.00006,399463,25.58894,1561077
30532,timiscool,1,0.00006,399464,25.58900,1561077
30533,timjar3,1,0.00006,399465,25.58906,1561077
30534,Timmi88,1,0.00006,399466,25.58913,1561077
30535,timofeee,1,0.00006,399467,25.58919,1561077
30536,timothegenzmer,1,0.00006,399468,25.58926,1561077
30537,timothyclifford,1,0.00006,399469,25.58932,1561077
30538,timothyfredrickson,1,0.00006,399470,25.58938,1561077
30539,timothy-mcroy,1,0.00006,399471,25.58945,1561077
30540,timp,1,0.00006,399472,25.58951,1561077
30541,timp87,1,0.00006,399473,25.58958,1561077
30542,Timpsons,1,0.00006,399474,25.58964,1561077
30543,tim-pugh,1,0.00006,399475,25.58971,1561077
30544,timroes,1,0.00006,399476,25.58977,1561077
30545,tim-saki,1,0.00006,399477,25.58983,1561077
30546,timscharfenort33,1,0.00006,399478,25.58990,1561077
30547,timshadel,1,0.00006,399479,25.58996,1561077
30548,TimSoethout,1,0.00006,399480,25.59003,1561077
30549,tim-tk,1,0.00006,399481,25.59009,1561077
30550,timur-han,1,0.00006,399482,25.59015,1561077
30551,tim-win,1,0.00006,399483,25.59022,1561077
30552,tingzhang,1,0.00006,399484,25.59028,1561077
30553,tinhtran24,1,0.00006,399485,25.59035,1561077
30554,tintht,1,0.00006,399486,25.59041,1561077
30555,TinusJ,1,0.00006,399487,25.59047,1561077
30556,tinycogio,1,0.00006,399488,25.59054,1561077
30557,tinydylan,1,0.00006,399489,25.59060,1561077
30558,Tiny-wlx,1,0.00006,399490,25.59067,1561077
30559,tinyzimmer,1,0.00006,399491,25.59073,1561077
30560,tiraeth,1,0.00006,399492,25.59079,1561077
30561,Tiru07,1,0.00006,399493,25.59086,1561077
30562,tishan18927,1,0.00006,399494,25.59092,1561077
30563,Titaniumtown,1,0.00006,399495,25.59099,1561077
30564,tite-alvarado,1,0.00006,399496,25.59105,1561077
30565,tiversusit,1,0.00006,399497,25.59111,1561077
30566,tivv,1,0.00006,399498,25.59118,1561077
30567,tizzo,1,0.00006,399499,25.59124,1561077
30568,tj-corrigan,1,0.00006,399500,25.59131,1561077
30569,tjhei,1,0.00006,399501,25.59137,1561077
30570,tjhiggins,1,0.00006,399502,25.59143,1561077
30571,tJouve,1,0.00006,399503,25.59150,1561077
30572,tjperovich,1,0.00006,399504,25.59156,1561077
30573,tjwallace,1,0.00006,399505,25.59163,1561077
30574,tkhkokd,1,0.00006,399506,25.59169,1561077
30575,tking16,1,0.00006,399507,25.59175,1561077
30576,tkokev,1,0.00006,399508,25.59182,1561077
30577,tkriviradev,1,0.00006,399509,25.59188,1561077
30578,tkrzeminski,1,0.00006,399510,25.59195,1561077
30579,tkurdyna,1,0.00006,399511,25.59201,1561077
30580,tkzv,1,0.00006,399512,25.59208,1561077
30581,tleahygoogle,1,0.00006,399513,25.59214,1561077
30582,tlewis,1,0.00006,399514,25.59220,1561077
30583,tlisonbee,1,0.00006,399515,25.59227,1561077
30584,TLogik,1,0.00006,399516,25.59233,1561077
30585,tmair,1,0.00006,399517,25.59240,1561077
30586,tmarlok88,1,0.00006,399518,25.59246,1561077
30587,tmcarr,1,0.00006,399519,25.59252,1561077
30588,tmccombs,1,0.00006,399520,25.59259,1561077
30589,tmcnag,1,0.00006,399521,25.59265,1561077
30590,tmcoma,1,0.00006,399522,25.59272,1561077
30591,tmikulin,1,0.00006,399523,25.59278,1561077
30592,tmiller,1,0.00006,399524,25.59284,1561077
30593,tm-linkwerk,1,0.00006,399525,25.59291,1561077
30594,tmoreira2020,1,0.00006,399526,25.59297,1561077
30595,tm-slavik57,1,0.00006,399527,25.59304,1561077
30596,tmx-kitta,1,0.00006,399528,25.59310,1561077
30597,tnstung,1,0.00006,399529,25.59316,1561077
30598,toan267,1,0.00006,399530,25.59323,1561077
30599,tobato,1,0.00006,399531,25.59329,1561077
30600,tobias-ericsson,1,0.00006,399532,25.59336,1561077
30601,tobiasgeissler,1,0.00006,399533,25.59342,1561077
30602,tobiashofmann,1,0.00006,399534,25.59348,1561077
30603,tobiasweibel,1,0.00006,399535,25.59355,1561077
30604,TobiEiss,1,0.00006,399536,25.59361,1561077
30605,TobiTenno,1,0.00006,399537,25.59368,1561077
30606,TobKed,1,0.00006,399538,25.59374,1561077
30607,tobysainsbury,1,0.00006,399539,25.59380,1561077
30608,toddatapiture,1,0.00006,399540,25.59387,1561077
30609,toddc-unity3d,1,0.00006,399541,25.59393,1561077
30610,toddlipcon,1,0.00006,399542,25.59400,1561077
30611,Toddman0430,1,0.00006,399543,25.59406,1561077
30612,toddpi314,1,0.00006,399544,25.59413,1561077
30613,todor-kolev,1,0.00006,399545,25.59419,1561077
30614,ToeBee,1,0.00006,399546,25.59425,1561077
30615,tofdragon,1,0.00006,399547,25.59432,1561077
30616,toinux,1,0.00006,399548,25.59438,1561077
30617,tokana,1,0.00006,399549,25.59445,1561077
30618,Tokenyet,1,0.00006,399550,25.59451,1561077
30619,tokunbo,1,0.00006,399551,25.59457,1561077
30620,tolland,1,0.00006,399552,25.59464,1561077
30621,tollgen,1,0.00006,399553,25.59470,1561077
30622,tolumia,1,0.00006,399554,25.59477,1561077
30623,tomap,1,0.00006,399555,25.59483,1561077
30624,TomA-R,1,0.00006,399556,25.59489,1561077
30625,tomas,1,0.00006,399557,25.59496,1561077
30626,tomasj,1,0.00006,399558,25.59502,1561077
30627,TomasLesc,1,0.00006,399559,25.59509,1561077
30628,tomasquith,1,0.00006,399560,25.59515,1561077
30629,tomasz77,1,0.00006,399561,25.59521,1561077
30630,tomasz-bres,1,0.00006,399562,25.59528,1561077
30631,TomaszHol,1,0.00006,399563,25.59534,1561077
30632,TomaszMrugala,1,0.00006,399564,25.59541,1561077
30633,tomaszszlek,1,0.00006,399565,25.59547,1561077
30634,TomaszUrugOlszewski,1,0.00006,399566,25.59553,1561077
30635,tombin,1,0.00006,399567,25.59560,1561077
30636,tombooth,1,0.00006,399568,25.59566,1561077
30637,tomcashman,1,0.00006,399569,25.59573,1561077
30638,tomcooperca,1,0.00006,399570,25.59579,1561077
30639,tomdw,1,0.00006,399571,25.59585,1561077
30640,tomeks666,1,0.00006,399572,25.59592,1561077
30641,tomerghelber,1,0.00006,399573,25.59598,1561077
30642,tomerliberman,1,0.00006,399574,25.59605,1561077
30643,tomers,1,0.00006,399575,25.59611,1561077
30644,tomfitzhenry,1,0.00006,399576,25.59617,1561077
30645,tomgross,1,0.00006,399577,25.59624,1561077
30646,TomHellier,1,0.00006,399578,25.59630,1561077
30647,tomikapc,1,0.00006,399579,25.59637,1561077
30648,tomiloza,1,0.00006,399580,25.59643,1561077
30649,tomi-roam,1,0.00006,399581,25.59650,1561077
30650,tomiyama2392,1,0.00006,399582,25.59656,1561077
30651,tomko80,1,0.00006,399583,25.59662,1561077
30652,tommartensen,1,0.00006,399584,25.59669,1561077
30653,tommyboys0107,1,0.00006,399585,25.59675,1561077
30654,tommymccallig,1,0.00006,399586,25.59682,1561077
30655,tompittson,1,0.00006,399587,25.59688,1561077
30656,tompsh,1,0.00006,399588,25.59694,1561077
30657,tomrobison,1,0.00006,399589,25.59701,1561077
30658,tomschr,1,0.00006,399590,25.59707,1561077
30659,TomTondeur,1,0.00006,399591,25.59714,1561077
30660,TomTucka,1,0.00006,399592,25.59720,1561077
30661,tomvater,1,0.00006,399593,25.59726,1561077
30662,tomwire,1,0.00006,399594,25.59733,1561077
30663,tomwys,1,0.00006,399595,25.59739,1561077
30664,tomykaira,1,0.00006,399596,25.59746,1561077
30665,tomyknocker,1,0.00006,399597,25.59752,1561077
30666,tonivdv,1,0.00006,399598,25.59758,1561077
30667,tony,1,0.00006,399599,25.59765,1561077
30668,TonyBian,1,0.00006,399600,25.59771,1561077
30669,tony-bondarenko,1,0.00006,399601,25.59778,1561077
30670,tonysmithio,1,0.00006,399602,25.59784,1561077
30671,tony-snyder-fc,1,0.00006,399603,25.59790,1561077
30672,tonythomas28,1,0.00006,399604,25.59797,1561077
30673,TonyWael,1,0.00006,399605,25.59803,1561077
30674,tony-wallace,1,0.00006,399606,25.59810,1561077
30675,topagae,1,0.00006,399607,25.59816,1561077
30676,Toparvion,1,0.00006,399608,25.59822,1561077
30677,tophers42,1,0.00006,399609,25.59829,1561077
30678,topu,1,0.00006,399610,25.59835,1561077
30679,TOPWN,1,0.00006,399611,25.59842,1561077
30680,toralf,1,0.00006,399612,25.59848,1561077
30681,toralMevada,1,0.00006,399613,25.59855,1561077
30682,torarvid,1,0.00006,399614,25.59861,1561077
30683,Torolleys,1,0.00006,399615,25.59867,1561077
30684,torquemad,1,0.00006,399616,25.59874,1561077
30685,torrancew,1,0.00006,399617,25.59880,1561077
30686,torrick,1,0.00006,399618,25.59887,1561077
30687,TorstenHellwig,1,0.00006,399619,25.59893,1561077
30688,torutk,1,0.00006,399620,25.59899,1561077
30689,toschder,1,0.00006,399621,25.59906,1561077
30690,toshihiko-okubo,1,0.00006,399622,25.59912,1561077
30691,Tosken1337,1,0.00006,399623,25.59919,1561077
30692,tosone,1,0.00006,399624,25.59925,1561077
30693,toufoner,1,0.00006,399625,25.59931,1561077
30694,tourjee,1,0.00006,399626,25.59938,1561077
30695,toutiyeti,1,0.00006,399627,25.59944,1561077
30696,tovine,1,0.00006,399628,25.59951,1561077
30697,Townsheriff,1,0.00006,399629,25.59957,1561077
30698,tpak,1,0.00006,399630,25.59963,1561077
30699,tperka-catalogicsoftware,1,0.00006,399631,25.59970,1561077
30700,tpham210,1,0.00006,399632,25.59976,1561077
30701,tphambgs,1,0.00006,399633,25.59983,1561077
30702,TQING1990,1,0.00006,399634,25.59989,1561077
30703,tq-jappy,1,0.00006,399635,25.59995,1561077
30704,traghu84,1,0.00006,399636,25.60002,1561077
30705,trane000,1,0.00006,399637,25.60008,1561077
30706,trankchung,1,0.00006,399638,25.60015,1561077
30707,traskrogers,1,0.00006,399639,25.60021,1561077
30708,travcunn,1,0.00006,399640,25.60027,1561077
30709,trayla,1,0.00006,399641,25.60034,1561077
30710,trcdabuildserver,1,0.00006,399642,25.60040,1561077
30711,trdwll,1,0.00006,399643,25.60047,1561077
30712,tre7roja,1,0.00006,399644,25.60053,1561077
30713,trecloux,1,0.00006,399645,25.60059,1561077
30714,tremblin,1,0.00006,399646,25.60066,1561077
30715,tremulaes,1,0.00006,399647,25.60072,1561077
30716,trentapple,1,0.00006,399648,25.60079,1561077
30717,trevoro,1,0.00006,399649,25.60085,1561077
30718,trevorrea,1,0.00006,399650,25.60092,1561077
30719,TreyLawrence,1,0.00006,399651,25.60098,1561077
30720,TRFFT,1,0.00006,399652,25.60104,1561077
30721,trim777,1,0.00006,399653,25.60111,1561077
30722,Trimeego,1,0.00006,399654,25.60117,1561077
30723,trinhanhquan,1,0.00006,399655,25.60124,1561077
30724,TrinuxSG,1,0.00006,399656,25.60130,1561077
30725,TripleStarCodeHunter,1,0.00006,399657,25.60136,1561077
30726,trippdaddy,1,0.00006,399658,25.60143,1561077
30727,Triqqo,1,0.00006,399659,25.60149,1561077
30728,trisb,1,0.00006,399660,25.60156,1561077
30729,trissanen,1,0.00006,399661,25.60162,1561077
30730,tristanzhang,1,0.00006,399662,25.60168,1561077
30731,triThirty,1,0.00006,399663,25.60175,1561077
30732,trolleybusses,1,0.00006,399664,25.60181,1561077
30733,trose89,1,0.00006,399665,25.60188,1561077
30734,troy-rudolph,1,0.00006,399666,25.60194,1561077
30735,troytop,1,0.00006,399667,25.60200,1561077
30736,trrtly,1,0.00006,399668,25.60207,1561077
30737,tru,1,0.00006,399669,25.60213,1561077
30738,truesoupfly,1,0.00006,399670,25.60220,1561077
30739,truestbyheart,1,0.00006,399671,25.60226,1561077
30740,TruffleMuffin,1,0.00006,399672,25.60232,1561077
30741,truh,1,0.00006,399673,25.60239,1561077
30742,trungPa,1,0.00006,399674,25.60245,1561077
30743,Truth1984,1,0.00006,399675,25.60252,1561077
30744,trydis,1,0.00006,399676,25.60258,1561077
30745,tryggth,1,0.00006,399677,25.60264,1561077
30746,trygveaa,1,0.00006,399678,25.60271,1561077
30747,TryingToImprove,1,0.00006,399679,25.60277,1561077
30748,TrymBeast,1,0.00006,399680,25.60284,1561077
30749,Tryph,1,0.00006,399681,25.60290,1561077
30750,tryptyx,1,0.00006,399682,25.60297,1561077
30751,tsadoklf,1,0.00006,399683,25.60303,1561077
30752,tsaizhenling,1,0.00006,399684,25.60309,1561077
30753,tsamuel33,1,0.00006,399685,25.60316,1561077
30754,tsasaki609,1,0.00006,399686,25.60322,1561077
30755,Tsaukpaetra,1,0.00006,399687,25.60329,1561077
30756,tsbx,1,0.00006,399688,25.60335,1561077
30757,tschifftner,1,0.00006,399689,25.60341,1561077
30758,tsDaenor,1,0.00006,399690,25.60348,1561077
30759,tsechov,1,0.00006,399691,25.60354,1561077
30760,tsim2020,1,0.00006,399692,25.60361,1561077
30761,tskinn,1,0.00006,399693,25.60367,1561077
30762,tsmithv11,1,0.00006,399694,25.60373,1561077
30763,ts-silvio,1,0.00006,399695,25.60380,1561077
30764,tssingkofer,1,0.00006,399696,25.60386,1561077
30765,tsukasaoishi,1,0.00006,399697,25.60393,1561077
30766,tsutsarin-fuib,1,0.00006,399698,25.60399,1561077
30767,tszpinda,1,0.00006,399699,25.60405,1561077
30768,TT2142022,1,0.00006,399700,25.60412,1561077
30769,ttrumm,1,0.00006,399701,25.60418,1561077
30770,ttsiebzehntt,1,0.00006,399702,25.60425,1561077
30771,tt-togi,1,0.00006,399703,25.60431,1561077
30772,tuanla-mobilus,1,0.00006,399704,25.60437,1561077
30773,tucksaun,1,0.00006,399705,25.60444,1561077
30774,tudormi,1,0.00006,399706,25.60450,1561077
30775,TueDissingWork,1,0.00006,399707,25.60457,1561077
30776,tufanrakshit006,1,0.00006,399708,25.60463,1561077
30777,tugberkugurlu,1,0.00006,399709,25.60469,1561077
30778,tugboat,1,0.00006,399710,25.60476,1561077
30779,tuhoojabotti,1,0.00006,399711,25.60482,1561077
30780,tuky,1,0.00006,399712,25.60489,1561077
30781,tulku,1,0.00006,399713,25.60495,1561077
30782,Tuman829,1,0.00006,399714,25.60501,1561077
30783,tunahan7el,1,0.00006,399715,25.60508,1561077
30784,tunasalat,1,0.00006,399716,25.60514,1561077
30785,tungamalli,1,0.00006,399717,25.60521,1561077
30786,tunkl,1,0.00006,399718,25.60527,1561077
30787,tunsira,1,0.00006,399719,25.60534,1561077
30788,tuochi,1,0.00006,399720,25.60540,1561077
30789,turgayozgur,1,0.00006,399721,25.60546,1561077
30790,turko,1,0.00006,399722,25.60553,1561077
30791,turneand,1,0.00006,399723,25.60559,1561077
30792,turnopil,1,0.00006,399724,25.60566,1561077
30793,tusharchaudhari30,1,0.00006,399725,25.60572,1561077
30794,tushar-sakpal,1,0.00006,399726,25.60578,1561077
30795,tuthan,1,0.00006,399727,25.60585,1561077
30796,tutipeti,1,0.00006,399728,25.60591,1561077
30797,TUTUBIG,1,0.00006,399729,25.60598,1561077
30798,tuwid,1,0.00006,399730,25.60604,1561077
30799,tuxhamb,1,0.00006,399731,25.60610,1561077
30800,tuxtter,1,0.00006,399732,25.60617,1561077
30801,tuxy85,1,0.00006,399733,25.60623,1561077
30802,tvasudev007,1,0.00006,399734,25.60630,1561077
30803,Tvde1,1,0.00006,399735,25.60636,1561077
30804,tvschuer,1,0.00006,399736,25.60642,1561077
30805,tw3rp,1,0.00006,399737,25.60649,1561077
30806,twanc,1,0.00006,399738,25.60655,1561077
30807,twcadamgrant,1,0.00006,399739,25.60662,1561077
30808,tweissin,1,0.00006,399740,25.60668,1561077
30809,Twister915,1,0.00006,399741,25.60674,1561077
30810,twoversionsofme,1,0.00006,399742,25.60681,1561077
30811,twpol,1,0.00006,399743,25.60687,1561077
30812,t-yaegashi,1,0.00006,399744,25.60694,1561077
30813,Tyagi0502,1,0.00006,399745,25.60700,1561077
30814,tyanko1,1,0.00006,399746,25.60706,1561077
30815,tyborg,1,0.00006,399747,25.60713,1561077
30816,TylerAP,1,0.00006,399748,25.60719,1561077
30817,tyler-hoffman,1,0.00006,399749,25.60726,1561077
30818,tylerjones4508,1,0.00006,399750,25.60732,1561077
30819,tylerstanczak,1,0.00006,399751,25.60739,1561077
30820,tylinux,1,0.00006,399752,25.60745,1561077
30821,tympanix,1,0.00006,399753,25.60751,1561077
30822,tyoi000,1,0.00006,399754,25.60758,1561077
30823,typeBlkCofe,1,0.00006,399755,25.60764,1561077
30824,typekpb,1,0.00006,399756,25.60771,1561077
30825,Tyrael,1,0.00006,399757,25.60777,1561077
30826,tyrone-grech,1,0.00006,399758,25.60783,1561077
30827,tyumin,1,0.00006,399759,25.60790,1561077
30828,u3r,1,0.00006,399760,25.60796,1561077
30829,u773357,1,0.00006,399761,25.60803,1561077
30830,uajith,1,0.00006,399762,25.60809,1561077
30831,ualjjcanada,1,0.00006,399763,25.60815,1561077
30832,ubante,1,0.00006,399764,25.60822,1561077
30833,ubaranouski,1,0.00006,399765,25.60828,1561077
30834,ubergeek42,1,0.00006,399766,25.60835,1561077
30835,ubrandt,1,0.00006,399767,25.60841,1561077
30836,uchanbi,1,0.00006,399768,25.60847,1561077
30837,udangel-r7,1,0.00006,399769,25.60854,1561077
30838,uday1bhanu,1,0.00006,399770,25.60860,1561077
30839,uday-kakkar,1,0.00006,399771,25.60867,1561077
30840,Udaynikam123,1,0.00006,399772,25.60873,1561077
30841,udaysharma,1,0.00006,399773,25.60879,1561077
30842,udb7l,1,0.00006,399774,25.60886,1561077
30843,udomsak,1,0.00006,399775,25.60892,1561077
30844,ufkesba,1,0.00006,399776,25.60899,1561077
30845,ufp1000,1,0.00006,399777,25.60905,1561077
30846,uglyliu,1,0.00006,399778,25.60911,1561077
30847,UgurVolkan,1,0.00006,399779,25.60918,1561077
30848,ugwuanye,1,0.00006,399780,25.60924,1561077
30849,uhari03,1,0.00006,399781,25.60931,1561077
30850,uipath-yk,1,0.00006,399782,25.60937,1561077
30851,ujain6,1,0.00006,399783,25.60944,1561077
30852,ujishu,1,0.00006,399784,25.60950,1561077
30853,ujjawal-4664,1,0.00006,399785,25.60956,1561077
30854,ukdvivek,1,0.00006,399786,25.60963,1561077
30855,ukid,1,0.00006,399787,25.60969,1561077
30856,Uklosk,1,0.00006,399788,25.60976,1561077
30857,UladzislauValchkou,1,0.00006,399789,25.60982,1561077
30858,ulises,1,0.00006,399790,25.60988,1561077
30859,UlkaAsati,1,0.00006,399791,25.60995,1561077
30860,UlrichBlunck,1,0.00006,399792,25.61001,1561077
30861,ultimate809,1,0.00006,399793,25.61008,1561077
30862,ultimaweapon,1,0.00006,399794,25.61014,1561077
30863,ultinous-zsolt,1,0.00006,399795,25.61020,1561077
30864,ultraon,1,0.00006,399796,25.61027,1561077
30865,ulyssesh,1,0.00006,399797,25.61033,1561077
30866,umairali7,1,0.00006,399798,25.61040,1561077
30867,Umar9052,1,0.00006,399799,25.61046,1561077
30868,umbertix,1,0.00006,399800,25.61052,1561077
30869,umegaya,1,0.00006,399801,25.61059,1561077
30870,UmeshVeerasingam,1,0.00006,399802,25.61065,1561077
30871,UncertainSchrodinger,1,0.00006,399803,25.61072,1561077
30872,undead85,1,0.00006,399804,25.61078,1561077
30873,UndeadJoe,1,0.00006,399805,25.61084,1561077
30874,unencoded,1,0.00006,399806,25.61091,1561077
30875,unicast,1,0.00006,399807,25.61097,1561077
30876,UniQP,1,0.00006,399808,25.61104,1561077
30877,Unit111,1,0.00006,399809,25.61110,1561077
30878,unitysipu,1,0.00006,399810,25.61116,1561077
30879,unixhelden,1,0.00006,399811,25.61123,1561077
30880,unixhup,1,0.00006,399812,25.61129,1561077
30881,unkind,1,0.00006,399813,25.61136,1561077
30882,Unknown-Guy,1,0.00006,399814,25.61142,1561077
30883,unlimitedLoop,1,0.00006,399815,25.61148,1561077
30884,unni-w,1,0.00006,399816,25.61155,1561077
30885,un-stantane,1,0.00006,399817,25.61161,1561077
30886,uohzxela,1,0.00006,399818,25.61168,1561077
30887,upendran,1,0.00006,399819,25.61174,1561077
30888,upendraskillup,1,0.00006,399820,25.61181,1561077
30889,uratnam,1,0.00006,399821,25.61187,1561077
30890,uriahl,1,0.00006,399822,25.61193,1561077
30891,uridium,1,0.00006,399823,25.61200,1561077
30892,urrego093,1,0.00006,399824,25.61206,1561077
30893,urvanov-ru,1,0.00006,399825,25.61213,1561077
30894,username-unavailable,1,0.00006,399826,25.61219,1561077
30895,ushahid-nisum-com,1,0.00006,399827,25.61225,1561077
30896,usherfu,1,0.00006,399828,25.61232,1561077
30897,usjpaq,1,0.00006,399829,25.61238,1561077
30898,ustuehler,1,0.00006,399830,25.61245,1561077
30899,usulkies,1,0.00006,399831,25.61251,1561077
30900,usuryadevara,1,0.00006,399832,25.61257,1561077
30901,utkarshkoo,1,0.00006,399833,25.61264,1561077
30902,uttam-li,1,0.00006,399834,25.61270,1561077
30903,uv2509,1,0.00006,399835,25.61277,1561077
30904,uvwild,1,0.00006,399836,25.61283,1561077
30905,uwoa,1,0.00006,399837,25.61289,1561077
30906,v00d00,1,0.00006,399838,25.61296,1561077
30907,v7r,1,0.00006,399839,25.61302,1561077
30908,vaccum121,1,0.00006,399840,25.61309,1561077
30909,VackarAfzal,1,0.00006,399841,25.61315,1561077
30910,VaclavKlic,1,0.00006,399842,25.61321,1561077
30911,vacri,1,0.00006,399843,25.61328,1561077
30912,vadicn,1,0.00006,399844,25.61334,1561077
30913,vadru,1,0.00006,399845,25.61341,1561077
30914,vaibhav-46,1,0.00006,399846,25.61347,1561077
30915,vaibhavbhade,1,0.00006,399847,25.61353,1561077
30916,VaibhavG10,1,0.00006,399848,25.61360,1561077
30917,vail130,1,0.00006,399849,25.61366,1561077
30918,vaisakhsaikripa,1,0.00006,399850,25.61373,1561077
30919,Valarfess,1,0.00006,399851,25.61379,1561077
30920,valedaemon,1,0.00006,399852,25.61386,1561077
30921,valentinabojan,1,0.00006,399853,25.61392,1561077
30922,valentin-nasta,1,0.00006,399854,25.61398,1561077
30923,ValeriiMal,1,0.00006,399855,25.61405,1561077
30924,valerio-it,1,0.00006,399856,25.61411,1561077
30925,valeriujieanu,1,0.00006,399857,25.61418,1561077
30926,valeriy-devpronet,1,0.00006,399858,25.61424,1561077
30927,valerjanka,1,0.00006,399859,25.61430,1561077
30928,ValorHeart,1,0.00006,399860,25.61437,1561077
30929,valterhenrique,1,0.00006,399861,25.61443,1561077
30930,valter-silva-git,1,0.00006,399862,25.61450,1561077
30931,vanatomas,1,0.00006,399863,25.61456,1561077
30932,VanAxe,1,0.00006,399864,25.61462,1561077
30933,vanclist,1,0.00006,399865,25.61469,1561077
30934,vandent6,1,0.00006,399866,25.61475,1561077
30935,vanditboy,1,0.00006,399867,25.61482,1561077
30936,vanga,1,0.00006,399868,25.61488,1561077
30937,Vanguardcreed,1,0.00006,399869,25.61494,1561077
30938,vanisree1,1,0.00006,399870,25.61501,1561077
30939,vanlongme,1,0.00006,399871,25.61507,1561077
30940,vanlooverenkoen,1,0.00006,399872,25.61514,1561077
30941,vannguyentricentis,1,0.00006,399873,25.61520,1561077
30942,VannTen,1,0.00006,399874,25.61526,1561077
30943,vansari,1,0.00006,399875,25.61533,1561077
30944,vantangst,1,0.00006,399876,25.61539,1561077
30945,VanThanhThai,1,0.00006,399877,25.61546,1561077
30946,vantiegh,1,0.00006,399878,25.61552,1561077
30947,varaprasad-pakalapati,1,0.00006,399879,25.61558,1561077
30948,varjoinen,1,0.00006,399880,25.61565,1561077
30949,varnk,1,0.00006,399881,25.61571,1561077
30950,Varomir,1,0.00006,399882,25.61578,1561077
30951,varosi,1,0.00006,399883,25.61584,1561077
30952,varshabhijeet,1,0.00006,399884,25.61590,1561077
30953,varsho,1,0.00006,399885,25.61597,1561077
30954,varun1308,1,0.00006,399886,25.61603,1561077
30955,varunincharge,1,0.00006,399887,25.61610,1561077
30956,varunnahata,1,0.00006,399888,25.61616,1561077
30957,varunsaran1,1,0.00006,399889,25.61623,1561077
30958,varun-vikas,1,0.00006,399890,25.61629,1561077
30959,varvanovich,1,0.00006,399891,25.61635,1561077
30960,vasanthy2k7,1,0.00006,399892,25.61642,1561077
30961,vascofg,1,0.00006,399893,25.61648,1561077
30962,vasidzius,1,0.00006,399894,25.61655,1561077
30963,Vasiliy-Lavrov,1,0.00006,399895,25.61661,1561077
30964,vasilvestre,1,0.00006,399896,25.61667,1561077
30965,vassik,1,0.00006,399897,25.61674,1561077
30966,VassilMarjunits,1,0.00006,399898,25.61680,1561077
30967,vastep,1,0.00006,399899,25.61687,1561077
30968,vasu-vi,1,0.00006,399900,25.61693,1561077
30969,vasya10,1,0.00006,399901,25.61699,1561077
30970,vathsalashetty25,1,0.00006,399902,25.61706,1561077
30971,vatioz,1,0.00006,399903,25.61712,1561077
30972,vavikast,1,0.00006,399904,25.61719,1561077
30973,vavoluk,1,0.00006,399905,25.61725,1561077
30974,vbekkerm,1,0.00006,399906,25.61731,1561077
30975,vbhavsar,1,0.00006,399907,25.61738,1561077
30976,vbhumare,1,0.00006,399908,25.61744,1561077
30977,vbisbest,1,0.00006,399909,25.61751,1561077
30978,vblg,1,0.00006,399910,25.61757,1561077
30979,vboix,1,0.00006,399911,25.61763,1561077
30980,vbonker,1,0.00006,399912,25.61770,1561077
30981,vbottu,1,0.00006,399913,25.61776,1561077
30982,vbtnickn,1,0.00006,399914,25.61783,1561077
30983,vcd195,1,0.00006,399915,25.61789,1561077
30984,vchawla3,1,0.00006,399916,25.61795,1561077
30985,vdoodala,1,0.00006,399917,25.61802,1561077
30986,Vebryn,1,0.00006,399918,25.61808,1561077
30987,vecchp,1,0.00006,399919,25.61815,1561077
30988,vedarn,1,0.00006,399920,25.61821,1561077
30989,veeradatla,1,0.00006,399921,25.61828,1561077
30990,VeeraNadikatla,1,0.00006,399922,25.61834,1561077
30991,veganafro,1,0.00006,399923,25.61840,1561077
30992,vejeta,1,0.00006,399924,25.61847,1561077
30993,velanbabu,1,0.00006,399925,25.61853,1561077
30994,velbur,1,0.00006,399926,25.61860,1561077
30995,velocity333,1,0.00006,399927,25.61866,1561077
30996,velzganesh,1,0.00006,399928,25.61872,1561077
30997,vemulaanvesh,1,0.00006,399929,25.61879,1561077
30998,vendetta1987,1,0.00006,399930,25.61885,1561077
30999,vengatesanns,1,0.00006,399931,25.61892,1561077
31000,VengefulAncient,1,0.00006,399932,25.61898,1561077
31001,venkatagajara,1,0.00006,399933,25.61904,1561077
31002,venkatareddy9,1,0.00006,399934,25.61911,1561077
31003,venkatasykam,1,0.00006,399935,25.61917,1561077
31004,VenkateshLoganathan,1,0.00006,399936,25.61924,1561077
31005,venkateshpanda,1,0.00006,399937,25.61930,1561077
31006,venkat-kasagani,1,0.00006,399938,25.61936,1561077
31007,venkat-ml,1,0.00006,399939,25.61943,1561077
31008,venkatvaranasi8421,1,0.00006,399940,25.61949,1561077
31009,venky2k57,1,0.00006,399941,25.61956,1561077
31010,venky-patikineti,1,0.00006,399942,25.61962,1561077
31011,venkyrajaram,1,0.00006,399943,25.61968,1561077
31012,venpo045,1,0.00006,399944,25.61975,1561077
31013,Venutiwa,1,0.00006,399945,25.61981,1561077
31014,VermaGa,1,0.00006,399946,25.61988,1561077
31015,vermeulenm,1,0.00006,399947,25.61994,1561077
31016,veryjos,1,0.00006,399948,25.62000,1561077
31017,VeryLazyBoy,1,0.00006,399949,25.62007,1561077
31018,veshwas,1,0.00006,399950,25.62013,1561077
31019,vexdev,1,0.00006,399951,25.62020,1561077
31020,vexus2,1,0.00006,399952,25.62026,1561077
31021,vfarafonov,1,0.00006,399953,25.62032,1561077
31022,vf-bbs,1,0.00006,399954,25.62039,1561077
31023,vhaidamaka,1,0.00006,399955,25.62045,1561077
31024,vhamon,1,0.00006,399956,25.62052,1561077
31025,vhrebinnyi,1,0.00006,399957,25.62058,1561077
31026,Vi7476,1,0.00006,399958,25.62065,1561077
31027,via-justa,1,0.00006,399959,25.62071,1561077
31028,viane,1,0.00006,399960,25.62077,1561077
31029,vianuoro,1,0.00006,399961,25.62084,1561077
31030,vibbow,1,0.00006,399962,25.62090,1561077
31031,VibinD,1,0.00006,399963,25.62097,1561077
31032,viceradman,1,0.00006,399964,25.62103,1561077
31033,vickikozel,1,0.00006,399965,25.62109,1561077
31034,vicky997,1,0.00006,399966,25.62116,1561077
31035,vickybansal,1,0.00006,399967,25.62122,1561077
31036,VickySmell,1,0.00006,399968,25.62129,1561077
31037,VickyWinner,1,0.00006,399969,25.62135,1561077
31038,vicperdana,1,0.00006,399970,25.62141,1561077
31039,victor-accarini,1,0.00006,399971,25.62148,1561077
31040,VictorAvelar,1,0.00006,399972,25.62154,1561077
31041,Victoremepunto,1,0.00006,399973,25.62161,1561077
31042,victorface2,1,0.00006,399974,25.62167,1561077
31043,victor-mendes-eduardo,1,0.00006,399975,25.62173,1561077
31044,victorpascual,1,0.00006,399976,25.62180,1561077
31045,VictorRPA,1,0.00006,399977,25.62186,1561077
31046,victtsl,1,0.00006,399978,25.62193,1561077
31047,videnovnebojsa,1,0.00006,399979,25.62199,1561077
31048,vidibon2000,1,0.00006,399980,25.62205,1561077
31049,vidolch,1,0.00006,399981,25.62212,1561077
31050,vieenodp,1,0.00006,399982,25.62218,1561077
31051,vietch2612,1,0.00006,399983,25.62225,1561077
31052,viewizard,1,0.00006,399984,25.62231,1561077
31053,viharreddy1994,1,0.00006,399985,25.62237,1561077
31054,vihoti,1,0.00006,399986,25.62244,1561077
31055,vijayamoorthi85,1,0.00006,399987,25.62250,1561077
31056,vijayanandsharma,1,0.00006,399988,25.62257,1561077
31057,vijaybirru,1,0.00006,399989,25.62263,1561077
31058,Vijaygoud,1,0.00006,399990,25.62270,1561077
31059,vijaynagr,1,0.00006,399991,25.62276,1561077
31060,vijaypremnath,1,0.00006,399992,25.62282,1561077
31061,vijaysanchetibmc,1,0.00006,399993,25.62289,1561077
31062,vijaysharm,1,0.00006,399994,25.62295,1561077
31063,vijaysundarv,1,0.00006,399995,25.62302,1561077
31064,vij-code,1,0.00006,399996,25.62308,1561077
31065,vijjukumar,1,0.00006,399997,25.62314,1561077
31066,Vikas92155,1,0.00006,399998,25.62321,1561077
31067,vikassrivas,1,0.00006,399999,25.62327,1561077
31068,vikhyatprabhu,1,0.00006,400000,25.62334,1561077
31069,vikoalucard,1,0.00006,400001,25.62340,1561077
31070,vikram291194,1,0.00006,400002,25.62346,1561077
31071,vikramaditya91,1,0.00006,400003,25.62353,1561077
31072,vikrantsnirban,1,0.00006,400004,25.62359,1561077
31073,viktardanilchyk,1,0.00006,400005,25.62366,1561077
31074,vilarion,1,0.00006,400006,25.62372,1561077
31075,vilasd,1,0.00006,400007,25.62378,1561077
31076,vilbert,1,0.00006,400008,25.62385,1561077
31077,villins,1,0.00006,400009,25.62391,1561077
31078,vilvic,1,0.00006,400010,25.62398,1561077
31079,vilvilking,1,0.00006,400011,25.62404,1561077
31080,vimalcs,1,0.00006,400012,25.62410,1561077
31081,vimalprakashts,1,0.00006,400013,25.62417,1561077
31082,vin01,1,0.00006,400014,25.62423,1561077
31083,vinamrahw,1,0.00006,400015,25.62430,1561077
31084,VinayakKukreja,1,0.00006,400016,25.62436,1561077
31085,vinayk06,1,0.00006,400017,25.62442,1561077
31086,vinaykonanki,1,0.00006,400018,25.62449,1561077
31087,vinayreddy888,1,0.00006,400019,25.62455,1561077
31088,vincedjango,1,0.00006,400020,25.62462,1561077
31089,vincent927,1,0.00006,400021,25.62468,1561077
31090,vincentchemouny,1,0.00006,400022,25.62474,1561077
31091,vincent-fuchs,1,0.00006,400023,25.62481,1561077
31092,vincenthuynh,1,0.00006,400024,25.62487,1561077
31093,vincentisambart,1,0.00006,400025,25.62494,1561077
31094,vincentjn,1,0.00006,400026,25.62500,1561077
31095,vincenzodnp,1,0.00006,400027,25.62507,1561077
31096,VincenzoDo,1,0.00006,400028,25.62513,1561077
31097,vindiagram,1,0.00006,400029,25.62519,1561077
31098,vinhut,1,0.00006,400030,25.62526,1561077
31099,ViniciusBastosTR,1,0.00006,400031,25.62532,1561077
31100,vinixavier,1,0.00006,400032,25.62539,1561077
31101,vinkris,1,0.00006,400033,25.62545,1561077
31102,vinnybad,1,0.00006,400034,25.62551,1561077
31103,Vinodlatha,1,0.00006,400035,25.62558,1561077
31104,vinogradoff,1,0.00006,400036,25.62564,1561077
31105,vinogradovs,1,0.00006,400037,25.62571,1561077
31106,vinothkumar437,1,0.00006,400038,25.62577,1561077
31107,VintageMo,1,0.00006,400039,25.62583,1561077
31108,Vinutha-Garimella,1,0.00006,400040,25.62590,1561077
31109,violin8668,1,0.00006,400041,25.62596,1561077
31110,vip20,1,0.00006,400042,25.62603,1561077
31111,vippakay,1,0.00006,400043,25.62609,1561077
31112,viraj-levelops,1,0.00006,400044,25.62615,1561077
31113,viren1500,1,0.00006,400045,25.62622,1561077
31114,VireshDoshi,1,0.00006,400046,25.62628,1561077
31115,VirgiliusMaximus,1,0.00006,400047,25.62635,1561077
31116,viriatis,1,0.00006,400048,25.62641,1561077
31117,viroos,1,0.00006,400049,25.62647,1561077
31118,VirtuallyScott,1,0.00006,400050,25.62654,1561077
31119,virtualmarc,1,0.00006,400051,25.62660,1561077
31120,visAnu17,1,0.00006,400052,25.62667,1561077
31121,visarya,1,0.00006,400053,25.62673,1561077
31122,vishalkuo,1,0.00006,400054,25.62679,1561077
31123,vishalsharmaind,1,0.00006,400055,25.62686,1561077
31124,vishnucr09,1,0.00006,400056,25.62692,1561077
31125,vishwakhrushi,1,0.00006,400057,25.62699,1561077
31126,vishwanathcs,1,0.00006,400058,25.62705,1561077
31127,vishy279,1,0.00006,400059,25.62712,1561077
31128,VISTALL,1,0.00006,400060,25.62718,1561077
31129,visuman,1,0.00006,400061,25.62724,1561077
31130,vitaliiprotsenko,1,0.00006,400062,25.62731,1561077
31131,vitaly-zdanevich,1,0.00006,400063,25.62737,1561077
31132,vitaminj,1,0.00006,400064,25.62744,1561077
31133,vitebski,1,0.00006,400065,25.62750,1561077
31134,vitomanu96,1,0.00006,400066,25.62756,1561077
31135,vitopn,1,0.00006,400067,25.62763,1561077
31136,vitorhas,1,0.00006,400068,25.62769,1561077
31137,vitorjordao,1,0.00006,400069,25.62776,1561077
31138,Vitorspk,1,0.00006,400070,25.62782,1561077
31139,VivaLaRobo,1,0.00006,400071,25.62788,1561077
31140,vivekmogili-avetta,1,0.00006,400072,25.62795,1561077
31141,vivelys,1,0.00006,400073,25.62801,1561077
31142,vivi2050,1,0.00006,400074,25.62808,1561077
31143,viviancpy,1,0.00006,400075,25.62814,1561077
31144,vivid-lukeloresch,1,0.00006,400076,25.62820,1561077
31145,viyancs,1,0.00006,400077,25.62827,1561077
31146,vizsatiz,1,0.00006,400078,25.62833,1561077
31147,VJ-2040,1,0.00006,400079,25.62840,1561077
31148,vjeffz,1,0.00006,400080,25.62846,1561077
31149,vjestin,1,0.00006,400081,25.62852,1561077
31150,vjkri,1,0.00006,400082,25.62859,1561077
31151,vjmomidi,1,0.00006,400083,25.62865,1561077
31152,vjrj,1,0.00006,400084,25.62872,1561077
31153,vjsandu,1,0.00006,400085,25.62878,1561077
31154,vkovalenk0,1,0.00006,400086,25.62884,1561077
31155,vkropotko,1,0.00006,400087,25.62891,1561077
31156,vkryzh,1,0.00006,400088,25.62897,1561077
31157,Vlad1mir-D,1,0.00006,400089,25.62904,1561077
31158,vlad2,1,0.00006,400090,25.62910,1561077
31159,vlad-bura,1,0.00006,400091,25.62916,1561077
31160,Vladimir-csp,1,0.00006,400092,25.62923,1561077
31161,VladimirIordanov,1,0.00006,400093,25.62929,1561077
31162,VladToporkov,1,0.00006,400094,25.62936,1561077
31163,vlad-tuznichenko,1,0.00006,400095,25.62942,1561077
31164,Vladyslav-Miletskyi,1,0.00006,400096,25.62949,1561077
31165,vlavicka,1,0.00006,400097,25.62955,1561077
31166,vlaza,1,0.00006,400098,25.62961,1561077
31167,vld-mh,1,0.00006,400099,25.62968,1561077
31168,vlingfu,1,0.00006,400100,25.62974,1561077
31169,vlokesh09,1,0.00006,400101,25.62981,1561077
31170,vm31,1,0.00006,400102,25.62987,1561077
31171,vmaurin,1,0.00006,400103,25.62993,1561077
31172,vmendis-stash,1,0.00006,400104,25.63000,1561077
31173,vmoravec,1,0.00006,400105,25.63006,1561077
31174,vnadgir-ef,1,0.00006,400106,25.63013,1561077
31175,vodik,1,0.00006,400107,25.63019,1561077
31176,Vodrech,1,0.00006,400108,25.63025,1561077
31177,volkangurel,1,0.00006,400109,25.63032,1561077
31178,volker-fr,1,0.00006,400110,25.63038,1561077
31179,volkovs,1,0.00006,400111,25.63045,1561077
31180,Volodjam,1,0.00006,400112,25.63051,1561077
31181,volserverRay,1,0.00006,400113,25.63057,1561077
31182,volvo-ritte,1,0.00006,400114,25.63064,1561077
31183,VolvoxGlobator,1,0.00006,400115,25.63070,1561077
31184,volym3ad,1,0.00006,400116,25.63077,1561077
31185,voneiden,1,0.00006,400117,25.63083,1561077
31186,vonEvil,1,0.00006,400118,25.63089,1561077
31187,vonkdoth-solutions,1,0.00006,400119,25.63096,1561077
31188,VonUniGE,1,0.00006,400120,25.63102,1561077
31189,Voolkanus,1,0.00006,400121,25.63109,1561077
31190,vorktanamobay,1,0.00006,400122,25.63115,1561077
31191,vospascal,1,0.00006,400123,25.63121,1561077
31192,vp131,1,0.00006,400124,25.63128,1561077
31193,vpbobade,1,0.00006,400125,25.63134,1561077
31194,vpierson,1,0.00006,400126,25.63141,1561077
31195,vpod,1,0.00006,400127,25.63147,1561077
31196,vpolice3,1,0.00006,400128,25.63154,1561077
31197,vpolischuk,1,0.00006,400129,25.63160,1561077
31198,vramanlal,1,0.00006,400130,25.63166,1561077
31199,vrazhagunila,1,0.00006,400131,25.63173,1561077
31200,Vrishabh55,1,0.00006,400132,25.63179,1561077
31201,vrommer,1,0.00006,400133,25.63186,1561077
31202,vrotenberg1,1,0.00006,400134,25.63192,1561077
31203,vrozov,1,0.00006,400135,25.63198,1561077
31204,vrsomisetty,1,0.00006,400136,25.63205,1561077
31205,vrushti-mody,1,0.00006,400137,25.63211,1561077
31206,vsachinv,1,0.00006,400138,25.63218,1561077
31207,VsegdaZhivoj,1,0.00006,400139,25.63224,1561077
31208,vsevolod-fedorov,1,0.00006,400140,25.63230,1561077
31209,vsoloviov,1,0.00006,400141,25.63237,1561077
31210,vsoteriou,1,0.00006,400142,25.63243,1561077
31211,vsrd13,1,0.00006,400143,25.63250,1561077
31212,vss96,1,0.00006,400144,25.63256,1561077
31213,vstars,1,0.00006,400145,25.63262,1561077
31214,vstaykov,1,0.00006,400146,25.63269,1561077
31215,vstrizaks,1,0.00006,400147,25.63275,1561077
31216,Vstural,1,0.00006,400148,25.63282,1561077
31217,vtajzich,1,0.00006,400149,25.63288,1561077
31218,v-theo,1,0.00006,400150,25.63294,1561077
31219,vtomasr5,1,0.00006,400151,25.63301,1561077
31220,vtwaldo21,1,0.00006,400152,25.63307,1561077
31221,vuongmao,1,0.00006,400153,25.63314,1561077
31222,Vuwij,1,0.00006,400154,25.63320,1561077
31223,vvaka,1,0.00006,400155,25.63326,1561077
31224,vvalderrv,1,0.00006,400156,25.63333,1561077
31225,vvatlin,1,0.00006,400157,25.63339,1561077
31226,vvchik,1,0.00006,400158,25.63346,1561077
31227,vvijayalakshmi21,1,0.00006,400159,25.63352,1561077
31228,vvranjek,1,0.00006,400160,25.63359,1561077
31229,vvs-vmg,1,0.00006,400161,25.63365,1561077
31230,vwin,1,0.00006,400162,25.63371,1561077
31231,vxe,1,0.00006,400163,25.63378,1561077
31232,vyask,1,0.00006,400164,25.63384,1561077
31233,vyepishov,1,0.00006,400165,25.63391,1561077
31234,Vyrnos,1,0.00006,400166,25.63397,1561077
31235,vyshakprojects,1,0.00006,400167,25.63403,1561077
31236,vytis,1,0.00006,400168,25.63410,1561077
31237,vzhyvyy,1,0.00006,400169,25.63416,1561077
31238,w00d,1,0.00006,400170,25.63423,1561077
31239,w0418,1,0.00006,400171,25.63429,1561077
31240,w0rp,1,0.00006,400172,25.63435,1561077
31241,w3blogfr,1,0.00006,400173,25.63442,1561077
31242,w3dman,1,0.00006,400174,25.63448,1561077
31243,waderobson,1,0.00006,400175,25.63455,1561077
31244,waedekin,1,0.00006,400176,25.63461,1561077
31245,wagnst,1,0.00006,400177,25.63467,1561077
31246,wagst,1,0.00006,400178,25.63474,1561077
31247,Wajeed-msft,1,0.00006,400179,25.63480,1561077
31248,WaldenL,1,0.00006,400180,25.63487,1561077
31249,WaldronYou,1,0.00006,400181,25.63493,1561077
31250,waleedali,1,0.00006,400182,25.63499,1561077
31251,waleedurehman,1,0.00006,400183,25.63506,1561077
31252,walkerlala,1,0.00006,400184,25.63512,1561077
31253,walkermundo,1,0.00006,400185,25.63519,1561077
31254,walkline,1,0.00006,400186,25.63525,1561077
31255,Wallace-EXE,1,0.00006,400187,25.63531,1561077
31256,wallali,1,0.00006,400188,25.63538,1561077
31257,wallhided,1,0.00006,400189,25.63544,1561077
31258,WalrusArtist,1,0.00006,400190,25.63551,1561077
31259,walsw,1,0.00006,400191,25.63557,1561077
31260,Walter-Gates-Bose,1,0.00006,400192,25.63563,1561077
31261,walthhy,1,0.00006,400193,25.63570,1561077
31262,wamaral,1,0.00006,400194,25.63576,1561077
31263,wanAll,1,0.00006,400195,25.63583,1561077
31264,wand3r3r,1,0.00006,400196,25.63589,1561077
31265,wandenberg,1,0.00006,400197,25.63596,1561077
31266,wangeDear,1,0.00006,400198,25.63602,1561077
31267,WangFeiwu,1,0.00006,400199,25.63608,1561077
31268,wangguang2112,1,0.00006,400200,25.63615,1561077
31269,wanghy8166,1,0.00006,400201,25.63621,1561077
31270,wangjia2016,1,0.00006,400202,25.63628,1561077
31271,wangjingfei,1,0.00006,400203,25.63634,1561077
31272,wangkepermit,1,0.00006,400204,25.63640,1561077
31273,wangmengqiang001,1,0.00006,400205,25.63647,1561077
31274,WangMingJue,1,0.00006,400206,25.63653,1561077
31275,wangqingjiewa,1,0.00006,400207,25.63660,1561077
31276,wangqr,1,0.00006,400208,25.63666,1561077
31277,wangrongding,1,0.00006,400209,25.63672,1561077
31278,wangrongjun,1,0.00006,400210,25.63679,1561077
31279,wangting66,1,0.00006,400211,25.63685,1561077
31280,wangwei0326,1,0.00006,400212,25.63692,1561077
31281,wangyong001,1,0.00006,400213,25.63698,1561077
31282,wangyoucao577,1,0.00006,400214,25.63704,1561077
31283,wangyuesong0,1,0.00006,400215,25.63711,1561077
31284,wannadream,1,0.00006,400216,25.63717,1561077
31285,wanpengfei-git,1,0.00006,400217,25.63724,1561077
31286,Warchant,1,0.00006,400218,25.63730,1561077
31287,wardiablo,1,0.00006,400219,25.63736,1561077
31288,wardvl,1,0.00006,400220,25.63743,1561077
31289,warmbeach,1,0.00006,400221,25.63749,1561077
31290,washingtoneg,1,0.00006,400222,25.63756,1561077
31291,wassimbelmezouar,1,0.00006,400223,25.63762,1561077
31292,wassy92x,1,0.00006,400224,25.63768,1561077
31293,waterdrops,1,0.00006,400225,25.63775,1561077
31294,waterings,1,0.00006,400226,25.63781,1561077
31295,watsoncj,1,0.00006,400227,25.63788,1561077
31296,watsonkzn,1,0.00006,400228,25.63794,1561077
31297,Wattos,1,0.00006,400229,25.63801,1561077
31298,wattwood,1,0.00006,400230,25.63807,1561077
31299,wavded,1,0.00006,400231,25.63813,1561077
31300,wawastein,1,0.00006,400232,25.63820,1561077
31301,waynew,1,0.00006,400233,25.63826,1561077
31302,wcahillmanley,1,0.00006,400234,25.63833,1561077
31303,wchen9911,1,0.00006,400235,25.63839,1561077
31304,wdalmut,1,0.00006,400236,25.63845,1561077
31305,wdgang,1,0.00006,400237,25.63852,1561077
31306,wdlaszlo,1,0.00006,400238,25.63858,1561077
31307,wdvr,1,0.00006,400239,25.63865,1561077
31308,wdy0719,1,0.00006,400240,25.63871,1561077
31309,webark,1,0.00006,400241,25.63877,1561077
31310,webartoli,1,0.00006,400242,25.63884,1561077
31311,WebDmitryPetrov,1,0.00006,400243,25.63890,1561077
31312,webfeature,1,0.00006,400244,25.63897,1561077
31313,webventil,1,0.00006,400245,25.63903,1561077
31314,WeekL,1,0.00006,400246,25.63909,1561077
31315,weeniearms,1,0.00006,400247,25.63916,1561077
31316,weidonglian,1,0.00006,400248,25.63922,1561077
31317,weiluxianche,1,0.00006,400249,25.63929,1561077
31318,we-infra,1,0.00006,400250,25.63935,1561077
31319,weirdbiz,1,0.00006,400251,25.63941,1561077
31320,weirdninja,1,0.00006,400252,25.63948,1561077
31321,weiwc,1,0.00006,400253,25.63954,1561077
31322,wemb06,1,0.00006,400254,25.63961,1561077
31323,wemu,1,0.00006,400255,25.63967,1561077
31324,wenbobao,1,0.00006,400256,25.63973,1561077
31325,wengm,1,0.00006,400257,25.63980,1561077
31326,wenhao,1,0.00006,400258,25.63986,1561077
31327,werthen,1,0.00006,400259,25.63993,1561077
31328,wes566,1,0.00006,400260,25.63999,1561077
31329,wesleung,1,0.00006,400261,25.64005,1561077
31330,wesleysee,1,0.00006,400262,25.64012,1561077
31331,wesleyxcooper,1,0.00006,400263,25.64018,1561077
31332,westhusing,1,0.00006,400264,25.64025,1561077
31333,weyCC81,1,0.00006,400265,25.64031,1561077
31334,weynhamz,1,0.00006,400266,25.64038,1561077
31335,wfairclough,1,0.00006,400267,25.64044,1561077
31336,wfee,1,0.00006,400268,25.64050,1561077
31337,wfreemanben,1,0.00006,400269,25.64057,1561077
31338,wfwf1990,1,0.00006,400270,25.64063,1561077
31339,wfxr,1,0.00006,400271,25.64070,1561077
31340,wgabsi88,1,0.00006,400272,25.64076,1561077
31341,wgku,1,0.00006,400273,25.64082,1561077
31342,wgoraciy,1,0.00006,400274,25.64089,1561077
31343,wgreven-ibr,1,0.00006,400275,25.64095,1561077
31344,wguzgg,1,0.00006,400276,25.64102,1561077
31345,wheatgrinder,1,0.00006,400277,25.64108,1561077
31346,WhiskeyDev,1,0.00006,400278,25.64114,1561077
31347,whitbreadapps,1,0.00006,400279,25.64121,1561077
31348,whoisjake,1,0.00006,400280,25.64127,1561077
31349,whoissqr,1,0.00006,400281,25.64134,1561077
31350,wholegale39,1,0.00006,400282,25.64140,1561077
31351,whr845736938,1,0.00006,400283,25.64146,1561077
31352,whuang12345,1,0.00006,400284,25.64153,1561077
31353,whytewolf,1,0.00006,400285,25.64159,1561077
31354,wI2L,1,0.00006,400286,25.64166,1561077
31355,WianVos,1,0.00006,400287,25.64172,1561077
31356,wico,1,0.00006,400288,25.64178,1561077
31357,widgetpl,1,0.00006,400289,25.64185,1561077
31358,wiebe,1,0.00006,400290,25.64191,1561077
31359,wiedsche,1,0.00006,400291,25.64198,1561077
31360,wigglyampsltd,1,0.00006,400292,25.64204,1561077
31361,wildgarden499,1,0.00006,400293,25.64210,1561077
31362,wileyj,1,0.00006,400294,25.64217,1561077
31363,wilkko,1,0.00006,400295,25.64223,1561077
31364,willbengtson,1,0.00006,400296,25.64230,1561077
31365,willcrain1,1,0.00006,400297,25.64236,1561077
31366,willerpp,1,0.00006,400298,25.64243,1561077
31367,willfarrell,1,0.00006,400299,25.64249,1561077
31368,willgriffin,1,0.00006,400300,25.64255,1561077
31369,William1Wu,1,0.00006,400301,25.64262,1561077
31370,williamstorres,1,0.00006,400302,25.64268,1561077
31371,williamweckl,1,0.00006,400303,25.64275,1561077
31372,WilliamWhelan,1,0.00006,400304,25.64281,1561077
31373,williancolognesitrimble,1,0.00006,400305,25.64287,1561077
31374,willieowens,1,0.00006,400306,25.64294,1561077
31375,willisjtc,1,0.00006,400307,25.64300,1561077
31376,willitscale,1,0.00006,400308,25.64307,1561077
31377,WilliZilliW,1,0.00006,400309,25.64313,1561077
31378,Will-N3t,1,0.00006,400310,25.64319,1561077
31379,will-nolan,1,0.00006,400311,25.64326,1561077
31380,willrichboa,1,0.00006,400312,25.64332,1561077
31381,will-sterling,1,0.00006,400313,25.64339,1561077
31382,willtorres,1,0.00006,400314,25.64345,1561077
31383,willychase,1,0.00006,400315,25.64351,1561077
31384,willyg,1,0.00006,400316,25.64358,1561077
31385,willynx,1,0.00006,400317,25.64364,1561077
31386,wilsn45,1,0.00006,400318,25.64371,1561077
31387,wilsongee,1,0.00006,400319,25.64377,1561077
31388,wimglenn,1,0.00006,400320,25.64383,1561077
31389,wimleers,1,0.00006,400321,25.64390,1561077
31390,wimnat,1,0.00006,400322,25.64396,1561077
31391,wimvr,1,0.00006,400323,25.64403,1561077
31392,Wing924,1,0.00006,400324,25.64409,1561077
31393,WinJayX,1,0.00006,400325,25.64415,1561077
31394,winlamevite,1,0.00006,400326,25.64422,1561077
31395,winstonriley,1,0.00006,400327,25.64428,1561077
31396,winstonsimon,1,0.00006,400328,25.64435,1561077
31397,WinterBear,1,0.00006,400329,25.64441,1561077
31398,winterwd,1,0.00006,400330,25.64447,1561077
31399,winzaa123,1,0.00006,400331,25.64454,1561077
31400,wirdman,1,0.00006,400332,25.64460,1561077
31401,wissemwis,1,0.00006,400333,25.64467,1561077
31402,wisting967,1,0.00006,400334,25.64473,1561077
31403,withgod,1,0.00006,400335,25.64480,1561077
31404,witterholt,1,0.00006,400336,25.64486,1561077
31405,wittjosiah,1,0.00006,400337,25.64492,1561077
31406,wizard-xie,1,0.00006,400338,25.64499,1561077
31407,wjcaitu,1,0.00006,400339,25.64505,1561077
31408,wjkw1,1,0.00006,400340,25.64512,1561077
31409,wjohnson8,1,0.00006,400341,25.64518,1561077
31410,wjstk16,1,0.00006,400342,25.64524,1561077
31411,wkjwjrantrzk,1,0.00006,400343,25.64531,1561077
31412,wkokolis,1,0.00006,400344,25.64537,1561077
31413,WKoopa,1,0.00006,400345,25.64544,1561077
31414,wktmeow,1,0.00006,400346,25.64550,1561077
31415,wlayzer,1,0.00006,400347,25.64556,1561077
31416,wlbentz,1,0.00006,400348,25.64563,1561077
31417,Wld1122,1,0.00006,400349,25.64569,1561077
31418,wlfshmn,1,0.00006,400350,25.64576,1561077
31419,wlisikpl,1,0.00006,400351,25.64582,1561077
31420,wll-zhou,1,0.00006,400352,25.64588,1561077
31421,wlmvp,1,0.00006,400353,25.64595,1561077
31422,w-marco,1,0.00006,400354,25.64601,1561077
31423,wmdev0808,1,0.00006,400355,25.64608,1561077
31424,wmedford,1,0.00006,400356,25.64614,1561077
31425,wmeeus,1,0.00006,400357,25.64620,1561077
31426,WMwezAAq,1,0.00006,400358,25.64627,1561077
31427,woberle,1,0.00006,400359,25.64633,1561077
31428,wodog1,1,0.00006,400360,25.64640,1561077
31429,Wojciechem,1,0.00006,400361,25.64646,1561077
31430,wokinger,1,0.00006,400362,25.64652,1561077
31431,wolfishsoul,1,0.00006,400363,25.64659,1561077
31432,Wolvenmoon,1,0.00006,400364,25.64665,1561077
31433,WolverMinion,1,0.00006,400365,25.64672,1561077
31434,wonderchang,1,0.00006,400366,25.64678,1561077
31435,wontonst,1,0.00006,400367,25.64685,1561077
31436,WoodenDoors,1,0.00006,400368,25.64691,1561077
31437,Woodpeker,1,0.00006,400369,25.64697,1561077
31438,woodshop2300,1,0.00006,400370,25.64704,1561077
31439,woody3000,1,0.00006,400371,25.64710,1561077
31440,wooseung-sim,1,0.00006,400372,25.64717,1561077
31441,workabhaswadhwa,1,0.00006,400373,25.64723,1561077
31442,worldjoe,1,0.00006,400374,25.64729,1561077
31443,worroc,1,0.00006,400375,25.64736,1561077
31444,woscostametaxa,1,0.00006,400376,25.64742,1561077
31445,wottah,1,0.00006,400377,25.64749,1561077
31446,WPCleaner,1,0.00006,400378,25.64755,1561077
31447,wp-davisona,1,0.00006,400379,25.64761,1561077
31448,wpride,1,0.00006,400380,25.64768,1561077
31449,wrenashe,1,0.00006,400381,25.64774,1561077
31450,wrjp,1,0.00006,400382,25.64781,1561077
31451,wrossmck,1,0.00006,400383,25.64787,1561077
31452,wroujoulah,1,0.00006,400384,25.64793,1561077
31453,wrvdklooster,1,0.00006,400385,25.64800,1561077
31454,wshager,1,0.00006,400386,25.64806,1561077
31455,wsialex,1,0.00006,400387,25.64813,1561077
31456,wsilva-gpfw,1,0.00006,400388,25.64819,1561077
31457,wsj0000,1,0.00006,400389,25.64825,1561077
31458,WSquared,1,0.00006,400390,25.64832,1561077
31459,wtanner,1,0.00006,400391,25.64838,1561077
31460,wtlinnertz,1,0.00006,400392,25.64845,1561077
31461,WTPascoe,1,0.00006,400393,25.64851,1561077
31462,wtschreiter,1,0.00006,400394,25.64857,1561077
31463,wtwde,1,0.00006,400395,25.64864,1561077
31464,wu105,1,0.00006,400396,25.64870,1561077
31465,wubin-ericsson,1,0.00006,400397,25.64877,1561077
31466,wudong,1,0.00006,400398,25.64883,1561077
31467,wulinghui,1,0.00006,400399,25.64889,1561077
31468,wunaidage,1,0.00006,400400,25.64896,1561077
31469,wusel42,1,0.00006,400401,25.64902,1561077
31470,wutb15,1,0.00006,400402,25.64909,1561077
31471,wutongjie23hao,1,0.00006,400403,25.64915,1561077
31472,wuwu2000,1,0.00006,400404,25.64922,1561077
31473,wuyongdec,1,0.00006,400405,25.64928,1561077
31474,wuyuanchao,1,0.00006,400406,25.64934,1561077
31475,wu-yun,1,0.00006,400407,25.64941,1561077
31476,wuzhaozhongguo,1,0.00006,400408,25.64947,1561077
31477,wuzhengxuan,1,0.00006,400409,25.64954,1561077
31478,wuzhike666,1,0.00006,400410,25.64960,1561077
31479,wuzhongwu,1,0.00006,400411,25.64966,1561077
31480,ww156,1,0.00006,400412,25.64973,1561077
31481,wwadge,1,0.00006,400413,25.64979,1561077
31482,wwasser,1,0.00006,400414,25.64986,1561077
31483,wwhurley,1,0.00006,400415,25.64992,1561077
31484,wwitteriii,1,0.00006,400416,25.64998,1561077
31485,wwkimball,1,0.00006,400417,25.65005,1561077
31486,www-yyy-1,1,0.00006,400418,25.65011,1561077
31487,wy131246,1,0.00006,400419,25.65018,1561077
31488,wyattjsmith1,1,0.00006,400420,25.65024,1561077
31489,wyfaq,1,0.00006,400421,25.65030,1561077
31490,wynandvanwyk,1,0.00006,400422,25.65037,1561077
31491,wy-z,1,0.00006,400423,25.65043,1561077
31492,wzhang111,1,0.00006,400424,25.65050,1561077
31493,wzooff,1,0.00006,400425,25.65056,1561077
31494,wzprichardwzp,1,0.00006,400426,25.65062,1561077
31495,x10mrrobot01x,1,0.00006,400427,25.65069,1561077
31496,X-7r3em,1,0.00006,400428,25.65075,1561077
31497,x86,1,0.00006,400429,25.65082,1561077
31498,xach,1,0.00006,400430,25.65088,1561077
31499,xait-arne-trodahl,1,0.00006,400431,25.65094,1561077
31500,xaithe,1,0.00006,400432,25.65101,1561077
31501,Xander567,1,0.00006,400433,25.65107,1561077
31502,xandi404,1,0.00006,400434,25.65114,1561077
31503,Xarthisius,1,0.00006,400435,25.65120,1561077
31504,xavierbourguignon,1,0.00006,400436,25.65127,1561077
31505,xavier-calland,1,0.00006,400437,25.65133,1561077
31506,xavierivadulla,1,0.00006,400438,25.65139,1561077
31507,xbombev,1,0.00006,400439,25.65146,1561077
31508,xCharg,1,0.00006,400440,25.65152,1561077
31509,xcorpio,1,0.00006,400441,25.65159,1561077
31510,XD-DENG,1,0.00006,400442,25.65165,1561077
31511,xdubx,1,0.00006,400443,25.65171,1561077
31512,xdzmkus,1,0.00006,400444,25.65178,1561077
31513,xecutioner,1,0.00006,400445,25.65184,1561077
31514,xela-jm,1,0.00006,400446,25.65191,1561077
31515,xenjke,1,0.00006,400447,25.65197,1561077
31516,xeongm,1,0.00006,400448,25.65203,1561077
31517,xero88,1,0.00006,400449,25.65210,1561077
31518,xeryany,1,0.00006,400450,25.65216,1561077
31519,Xexiz,1,0.00006,400451,25.65223,1561077
31520,xfreebird,1,0.00006,400452,25.65229,1561077
31521,xgear-public,1,0.00006,400453,25.65235,1561077
31522,xgeoff,1,0.00006,400454,25.65242,1561077
31523,xgin,1,0.00006,400455,25.65248,1561077
31524,xgy560501,1,0.00006,400456,25.65255,1561077
31525,xhuang-hulu,1,0.00006,400457,25.65261,1561077
31526,xiahuai,1,0.00006,400458,25.65267,1561077
31527,xianfengsong,1,0.00006,400459,25.65274,1561077
31528,xianshenglu,1,0.00006,400460,25.65280,1561077
31529,xianxiaoyin,1,0.00006,400461,25.65287,1561077
31530,xiaobeon,1,0.00006,400462,25.65293,1561077
31531,xiaocode,1,0.00006,400463,25.65299,1561077
31532,xiaod0510,1,0.00006,400464,25.65306,1561077
31533,XiaoduLiu,1,0.00006,400465,25.65312,1561077
31534,XiaohanLiang,1,0.00006,400466,25.65319,1561077
31535,xiaojia1203,1,0.00006,400467,25.65325,1561077
31536,xiaojias,1,0.00006,400468,25.65331,1561077
31537,xiaomingkou,1,0.00006,400469,25.65338,1561077
31538,xiaosaysh,1,0.00006,400470,25.65344,1561077
31539,xiaotian45123,1,0.00006,400471,25.65351,1561077
31540,XiaotongLi0709-Houzz,1,0.00006,400472,25.65357,1561077
31541,xiayang-126,1,0.00006,400473,25.65364,1561077
31542,xiayingfeng,1,0.00006,400474,25.65370,1561077
31543,xicombd,1,0.00006,400475,25.65376,1561077
31544,xiedaibin,1,0.00006,400476,25.65383,1561077
31545,xieshaoping,1,0.00006,400477,25.65389,1561077
31546,xificurC,1,0.00006,400478,25.65396,1561077
31547,xiii,1,0.00006,400479,25.65402,1561077
31548,xike41,1,0.00006,400480,25.65408,1561077
31549,ximarx,1,0.00006,400481,25.65415,1561077
31550,xinatcg,1,0.00006,400482,25.65421,1561077
31551,xingducai,1,0.00006,400483,25.65428,1561077
31552,xinnj,1,0.00006,400484,25.65434,1561077
31553,xinzx,1,0.00006,400485,25.65440,1561077
31554,xitrumm,1,0.00006,400486,25.65447,1561077
31555,xitter,1,0.00006,400487,25.65453,1561077
31556,xiujuez,1,0.00006,400488,25.65460,1561077
31557,xiuxiumomo,1,0.00006,400489,25.65466,1561077
31558,xjiaon,1,0.00006,400490,25.65472,1561077
31559,xjjx,1,0.00006,400491,25.65479,1561077
31560,xjlight,1,0.00006,400492,25.65485,1561077
31561,xkcoding,1,0.00006,400493,25.65492,1561077
31562,xlab,1,0.00006,400494,25.65498,1561077
31563,xmeng1,1,0.00006,400495,25.65504,1561077
31564,xmj,1,0.00006,400496,25.65511,1561077
31565,xMort,1,0.00006,400497,25.65517,1561077
31566,xnulinu,1,0.00006,400498,25.65524,1561077
31567,xnYi9wRezm,1,0.00006,400499,25.65530,1561077
31568,xob,1,0.00006,400500,25.65536,1561077
31569,xoco70,1,0.00006,400501,25.65543,1561077
31570,xolantumy,1,0.00006,400502,25.65549,1561077
31571,XonqNopp,1,0.00006,400503,25.65556,1561077
31572,xpxrzerr,1,0.00006,400504,25.65562,1561077
31573,xs2bharat,1,0.00006,400505,25.65569,1561077
31574,xsacha,1,0.00006,400506,25.65575,1561077
31575,xsautejeau,1,0.00006,400507,25.65581,1561077
31576,xsof115,1,0.00006,400508,25.65588,1561077
31577,xtcel,1,0.00006,400509,25.65594,1561077
31578,xtroce,1,0.00006,400510,25.65601,1561077
31579,xtroncode,1,0.00006,400511,25.65607,1561077
31580,XuSummer,1,0.00006,400512,25.65613,1561077
31581,xwlee,1,0.00006,400513,25.65620,1561077
31582,xxbandy,1,0.00006,400514,25.65626,1561077
31583,xXNbKXx,1,0.00006,400515,25.65633,1561077
31584,xXpc-freakXx,1,0.00006,400516,25.65639,1561077
31585,xxxbobrxxx,1,0.00006,400517,25.65645,1561077
31586,XXXdimaka,1,0.00006,400518,25.65652,1561077
31587,xxxifan,1,0.00006,400519,25.65658,1561077
31588,xxyuk,1,0.00006,400520,25.65665,1561077
31589,xyan0607,1,0.00006,400521,25.65671,1561077
31590,x-yuri,1,0.00006,400522,25.65677,1561077
31591,xzhorikx,1,0.00006,400523,25.65684,1561077
31592,Y0lan,1,0.00006,400524,25.65690,1561077
31593,y0n1,1,0.00006,400525,25.65697,1561077
31594,yaariyuval,1,0.00006,400526,25.65703,1561077
31595,yachub,1,0.00006,400527,25.65709,1561077
31596,YaelZav,1,0.00006,400528,25.65716,1561077
31597,yagiel,1,0.00006,400529,25.65722,1561077
31598,yagilm,1,0.00006,400530,25.65729,1561077
31599,yahiakhidr,1,0.00006,400531,25.65735,1561077
31600,yahman72,1,0.00006,400532,25.65741,1561077
31601,yairogen,1,0.00006,400533,25.65748,1561077
31602,yairyog,1,0.00006,400534,25.65754,1561077
31603,Yakha,1,0.00006,400535,25.65761,1561077
31604,yakhyadabo,1,0.00006,400536,25.65767,1561077
31605,yakirtzad,1,0.00006,400537,25.65774,1561077
31606,yakobe,1,0.00006,400538,25.65780,1561077
31607,yalopov,1,0.00006,400539,25.65786,1561077
31608,Yamaha32088,1,0.00006,400540,25.65793,1561077
31609,yamazakei321,1,0.00006,400541,25.65799,1561077
31610,yamenk,1,0.00006,400542,25.65806,1561077
31611,yamitsilv,1,0.00006,400543,25.65812,1561077
31612,yanaair,1,0.00006,400544,25.65818,1561077
31613,yanaki,1,0.00006,400545,25.65825,1561077
31614,yancs,1,0.00006,400546,25.65831,1561077
31615,yandemontreal,1,0.00006,400547,25.65838,1561077
31616,yanfulei,1,0.00006,400548,25.65844,1561077
31617,yang837157632,1,0.00006,400549,25.65850,1561077
31618,yangfan0095,1,0.00006,400550,25.65857,1561077
31619,yangkailc,1,0.00006,400551,25.65863,1561077
31620,yang-ling,1,0.00006,400552,25.65870,1561077
31621,yangquan1982,1,0.00006,400553,25.65876,1561077
31622,yangshuhao,1,0.00006,400554,25.65882,1561077
31623,yangtadasd,1,0.00006,400555,25.65889,1561077
31624,yangweijie,1,0.00006,400556,25.65895,1561077
31625,yangzhiwei256,1,0.00006,400557,25.65902,1561077
31626,yani-,1,0.00006,400558,25.65908,1561077
31627,yanlinux,1,0.00006,400559,25.65914,1561077
31628,yannickeboo,1,0.00006,400560,25.65921,1561077
31629,YannickteK,1,0.00006,400561,25.65927,1561077
31630,YannikSue,1,0.00006,400562,25.65934,1561077
31631,yannmontp,1,0.00006,400563,25.65940,1561077
31632,yanxiaochuan,1,0.00006,400564,25.65946,1561077
31633,YaoJie82,1,0.00006,400565,25.65953,1561077
31634,yaseenexists,1,0.00006,400566,25.65959,1561077
31635,yaseensec,1,0.00006,400567,25.65966,1561077
31636,Yashas93,1,0.00006,400568,25.65972,1561077
31637,yashhjaggi1998,1,0.00006,400569,25.65978,1561077
31638,yashi27-27,1,0.00006,400570,25.65985,1561077
31639,YashkevichArtem,1,0.00006,400571,25.65991,1561077
31640,YashPethe,1,0.00006,400572,25.65998,1561077
31641,YashSalve695,1,0.00006,400573,25.66004,1561077
31642,yashu23,1,0.00006,400574,25.66011,1561077
31643,yava-ua,1,0.00006,400575,25.66017,1561077
31644,yavrumian,1,0.00006,400576,25.66023,1561077
31645,yavuzd,1,0.00006,400577,25.66030,1561077
31646,yayachiken,1,0.00006,400578,25.66036,1561077
31647,Yayo-Arellano,1,0.00006,400579,25.66043,1561077
31648,yaytul,1,0.00006,400580,25.66049,1561077
31649,yazeng,1,0.00006,400581,25.66055,1561077
31650,ybdesire,1,0.00006,400582,25.66062,1561077
31651,ychaudhari,1,0.00006,400583,25.66068,1561077
31652,ycjonlin,1,0.00006,400584,25.66075,1561077
31653,yedaodao,1,0.00006,400585,25.66081,1561077
31654,yegeniy,1,0.00006,400586,25.66087,1561077
31655,yeikel,1,0.00006,400587,25.66094,1561077
31656,yejianbing01,1,0.00006,400588,25.66100,1561077
31657,yeka,1,0.00006,400589,25.66107,1561077
31658,yekanchi,1,0.00006,400590,25.66113,1561077
31659,yellowstone-bbc,1,0.00006,400591,25.66119,1561077
31660,yellow-straw-hat,1,0.00006,400592,25.66126,1561077
31661,yemkay,1,0.00006,400593,25.66132,1561077
31662,yenoiwesa,1,0.00006,400594,25.66139,1561077
31663,YeonSeoMom,1,0.00006,400595,25.66145,1561077
31664,yerenkow,1,0.00006,400596,25.66151,1561077
31665,YeruchamB,1,0.00006,400597,25.66158,1561077
31666,yetanotherbug,1,0.00006,400598,25.66164,1561077
31667,yevgeniyo,1,0.00006,400599,25.66171,1561077
31668,yevgenytr,1,0.00006,400600,25.66177,1561077
31669,YevheniiPokhvalii,1,0.00006,400601,25.66183,1561077
31670,yewenhai99999,1,0.00006,400602,25.66190,1561077
31671,yfolias,1,0.00006,400603,25.66196,1561077
31672,Yiadh,1,0.00006,400604,25.66203,1561077
31673,yidasanqian,1,0.00006,400605,25.66209,1561077
31674,yigalg,1,0.00006,400606,25.66216,1561077
31675,yilativs,1,0.00006,400607,25.66222,1561077
31676,yildiraymeric,1,0.00006,400608,25.66228,1561077
31677,yi-lu,1,0.00006,400609,25.66235,1561077
31678,yimity,1,0.00006,400610,25.66241,1561077
31679,YingsongXue,1,0.00006,400611,25.66248,1561077
31680,yise123,1,0.00006,400612,25.66254,1561077
31681,yishan-lin,1,0.00006,400613,25.66260,1561077
31682,Yiwei-Chen-Bose,1,0.00006,400614,25.66267,1561077
31683,yixi8524,1,0.00006,400615,25.66273,1561077
31684,yixiaol-m,1,0.00006,400616,25.66280,1561077
31685,yjagdale,1,0.00006,400617,25.66286,1561077
31686,yjo,1,0.00006,400618,25.66292,1561077
31687,YJ-Yejuan,1,0.00006,400619,25.66299,1561077
31688,ykf87,1,0.00006,400620,25.66305,1561077
31689,ykfq,1,0.00006,400621,25.66312,1561077
31690,yktoo,1,0.00006,400622,25.66318,1561077
31691,ykulkarnidia,1,0.00006,400623,25.66324,1561077
31692,ylcao,1,0.00006,400624,25.66331,1561077
31693,ylebedeva,1,0.00006,400625,25.66337,1561077
31694,ylvaldes,1,0.00006,400626,25.66344,1561077
31695,ymatsush,1,0.00006,400627,25.66350,1561077
31696,ynqa,1,0.00006,400628,25.66356,1561077
31697,yobushka,1,0.00006,400629,25.66363,1561077
31698,yo-cleon,1,0.00006,400630,25.66369,1561077
31699,yogesh249,1,0.00006,400631,25.66376,1561077
31700,yogesh9391,1,0.00006,400632,25.66382,1561077
31701,yogeshprasad,1,0.00006,400633,25.66388,1561077
31702,Yogeswaran3,1,0.00006,400634,25.66395,1561077
31703,yogig,1,0.00006,400635,25.66401,1561077
31704,yograterol,1,0.00006,400636,25.66408,1561077
31705,yogurtnaturalny,1,0.00006,400637,25.66414,1561077
31706,YokaiRick,1,0.00006,400638,25.66420,1561077
31707,yokoe,1,0.00006,400639,25.66427,1561077
31708,YonaLugassi,1,0.00006,400640,25.66433,1561077
31709,yonatanelkad,1,0.00006,400641,25.66440,1561077
31710,yongwen,1,0.00006,400642,25.66446,1561077
31711,yongwoohan,1,0.00006,400643,25.66453,1561077
31712,YoninL,1,0.00006,400644,25.66459,1561077
31713,YoniSegal,1,0.00006,400645,25.66465,1561077
31714,Yoni-shir,1,0.00006,400646,25.66472,1561077
31715,YOO629,1,0.00006,400647,25.66478,1561077
31716,yoram-s,1,0.00006,400648,25.66485,1561077
31717,yosefe,1,0.00006,400649,25.66491,1561077
31718,yosephkassa,1,0.00006,400650,25.66497,1561077
31719,yosoyju,1,0.00006,400651,25.66504,1561077
31720,yotles,1,0.00006,400652,25.66510,1561077
31721,you227,1,0.00006,400653,25.66517,1561077
31722,youctac,1,0.00006,400654,25.66523,1561077
31723,youhide,1,0.00006,400655,25.66529,1561077
31724,youlu2017,1,0.00006,400656,25.66536,1561077
31725,young007007,1,0.00006,400657,25.66542,1561077
31726,youribonnaffe,1,0.00006,400658,25.66549,1561077
31727,yousky,1,0.00006,400659,25.66555,1561077
31728,youssefboudaya,1,0.00006,400660,25.66561,1561077
31729,yoyokko,1,0.00006,400661,25.66568,1561077
31730,ypyly,1,0.00006,400662,25.66574,1561077
31731,yrj2011,1,0.00006,400663,25.66581,1561077
31732,ysammy,1,0.00006,400664,25.66587,1561077
31733,ysegorov,1,0.00006,400665,25.66593,1561077
31734,yshingai,1,0.00006,400666,25.66600,1561077
31735,ysjjovo,1,0.00006,400667,25.66606,1561077
31736,ystoneman,1,0.00006,400668,25.66613,1561077
31737,ytree-admin,1,0.00006,400669,25.66619,1561077
31738,YuantongL,1,0.00006,400670,25.66625,1561077
31739,yuchting,1,0.00006,400671,25.66632,1561077
31740,yudar1024,1,0.00006,400672,25.66638,1561077
31741,yudatou123,1,0.00006,400673,25.66645,1561077
31742,yuetianle,1,0.00006,400674,25.66651,1561077
31743,yuezhang-houzz,1,0.00006,400675,25.66658,1561077
31744,yugansh20,1,0.00006,400676,25.66664,1561077
31745,yuhki50,1,0.00006,400677,25.66670,1561077
31746,yuiung,1,0.00006,400678,25.66677,1561077
31747,yukaReal,1,0.00006,400679,25.66683,1561077
31748,yuliujin,1,0.00006,400680,25.66690,1561077
31749,yuliycv,1,0.00006,400681,25.66696,1561077
31750,yunduz,1,0.00006,400682,25.66702,1561077
31751,YungTosti,1,0.00006,400683,25.66709,1561077
31752,YunGuoGuo,1,0.00006,400684,25.66715,1561077
31753,yuntsewu,1,0.00006,400685,25.66722,1561077
31754,yunxingwang,1,0.00006,400686,25.66728,1561077
31755,yunzhangit,1,0.00006,400687,25.66734,1561077
31756,yuran4eg,1,0.00006,400688,25.66741,1561077
31757,yurchenkosv,1,0.00006,400689,25.66747,1561077
31758,yuri-1987,1,0.00006,400690,25.66754,1561077
31759,yuriib,1,0.00006,400691,25.66760,1561077
31760,yurikhan,1,0.00006,400692,25.66766,1561077
31761,Yuriy11,1,0.00006,400693,25.66773,1561077
31762,YuriyGorvitovskiy,1,0.00006,400694,25.66779,1561077
31763,yurok15,1,0.00006,400695,25.66786,1561077
31764,yush1ga,1,0.00006,400696,25.66792,1561077
31765,YuviGold,1,0.00006,400697,25.66798,1561077
31766,yuwaMSFT2,1,0.00006,400698,25.66805,1561077
31767,yuweibo,1,0.00006,400699,25.66811,1561077
31768,yuxintong-github,1,0.00006,400700,25.66818,1561077
31769,yuzliu,1,0.00006,400701,25.66824,1561077
31770,yvd,1,0.00006,400702,25.66830,1561077
31771,ywen,1,0.00006,400703,25.66837,1561077
31772,yx33,1,0.00006,400704,25.66843,1561077
31773,yxot12,1,0.00006,400705,25.66850,1561077
31774,yyurov,1,0.00006,400706,25.66856,1561077
31775,yzhang-myob,1,0.00006,400707,25.66862,1561077
31776,yzzshmily,1,0.00006,400708,25.66869,1561077
31777,z00sts,1,0.00006,400709,25.66875,1561077
31778,z2d,1,0.00006,400710,25.66882,1561077
31779,zabetak,1,0.00006,400711,25.66888,1561077
31780,zacaaron,1,0.00006,400712,25.66895,1561077
31781,zaccari,1,0.00006,400713,25.66901,1561077
31782,ZachArani,1,0.00006,400714,25.66907,1561077
31783,zachary2940,1,0.00006,400715,25.66914,1561077
31784,zach-nervana,1,0.00006,400716,25.66920,1561077
31785,zachwhaley,1,0.00006,400717,25.66927,1561077
31786,Zack24441,1,0.00006,400718,25.66933,1561077
31787,zahidraza,1,0.00006,400719,25.66939,1561077
31788,Zahlii,1,0.00006,400720,25.66946,1561077
31789,zaidizeeshan,1,0.00006,400721,25.66952,1561077
31790,zainaloha,1,0.00006,400722,25.66959,1561077
31791,zakabluk,1,0.00006,400723,25.66965,1561077
31792,zakariaboualaid,1,0.00006,400724,25.66971,1561077
31793,zakcox,1,0.00006,400725,25.66978,1561077
31794,zakjan,1,0.00006,400726,25.66984,1561077
31795,zakk4223,1,0.00006,400727,25.66991,1561077
31796,ZakTaccardi,1,0.00006,400728,25.66997,1561077
31797,zanderhavgaard,1,0.00006,400729,25.67003,1561077
31798,zandersmith-wp,1,0.00006,400730,25.67010,1561077
31799,zandolsi-psee,1,0.00006,400731,25.67016,1561077
31800,zapman449,1,0.00006,400732,25.67023,1561077
31801,zapp42,1,0.00006,400733,25.67029,1561077
31802,zarathon,1,0.00006,400734,25.67035,1561077
31803,zarkara,1,0.00006,400735,25.67042,1561077
31804,zasdfgbnm,1,0.00006,400736,25.67048,1561077
31805,z-ax,1,0.00006,400737,25.67055,1561077
31806,zayass,1,0.00006,400738,25.67061,1561077
31807,zbelzer,1,0.00006,400739,25.67067,1561077
31808,ZbigniewZabost,1,0.00006,400740,25.67074,1561077
31809,ZbigniewZabost-zanox,1,0.00006,400741,25.67080,1561077
31810,zbjdonald,1,0.00006,400742,25.67087,1561077
31811,zbsax,1,0.00006,400743,25.67093,1561077
31812,zcool321,1,0.00006,400744,25.67100,1561077
31813,zdraganov,1,0.00006,400745,25.67106,1561077
31814,zebrik,1,0.00006,400746,25.67112,1561077
31815,zeddD1abl0,1,0.00006,400747,25.67119,1561077
31816,zeddicus76,1,0.00006,400748,25.67125,1561077
31817,ZedYeung,1,0.00006,400749,25.67132,1561077
31818,ZeeCoder,1,0.00006,400750,25.67138,1561077
31819,zeejay09,1,0.00006,400751,25.67144,1561077
31820,zeenlym,1,0.00006,400752,25.67151,1561077
31821,zeeshanali2021,1,0.00006,400753,25.67157,1561077
31822,zeevMetz,1,0.00006,400754,25.67164,1561077
31823,zeewell,1,0.00006,400755,25.67170,1561077
31824,Zehhu,1,0.00006,400756,25.67176,1561077
31825,Zeloslaw,1,0.00006,400757,25.67183,1561077
31826,zencode1,1,0.00006,400758,25.67189,1561077
31827,zengfc0,1,0.00006,400759,25.67196,1561077
31828,zenng18,1,0.00006,400760,25.67202,1561077
31829,zephiyr,1,0.00006,400761,25.67208,1561077
31830,zeraturl,1,0.00006,400762,25.67215,1561077
31831,zeripath,1,0.00006,400763,25.67221,1561077
31832,zero4573,1,0.00006,400764,25.67228,1561077
31833,zeroByzero,1,0.00006,400765,25.67234,1561077
31834,zerojay,1,0.00006,400766,25.67240,1561077
31835,Zerony,1,0.00006,400767,25.67247,1561077
31836,zertan,1,0.00006,400768,25.67253,1561077
31837,zffocussss,1,0.00006,400769,25.67260,1561077
31838,ZG77,1,0.00006,400770,25.67266,1561077
31839,zgdnba1,1,0.00006,400771,25.67272,1561077
31840,zgoda,1,0.00006,400772,25.67279,1561077
31841,zgq5555,1,0.00006,400773,25.67285,1561077
31842,Zgreugneugneu,1,0.00006,400774,25.67292,1561077
31843,zhanghetong,1,0.00006,400775,25.67298,1561077
31844,zhangmer,1,0.00006,400776,25.67304,1561077
31845,zhangxiao123qqq,1,0.00006,400777,25.67311,1561077
31846,zhangxinlong633,1,0.00006,400778,25.67317,1561077
31847,zhangyang-gg,1,0.00006,400779,25.67324,1561077
31848,zhangyaocheng,1,0.00006,400780,25.67330,1561077
31849,zhangyihui1,1,0.00006,400781,25.67337,1561077
31850,zhangzj0225,1,0.00006,400782,25.67343,1561077
31851,Zhanjiabin,1,0.00006,400783,25.67349,1561077
31852,zhankangbao,1,0.00006,400784,25.67356,1561077
31853,zhantt1,1,0.00006,400785,25.67362,1561077
31854,zhao5363,1,0.00006,400786,25.67369,1561077
31855,zhaojianping,1,0.00006,400787,25.67375,1561077
31856,zhaojinggang,1,0.00006,400788,25.67381,1561077
31857,ZhaoRd,1,0.00006,400789,25.67388,1561077
31858,ZhdanovR,1,0.00006,400790,25.67394,1561077
31859,ZhDev,1,0.00006,400791,25.67401,1561077
31860,zhelyan,1,0.00006,400792,25.67407,1561077
31861,zhengjy,1,0.00006,400793,25.67413,1561077
31862,zhenxin0603,1,0.00006,400794,25.67420,1561077
31863,zhezhe101,1,0.00006,400795,25.67426,1561077
31864,zhihuiFan,1,0.00006,400796,25.67433,1561077
31865,zhiminwen,1,0.00006,400797,25.67439,1561077
31866,zhiqiangfan,1,0.00006,400798,25.67445,1561077
31867,zhiyxu,1,0.00006,400799,25.67452,1561077
31868,zhmg23,1,0.00006,400800,25.67458,1561077
31869,zhongyuanzhao000,1,0.00006,400801,25.67465,1561077
31870,zhouguangming,1,0.00006,400802,25.67471,1561077
31871,zhuanjiaozm,1,0.00006,400803,25.67477,1561077
31872,zhujun74,1,0.00006,400804,25.67484,1561077
31873,zhuzhiyang,1,0.00006,400805,25.67490,1561077
31874,ziggystar,1,0.00006,400806,25.67497,1561077
31875,ziggystartdust,1,0.00006,400807,25.67503,1561077
31876,zillaer,1,0.00006,400808,25.67509,1561077
31877,Zimgir,1,0.00006,400809,25.67516,1561077
31878,zimrh,1,0.00006,400810,25.67522,1561077
31879,Zion-github,1,0.00006,400811,25.67529,1561077
31880,Ziouani,1,0.00006,400812,25.67535,1561077
31881,zipeng-wu-sonarsource,1,0.00006,400813,25.67542,1561077
31882,zipkid,1,0.00006,400814,25.67548,1561077
31883,Zipper213,1,0.00006,400815,25.67554,1561077
31884,ziru,1,0.00006,400816,25.67561,1561077
31885,zittix,1,0.00006,400817,25.67567,1561077
31886,Ziwi01,1,0.00006,400818,25.67574,1561077
31887,zjawol,1,0.00006,400819,25.67580,1561077
31888,zjhuntin,1,0.00006,400820,25.67586,1561077
31889,zjkyz8,1,0.00006,400821,25.67593,1561077
31890,zjq123456,1,0.00006,400822,25.67599,1561077
31891,zkto,1,0.00006,400823,25.67606,1561077
31892,zlance,1,0.00006,400824,25.67612,1561077
31893,zlliu646428468,1,0.00006,400825,25.67618,1561077
31894,zloty,1,0.00006,400826,25.67625,1561077
31895,zloveless,1,0.00006,400827,25.67631,1561077
31896,zloygreko,1,0.00006,400828,25.67638,1561077
31897,zloylos,1,0.00006,400829,25.67644,1561077
31898,zlyuancn,1,0.00006,400830,25.67650,1561077
31899,Zmansi,1,0.00006,400831,25.67657,1561077
31900,zoeimogen,1,0.00006,400832,25.67663,1561077
31901,zogodo,1,0.00006,400833,25.67670,1561077
31902,zolech,1,0.00006,400834,25.67676,1561077
31903,Zoltu,1,0.00006,400835,25.67682,1561077
31904,zombified,1,0.00006,400836,25.67689,1561077
31905,zomglings,1,0.00006,400837,25.67695,1561077
31906,zomo,1,0.00006,400838,25.67702,1561077
31907,zongxiang-zhou,1,0.00006,400839,25.67708,1561077
31908,zoojar,1,0.00006,400840,25.67714,1561077
31909,Zophar78,1,0.00006,400841,25.67721,1561077
31910,zopz,1,0.00006,400842,25.67727,1561077
31911,Zordrak,1,0.00006,400843,25.67734,1561077
31912,zoret4,1,0.00006,400844,25.67740,1561077
31913,Zorkbomb,1,0.00006,400845,25.67746,1561077
31914,zosimos,1,0.00006,400846,25.67753,1561077
31915,zOthix,1,0.00006,400847,25.67759,1561077
31916,zoulux,1,0.00006,400848,25.67766,1561077
31917,zphixon,1,0.00006,400849,25.67772,1561077
31918,ZqyDaoDao,1,0.00006,400850,25.67779,1561077
31919,zricethezav,1,0.00006,400851,25.67785,1561077
31920,zrlay,1,0.00006,400852,25.67791,1561077
31921,zschwarz,1,0.00006,400853,25.67798,1561077
31922,zsoltdudas,1,0.00006,400854,25.67804,1561077
31923,zswanson,1,0.00006,400855,25.67811,1561077
31924,ztbrown,1,0.00006,400856,25.67817,1561077
31925,ztittle,1,0.00006,400857,25.67823,1561077
31926,ztsmith,1,0.00006,400858,25.67830,1561077
31927,zubair-airborneapp,1,0.00006,400859,25.67836,1561077
31928,zudljk,1,0.00006,400860,25.67843,1561077
31929,zumacinsmity,1,0.00006,400861,25.67849,1561077
31930,zupzup,1,0.00006,400862,25.67855,1561077
31931,zushane,1,0.00006,400863,25.67862,1561077
31932,zvonkokutlesa,1,0.00006,400864,25.67868,1561077
31933,zvymazal,1,0.00006,400865,25.67875,1561077
31934,zw999,1,0.00006,400866,25.67881,1561077
31935,zwidny,1,0.00006,400867,25.67887,1561077
31936,ZwoCa,1,0.00006,400868,25.67894,1561077
31937,zx972243884,1,0.00006,400869,25.67900,1561077
31938,zxitedu,1,0.00006,400870,25.67907,1561077
31939,zxti,1,0.00006,400871,25.67913,1561077
31940,ZyanKLee,1,0.00006,400872,25.67919,1561077
31941,zyb2n,1,0.00006,400873,25.67926,1561077
31942,zyf0330,1,0.00006,400874,25.67932,1561077
31943,zygoat,1,0.00006,400875,25.67939,1561077
31944,zyhagit,1,0.00006,400876,25.67945,1561077
31945,zystem,1,0.00006,400877,25.67951,1561077
31946,zytchn,1,0.00006,400878,25.67958,1561077
31947,zyzlik,1,0.00006,400879,25.67964,1561077
31948,zzdivyang,1,0.00006,400880,25.67971,1561077
31949,zzhengjian,1,0.00006,400881,25.67977,1561077
31950,zziga,1,0.00006,400882,25.67984,1561077
31951,zzpj,1,0.00006,400883,25.67990,1561077
