rank_number,actor,contributions,percent,cumulative_sum,cumulative_percent,all_contributions
1,stianst,23696,14.53163,23696,14.53163,163065
2,jonkoops,12336,7.56508,36032,22.09671,163065
3,mposolda,11920,7.30997,47952,29.40668,163065
4,pedroigor,8962,5.49597,56914,34.90265,163065
5,hmlnarik,8458,5.18689,65372,40.08953,163065
6,edewit,6435,3.94628,71807,44.03581,163065
7,ssilvert,5858,3.59243,77665,47.62825,163065
8,abstractj,5627,3.45077,83292,51.07902,163065
9,patriot1burke,3765,2.30890,87057,53.38791,163065
10,mhajas,3184,1.95260,90241,55.34051,163065
11,andymunro,2903,1.78027,93144,57.12078,163065
12,tnorimat,2848,1.74654,95992,58.86732,163065
13,vramik,2479,1.52025,98471,60.38758,163065
14,DGuhr,2073,1.27127,100544,61.65885,163065
15,andreaTP,1851,1.13513,102395,62.79398,163065
16,mabartos,1734,1.06338,104129,63.85736,163065
17,martin-kanis,1494,0.91620,105623,64.77356,163065
18,jenny-s51,1393,0.85426,107016,65.62782,163065
19,mfrances17,1292,0.79232,108308,66.42014,163065
20,sguilhen,1274,0.78128,109582,67.20142,163065
21,agagancarczyk,1091,0.66906,110673,67.87048,163065
22,pdrozd,950,0.58259,111623,68.45307,163065
23,xianli123,878,0.53844,112501,68.99151,163065
24,kami619,727,0.44583,113228,69.43734,163065
25,matthewhelmke,674,0.41333,113902,69.85067,163065
26,iankko,611,0.37470,114513,70.22537,163065
27,rmartinc,608,0.37286,115121,70.59823,163065
28,sschu,504,0.30908,115625,70.90731,163065
29,tkyjovsk,437,0.26799,116062,71.17530,163065
30,yih-wang,429,0.26309,116491,71.43838,163065
31,velias,388,0.23794,116879,71.67633,163065
32,Aboullos,379,0.23242,117258,71.90875,163065
33,lhanusov,362,0.22200,117620,72.13075,163065
34,miquelsi,342,0.20973,117962,72.34048,163065
35,cgeorgilakis,335,0.20544,118297,72.54592,163065
36,srambach,322,0.19747,118619,72.74338,163065
37,k-tamura,296,0.18152,118915,72.92491,163065
38,Pepo48,292,0.17907,119207,73.10398,163065
39,lexcao,267,0.16374,119474,73.26772,163065
40,douglaspalmer,256,0.15699,119730,73.42471,163065
41,y-tabata,244,0.14963,119974,73.57434,163065
42,dteleguin,220,0.13492,120194,73.70926,163065
43,ikhomyn,219,0.13430,120413,73.84356,163065
44,pskopek,212,0.13001,120625,73.97357,163065
45,lscorcia,203,0.12449,120828,74.09806,163065
46,zak905,202,0.12388,121030,74.22194,163065
47,danielFesenmeyer,180,0.11039,121210,74.33232,163065
48,andre-nascimento-rh,176,0.10793,121386,74.44025,163065
49,girirajsharma,160,0.09812,121546,74.53837,163065
50,vanrar68,133,0.08156,121679,74.61994,163065
51,dominikkawka,126,0.07727,121805,74.69721,163065
52,bs-matil,107,0.06562,121912,74.76282,163065
53,cainj13,107,0.06562,122019,74.82844,163065
54,Captain1653,107,0.06562,122126,74.89406,163065
55,marcelomrwin,107,0.06562,122233,74.95968,163065
56,stelewis-redhat,104,0.06378,122337,75.02346,163065
57,nehachopra27,102,0.06255,122439,75.08601,163065
58,Cracky5457,101,0.06194,122540,75.14795,163065
59,slominskir,96,0.05887,122636,75.20682,163065
60,ebondu,95,0.05826,122731,75.26508,163065
61,trixpan,95,0.05826,122826,75.32334,163065
62,tyandor,95,0.05826,122921,75.38160,163065
63,davoustp,94,0.05765,123015,75.43924,163065
64,benjamin37,93,0.05703,123108,75.49627,163065
65,ioemat,93,0.05703,123201,75.55331,163065
66,dhx-teuto,91,0.05581,123292,75.60911,163065
67,sventorben,91,0.05581,123383,75.66492,163065
68,artur-baltabayev,90,0.05519,123473,75.72011,163065
69,drichtarik,90,0.05519,123563,75.77530,163065
70,wyvie,90,0.05519,123653,75.83050,163065
71,dasniko,87,0.05335,123740,75.88385,163065
72,junezhang,87,0.05335,123827,75.93720,163065
73,gerbermichi,86,0.05274,123913,75.98994,163065
74,glavoie,84,0.05151,123997,76.04146,163065
75,foo4u,83,0.05090,124080,76.09236,163065
76,ccopelloRH,82,0.05029,124162,76.14264,163065
77,zagaria,80,0.04906,124242,76.19170,163065
78,jbman,79,0.04845,124321,76.24015,163065
79,xgp,79,0.04845,124400,76.28860,163065
80,aasingh,78,0.04783,124478,76.33643,163065
81,david-rh,74,0.04538,124552,76.38181,163065
82,bobmcwhirter,71,0.04354,124623,76.42535,163065
83,guymoyo,71,0.04354,124694,76.46889,163065
84,clementcur,67,0.04109,124761,76.50998,163065
85,ynojima,67,0.04109,124828,76.55107,163065
86,christiemolloy,65,0.03986,124893,76.59093,163065
87,knutz3n,65,0.03986,124958,76.63079,163065
88,Michito-Okai,65,0.03986,125023,76.67065,163065
89,scranen,65,0.03986,125088,76.71051,163065
90,chameleon82,64,0.03925,125152,76.74976,163065
91,AlistairDoswald,63,0.03863,125215,76.78840,163065
92,pedro-hos,63,0.03863,125278,76.82703,163065
93,gtudan,62,0.03802,125340,76.86505,163065
94,CorneliaLahnsteiner,61,0.03741,125401,76.90246,163065
95,leischt,60,0.03680,125461,76.93926,163065
96,laskasn,59,0.03618,125520,76.97544,163065
97,Redhat-Alice,59,0.03618,125579,77.01162,163065
98,Martin-Idel-SI,58,0.03557,125637,77.04719,163065
99,ath88,57,0.03496,125694,77.08215,163065
100,mm-matthias,57,0.03496,125751,77.11710,163065
101,alechenninger,56,0.03434,125807,77.15144,163065
102,lkubik,56,0.03434,125863,77.18578,163065
103,antikalk,55,0.03373,125918,77.21951,163065
104,unly,55,0.03373,125973,77.25324,163065
105,yelhouti,55,0.03373,126028,77.28697,163065
106,grgrzybek,52,0.03189,126080,77.31886,163065
107,thielef,52,0.03189,126132,77.35075,163065
108,hokuda,51,0.03128,126183,77.38203,163065
109,darius-m,50,0.03066,126233,77.41269,163065
110,Rajagopalan-Ranganathan,50,0.03066,126283,77.44335,163065
111,trevorloranger,50,0.03066,126333,77.47401,163065
112,i7a7467,49,0.03005,126382,77.50406,163065
113,micedre,48,0.02944,126430,77.53350,163065
114,Captain-P-Goldfish,46,0.02821,126476,77.56171,163065
115,jmrodriguez,46,0.02821,126522,77.58992,163065
116,aruehl,45,0.02760,126567,77.61751,163065
117,sgilda,45,0.02760,126612,77.64511,163065
118,srose,44,0.02698,126656,77.67209,163065
119,ajaiswal595,42,0.02576,126698,77.69785,163065
120,looorent,42,0.02576,126740,77.72361,163065
121,raehalme,41,0.02514,126781,77.74875,163065
122,testn,40,0.02453,126821,77.77328,163065
123,semangard,39,0.02392,126860,77.79720,163065
124,vplemyannik,39,0.02392,126899,77.82111,163065
125,vrockai,39,0.02392,126938,77.84503,163065
126,wwwy3y3,39,0.02392,126977,77.86895,163065
127,thatblindgeye,38,0.02330,127015,77.89225,163065
128,acotty,36,0.02208,127051,77.91433,163065
129,Eng-Fouad,36,0.02208,127087,77.93641,163065
130,fidgi,36,0.02208,127123,77.95848,163065
131,skjolber,36,0.02208,127159,77.98056,163065
132,sldab,36,0.02208,127195,78.00264,163065
133,ncbaratta,35,0.02146,127230,78.02410,163065
134,nengard,35,0.02146,127265,78.04556,163065
135,benzitohhh,34,0.02085,127299,78.06642,163065
136,dreamcrash,34,0.02085,127333,78.08727,163065
137,jsorah,34,0.02085,127367,78.10812,163065
138,leswilliams44,34,0.02085,127401,78.12897,163065
139,sebastianloesch,34,0.02085,127435,78.14982,163065
140,souravs17031999,34,0.02085,127469,78.17067,163065
141,wojnarfilip,34,0.02085,127503,78.19152,163065
142,epuronta,33,0.02024,127536,78.21176,163065
143,marcwrobel,33,0.02024,127569,78.23199,163065
144,wei-lee,33,0.02024,127602,78.25223,163065
145,aleksandr-belyaev,32,0.01962,127634,78.27185,163065
146,brat000012001,32,0.01962,127666,78.29148,163065
147,raphisuter,32,0.01962,127698,78.31110,163065
148,bruegth,31,0.01901,127729,78.33011,163065
149,gedejong,31,0.01901,127760,78.34912,163065
150,johnament,31,0.01901,127791,78.36814,163065
151,pruivo,30,0.01840,127821,78.38653,163065
152,psytester,30,0.01840,127851,78.40493,163065
153,wvdhaute,30,0.01840,127881,78.42333,163065
154,Yang-Xie-OSS,30,0.01840,127911,78.44173,163065
155,gabriel-cardoso,29,0.01778,127940,78.45951,163065
156,iingawal,29,0.01778,127969,78.47729,163065
157,KnauerSecunet,29,0.01778,127998,78.49508,163065
158,afedotov,28,0.01717,128026,78.51225,163065
159,Ekouyoja,28,0.01717,128054,78.52942,163065
160,harture,28,0.01717,128082,78.54659,163065
161,jangaraj,28,0.01717,128110,78.56376,163065
162,nngo,28,0.01717,128138,78.58093,163065
163,wildloop,28,0.01717,128166,78.59811,163065
164,Crow-EH,27,0.01656,128193,78.61466,163065
165,devopsix,27,0.01656,128220,78.63122,163065
166,ewjmulder,27,0.01656,128247,78.64778,163065
167,filipelautert,27,0.01656,128274,78.66434,163065
168,giacomoa,27,0.01656,128301,78.68089,163065
169,lgraf,27,0.01656,128328,78.69745,163065
170,mbaluch,27,0.01656,128355,78.71401,163065
171,mortenjoenby,27,0.01656,128382,78.73057,163065
172,roberth1988,27,0.01656,128409,78.74713,163065
173,agandhew,26,0.01594,128435,78.76307,163065
174,bohmber,26,0.01594,128461,78.77901,163065
175,cachescrubber,26,0.01594,128487,78.79496,163065
176,McLaynV,26,0.01594,128513,78.81090,163065
177,msvechla,26,0.01594,128539,78.82685,163065
178,ungarida,26,0.01594,128565,78.84279,163065
179,evanshortiss,25,0.01533,128590,78.85812,163065
180,manuel-palacio,25,0.01533,128615,78.87346,163065
181,mtrue01,25,0.01533,128640,78.88879,163065
182,oculos,25,0.01533,128665,78.90412,163065
183,valb3r,25,0.01533,128690,78.91945,163065
184,bastianccm,24,0.01472,128714,78.93417,163065
185,fbrissi,24,0.01472,128738,78.94889,163065
186,fkiss,24,0.01472,128762,78.96360,163065
187,manbobo2002,24,0.01472,128786,78.97832,163065
188,OskarsPakers,24,0.01472,128810,78.99304,163065
189,sathieu,24,0.01472,128834,79.00776,163065
190,Tristan971,24,0.01472,128858,79.02248,163065
191,diodfr,23,0.01410,128881,79.03658,163065
192,eldarj,23,0.01410,128904,79.05069,163065
193,hardselius,23,0.01410,128927,79.06479,163065
194,julian-berbel,23,0.01410,128950,79.07889,163065
195,lagess,23,0.01410,128973,79.09300,163065
196,leandrobortoli,23,0.01410,128996,79.10710,163065
197,nhirsl,23,0.01410,129019,79.12121,163065
198,soleblaze,23,0.01410,129042,79.13531,163065
199,eabykov,22,0.01349,129064,79.14881,163065
200,fjuma,22,0.01349,129086,79.16230,163065
201,hongquyen196,22,0.01349,129108,79.17579,163065
202,kherock,22,0.01349,129130,79.18928,163065
203,lrozenblyum,22,0.01349,129152,79.20277,163065
204,mkrueger92,22,0.01349,129174,79.21626,163065
205,mpalavrov,22,0.01349,129196,79.22976,163065
206,MStokluska,22,0.01349,129218,79.24325,163065
207,sonOfRa,22,0.01349,129240,79.25674,163065
208,Toma5OD,22,0.01349,129262,79.27023,163065
209,torbjornsk,22,0.01349,129284,79.28372,163065
210,andreas-blaettlinger,21,0.01288,129305,79.29660,163065
211,edwint88,21,0.01288,129326,79.30948,163065
212,foliengriller,21,0.01288,129347,79.32236,163065
213,helder-jaspion,21,0.01288,129368,79.33523,163065
214,jblashka,21,0.01288,129389,79.34811,163065
215,kris2kris,21,0.01288,129410,79.36099,163065
216,pravsjv,21,0.01288,129431,79.37387,163065
217,saibot94,21,0.01288,129452,79.38675,163065
218,shimkiv,21,0.01288,129473,79.39963,163065
219,trecloux,21,0.01288,129494,79.41250,163065
220,bb-matthewc,20,0.01227,129514,79.42477,163065
221,br0xpl,20,0.01227,129534,79.43703,163065
222,DaSmoo,20,0.01227,129554,79.44930,163065
223,filipetavares,20,0.01227,129574,79.46156,163065
224,klausbetz,20,0.01227,129594,79.47383,163065
225,rh-iatanaso,20,0.01227,129614,79.48609,163065
226,stustison,20,0.01227,129634,79.49836,163065
227,yordis,20,0.01227,129654,79.51062,163065
228,bodograumann,19,0.01165,129673,79.52228,163065
229,Bukarim,19,0.01165,129692,79.53393,163065
230,daklassen,19,0.01165,129711,79.54558,163065
231,karlhorky,19,0.01165,129730,79.55723,163065
232,Nuru,19,0.01165,129749,79.56888,163065
233,titansmc,19,0.01165,129768,79.58054,163065
234,cardosogabriel,18,0.01104,129786,79.59157,163065
235,emikolajczak,18,0.01104,129804,79.60261,163065
236,frelibert,18,0.01104,129822,79.61365,163065
237,grossws,18,0.01104,129840,79.62469,163065
238,jean-merelis,18,0.01104,129858,79.63573,163065
239,keycloak-packages,18,0.01104,129876,79.64677,163065
240,kkcmadhu,18,0.01104,129894,79.65781,163065
241,mazenaissa,18,0.01104,129912,79.66884,163065
242,nxadm,18,0.01104,129930,79.67988,163065
243,romge,18,0.01104,129948,79.69092,163065
244,shousper,18,0.01104,129966,79.70196,163065
245,Spechey,18,0.01104,129984,79.71300,163065
246,ssill2,18,0.01104,130002,79.72404,163065
247,valerii15298,18,0.01104,130020,79.73507,163065
248,Vividious,18,0.01104,130038,79.74611,163065
249,AmusedShadow,17,0.01043,130055,79.75654,163065
250,BiatBang,17,0.01043,130072,79.76696,163065
251,CollinAlpert,17,0.01043,130089,79.77739,163065
252,daviddelannoy,17,0.01043,130106,79.78781,163065
253,ethindp,17,0.01043,130123,79.79824,163065
254,EvgeniGordeev,17,0.01043,130140,79.80867,163065
255,evtr,17,0.01043,130157,79.81909,163065
256,fperot74,17,0.01043,130174,79.82952,163065
257,guitaro,17,0.01043,130191,79.83994,163065
258,h3nrique,17,0.01043,130208,79.85037,163065
259,jblachly,17,0.01043,130225,79.86079,163065
260,jniebuhr,17,0.01043,130242,79.87122,163065
261,katariakhyati,17,0.01043,130259,79.88164,163065
262,marziman,17,0.01043,130276,79.89207,163065
263,mrk-andreev,17,0.01043,130293,79.90249,163065
264,mwcz,17,0.01043,130310,79.91292,163065
265,patrick-primesign,17,0.01043,130327,79.92334,163065
266,ykvasetskiy,17,0.01043,130344,79.93377,163065
267,999eagle,16,0.00981,130360,79.94358,163065
268,azilentech,16,0.00981,130376,79.95339,163065
269,ch219318,16,0.00981,130392,79.96320,163065
270,DmitryMishchuk,16,0.00981,130408,79.97302,163065
271,gitdode,16,0.00981,130424,79.98283,163065
272,IoannisMatzaris,16,0.00981,130440,79.99264,163065
273,jbpin,16,0.00981,130456,80.00245,163065
274,JoshuaMulliken,16,0.00981,130472,80.01227,163065
275,Kanzow-IHK,16,0.00981,130488,80.02208,163065
276,Morl99,16,0.00981,130504,80.03189,163065
277,SamTV12345,16,0.00981,130520,80.04170,163065
278,SomeDeveloper13,16,0.00981,130536,80.05151,163065
279,tlann,16,0.00981,130552,80.06133,163065
280,zschwarz,16,0.00981,130568,80.07114,163065
281,agancarc,15,0.00920,130583,80.08034,163065
282,approached,15,0.00920,130598,80.08953,163065
283,aprilma419,15,0.00920,130613,80.09873,163065
284,arthur25000,15,0.00920,130628,80.10793,163065
285,Avarei,15,0.00920,130643,80.11713,163065
286,bartmentech,15,0.00920,130658,80.12633,163065
287,brothwellIntegral,15,0.00920,130673,80.13553,163065
288,cfsnyder,15,0.00920,130688,80.14473,163065
289,FranckKe,15,0.00920,130703,80.15393,163065
290,HryhoriiHevorkian,15,0.00920,130718,80.16313,163065
291,iperdomo,15,0.00920,130733,80.17232,163065
292,jderuere,15,0.00920,130748,80.18152,163065
293,Joe32,15,0.00920,130763,80.19072,163065
294,kaustubh-rh,15,0.00920,130778,80.19992,163065
295,mfdewit,15,0.00920,130793,80.20912,163065
296,npriebe,15,0.00920,130808,80.21832,163065
297,orivat,15,0.00920,130823,80.22752,163065
298,pgagnon,15,0.00920,130838,80.23672,163065
299,phamlankt,15,0.00920,130853,80.24591,163065
300,RaiSaurabh,15,0.00920,130868,80.25511,163065
301,rgala,15,0.00920,130883,80.26431,163065
302,sanket-bhalerao,15,0.00920,130898,80.27351,163065
303,SergiusAC,15,0.00920,130913,80.28271,163065
304,sjweixel,15,0.00920,130928,80.29191,163065
305,squaremarco,15,0.00920,130943,80.30111,163065
306,tkautenburger,15,0.00920,130958,80.31031,163065
307,vacuas,15,0.00920,130973,80.31950,163065
308,weltonrodrigo,15,0.00920,130988,80.32870,163065
309,dominikschlosser,14,0.00859,131002,80.33729,163065
310,dpulrichth,14,0.00859,131016,80.34587,163065
311,ejez,14,0.00859,131030,80.35446,163065
312,etchepar,14,0.00859,131044,80.36305,163065
313,fisache,14,0.00859,131058,80.37163,163065
314,gaetancollaud,14,0.00859,131072,80.38022,163065
315,gunterze,14,0.00859,131086,80.38880,163065
316,Jess103,14,0.00859,131100,80.39739,163065
317,keycloak,14,0.00859,131114,80.40597,163065
318,loaded02,14,0.00859,131128,80.41456,163065
319,madgaet,14,0.00859,131142,80.42314,163065
320,mduchrow,14,0.00859,131156,80.43173,163065
321,mvk37,14,0.00859,131170,80.44032,163065
322,myifeng,14,0.00859,131184,80.44890,163065
323,neslihanedes,14,0.00859,131198,80.45749,163065
324,pacostas,14,0.00859,131212,80.46607,163065
325,pnagesha,14,0.00859,131226,80.47466,163065
326,rainerfrey,14,0.00859,131240,80.48324,163065
327,RobYed,14,0.00859,131254,80.49183,163065
328,sberyozkin,14,0.00859,131268,80.50041,163065
329,shaneboulden,14,0.00859,131282,80.50900,163065
330,thpeter,14,0.00859,131296,80.51759,163065
331,yaoguoh,14,0.00859,131310,80.52617,163065
332,AlexeiKlimenko,13,0.00797,131323,80.53414,163065
333,breedjaram32,13,0.00797,131336,80.54212,163065
334,carlosli888,13,0.00797,131349,80.55009,163065
335,cartmanume,13,0.00797,131362,80.55806,163065
336,ch-lepp,13,0.00797,131375,80.56603,163065
337,cvcrckt,13,0.00797,131388,80.57400,163065
338,DAHAG-ArisNourbakhsh,13,0.00797,131401,80.58198,163065
339,dkobras,13,0.00797,131414,80.58995,163065
340,douph1,13,0.00797,131427,80.59792,163065
341,flipp5b,13,0.00797,131440,80.60589,163065
342,fschmager,13,0.00797,131453,80.61387,163065
343,GeorgeBekh,13,0.00797,131466,80.62184,163065
344,gilvansfilho,13,0.00797,131479,80.62981,163065
345,gkgeorgiev,13,0.00797,131492,80.63778,163065
346,iavael,13,0.00797,131505,80.64575,163065
347,inad9300,13,0.00797,131518,80.65373,163065
348,jeroenr,13,0.00797,131531,80.66170,163065
349,jonm-bb,13,0.00797,131544,80.66967,163065
350,jurjanpaul,13,0.00797,131557,80.67764,163065
351,karelhala,13,0.00797,131570,80.68562,163065
352,krnbr,13,0.00797,131583,80.69359,163065
353,liqiang-fit2cloud,13,0.00797,131596,80.70156,163065
354,little-pinecone,13,0.00797,131609,80.70953,163065
355,matumot,13,0.00797,131622,80.71751,163065
356,micbis,13,0.00797,131635,80.72548,163065
357,mrpatrickpilch,13,0.00797,131648,80.73345,163065
358,nbjohnson,13,0.00797,131661,80.74142,163065
359,PacoVK,13,0.00797,131674,80.74939,163065
360,peacepenguin,13,0.00797,131687,80.75737,163065
361,ramirost,13,0.00797,131700,80.76534,163065
362,ramunask,13,0.00797,131713,80.77331,163065
363,rhyamada,13,0.00797,131726,80.78128,163065
364,rmoqpd5t,13,0.00797,131739,80.78926,163065
365,sathishkumar3009,13,0.00797,131752,80.79723,163065
366,sbrajchuk,13,0.00797,131765,80.80520,163065
367,steevebtib,13,0.00797,131778,80.81317,163065
368,tvrg,13,0.00797,131791,80.82114,163065
369,UXabre,13,0.00797,131804,80.82912,163065
370,vibe13,13,0.00797,131817,80.83709,163065
371,wederer,13,0.00797,131830,80.84506,163065
372,Xiangjiaox,13,0.00797,131843,80.85303,163065
373,ZinkNotTheMetal,13,0.00797,131856,80.86101,163065
374,aba-langenegger,12,0.00736,131868,80.86837,163065
375,alvarogimenez,12,0.00736,131880,80.87572,163065
376,BonaBeavis,12,0.00736,131892,80.88308,163065
377,daniel-ac-martin,12,0.00736,131904,80.89044,163065
378,engineersamuel,12,0.00736,131916,80.89780,163065
379,evertongodoi,12,0.00736,131928,80.90516,163065
380,gautric,12,0.00736,131940,80.91252,163065
381,janslow,12,0.00736,131952,80.91988,163065
382,johgoe,12,0.00736,131964,80.92724,163065
383,KenRoy-Octo,12,0.00736,131976,80.93460,163065
384,manodupont,12,0.00736,131988,80.94196,163065
385,McArni91,12,0.00736,132000,80.94931,163065
386,MohammedAdain,12,0.00736,132012,80.95667,163065
387,MuhammadZakwan,12,0.00736,132024,80.96403,163065
388,nicolabeghin,12,0.00736,132036,80.97139,163065
389,oliverkane,12,0.00736,132048,80.97875,163065
390,petlys,12,0.00736,132060,80.98611,163065
391,rbarroetavena,12,0.00736,132072,80.99347,163065
392,rocketeerbkw,12,0.00736,132084,81.00083,163065
393,splatch,12,0.00736,132096,81.00819,163065
394,StefAtMentech,12,0.00736,132108,81.01555,163065
395,strima,12,0.00736,132120,81.02290,163065
396,tmogi001,12,0.00736,132132,81.03026,163065
397,USAF-cbentkowski,12,0.00736,132144,81.03762,163065
398,winfinit,12,0.00736,132156,81.04498,163065
399,woprandi,12,0.00736,132168,81.05234,163065
400,zhutaoredhat,12,0.00736,132180,81.05970,163065
401,AhazIsraeli,11,0.00675,132191,81.06645,163065
402,ahrycej,11,0.00675,132202,81.07319,163065
403,alevid99,11,0.00675,132213,81.07994,163065
404,alexandredantas,11,0.00675,132224,81.08668,163065
405,ammendonca,11,0.00675,132235,81.09343,163065
406,ayatb,11,0.00675,132246,81.10017,163065
407,ChrisBrandhorst,11,0.00675,132257,81.10692,163065
408,ebremer,11,0.00675,132268,81.11367,163065
409,enastevska,11,0.00675,132279,81.12041,163065
410,gabrielpadilh4,11,0.00675,132290,81.12716,163065
411,gelm0,11,0.00675,132301,81.13390,163065
412,gideonray,11,0.00675,132312,81.14065,163065
413,gigaga,11,0.00675,132323,81.14740,163065
414,guptakaran27,11,0.00675,132334,81.15414,163065
415,JBWatenbergScality,11,0.00675,132345,81.16089,163065
416,jkenefick,11,0.00675,132356,81.16763,163065
417,jntesteves,11,0.00675,132367,81.17438,163065
418,JonasCir,11,0.00675,132378,81.18112,163065
419,justin-stephenson,11,0.00675,132389,81.18787,163065
420,kanguran,11,0.00675,132400,81.19462,163065
421,leonardobrancalhao,11,0.00675,132411,81.20136,163065
422,minusdavid,11,0.00675,132422,81.20811,163065
423,m-takai,11,0.00675,132433,81.21485,163065
424,Nefcanto,11,0.00675,132444,81.22160,163065
425,nirousseau,11,0.00675,132455,81.22834,163065
426,prakash1,11,0.00675,132466,81.23509,163065
427,psztoch,11,0.00675,132477,81.24184,163065
428,puce77,11,0.00675,132488,81.24858,163065
429,puntogil,11,0.00675,132499,81.25533,163065
430,pwolf23,11,0.00675,132510,81.26207,163065
431,Pyr0technicien,11,0.00675,132521,81.26882,163065
432,RomanManz,11,0.00675,132532,81.27556,163065
433,rtheys,11,0.00675,132543,81.28231,163065
434,Schwaller,11,0.00675,132554,81.28906,163065
435,shubhamarora97,11,0.00675,132565,81.29580,163065
436,sirkrypt0,11,0.00675,132576,81.30255,163065
437,thokuest,11,0.00675,132587,81.30929,163065
438,tjuerge,11,0.00675,132598,81.31604,163065
439,wkruse,11,0.00675,132609,81.32279,163065
440,3XC1T3D,10,0.00613,132619,81.32892,163065
441,Abhishek-Govula,10,0.00613,132629,81.33505,163065
442,apollo13,10,0.00613,132639,81.34118,163065
443,archoversight,10,0.00613,132649,81.34732,163065
444,bjoernhype,10,0.00613,132659,81.35345,163065
445,brettlounsbury,10,0.00613,132669,81.35958,163065
446,Brezensalzer,10,0.00613,132679,81.36571,163065
447,camjjames,10,0.00613,132689,81.37185,163065
448,cdupont,10,0.00613,132699,81.37798,163065
449,chrisnurse,10,0.00613,132709,81.38411,163065
450,cybermo,10,0.00613,132719,81.39024,163065
451,DanielJoyce,10,0.00613,132729,81.39638,163065
452,didiez,10,0.00613,132739,81.40251,163065
453,d-vo,10,0.00613,132749,81.40864,163065
454,efge,10,0.00613,132759,81.41477,163065
455,gatos-cc,10,0.00613,132769,81.42091,163065
456,hc42,10,0.00613,132779,81.42704,163065
457,heddn,10,0.00613,132789,81.43317,163065
458,hellobiek,10,0.00613,132799,81.43930,163065
459,intellitour,10,0.00613,132809,81.44544,163065
460,JameelB,10,0.00613,132819,81.45157,163065
461,Jeff-Tian,10,0.00613,132829,81.45770,163065
462,jorozcof,10,0.00613,132839,81.46383,163065
463,JPA2015,10,0.00613,132849,81.46997,163065
464,kdankert,10,0.00613,132859,81.47610,163065
465,kyao233,10,0.00613,132869,81.48223,163065
466,Madankapoor,10,0.00613,132879,81.48836,163065
467,maito1201,10,0.00613,132889,81.49450,163065
468,marcelnem,10,0.00613,132899,81.50063,163065
469,MetaMmodern,10,0.00613,132909,81.50676,163065
470,mteubner,10,0.00613,132919,81.51289,163065
471,n1330,10,0.00613,132929,81.51903,163065
472,nono-lqdn,10,0.00613,132939,81.52516,163065
473,okft,10,0.00613,132949,81.53129,163065
474,OtenMoten,10,0.00613,132959,81.53742,163065
475,Pastor,10,0.00613,132969,81.54356,163065
476,pejeio,10,0.00613,132979,81.54969,163065
477,pmensik,10,0.00613,132989,81.55582,163065
478,raffaeler,10,0.00613,132999,81.56195,163065
479,rakeshreddyrg09,10,0.00613,133009,81.56809,163065
480,rodrigopsasaki,10,0.00613,133019,81.57422,163065
481,Saikishorkhadge,10,0.00613,133029,81.58035,163065
482,senyahnoj,10,0.00613,133039,81.58648,163065
483,Shryne,10,0.00613,133049,81.59262,163065
484,SrMouraSilva,10,0.00613,133059,81.59875,163065
485,stefanwendelmann,10,0.00613,133069,81.60488,163065
486,sushil-singh-guavus,10,0.00613,133079,81.61101,163065
487,Szer,10,0.00613,133089,81.61715,163065
488,twwd,10,0.00613,133099,81.62328,163065
489,ummarbhutta,10,0.00613,133109,81.62941,163065
490,Wolfsrudel,10,0.00613,133119,81.63554,163065
491,XcrigX,10,0.00613,133129,81.64168,163065
492,YaoFu-ea,10,0.00613,133139,81.64781,163065
493,yoannguion,10,0.00613,133149,81.65394,163065
494,zakariae-lebriq,10,0.00613,133159,81.66007,163065
495,1rahulr,9,0.00552,133168,81.66559,163065
496,adame11,9,0.00552,133177,81.67111,163065
497,ahweis,9,0.00552,133186,81.67663,163065
498,Akireken,9,0.00552,133195,81.68215,163065
499,allupaku,9,0.00552,133204,81.68767,163065
500,alwibrm,9,0.00552,133213,81.69319,163065
501,ashim-kr-saha,9,0.00552,133222,81.69871,163065
502,atlasloewenherz,9,0.00552,133231,81.70423,163065
503,Axenu,9,0.00552,133240,81.70975,163065
504,bdalenoord,9,0.00552,133249,81.71527,163065
505,behana,9,0.00552,133258,81.72079,163065
506,bpedersen2,9,0.00552,133267,81.72631,163065
507,cescoffier,9,0.00552,133276,81.73182,163065
508,ChristianLutz,9,0.00552,133285,81.73734,163065
509,DallasP9124,9,0.00552,133294,81.74286,163065
510,daurrutia,9,0.00552,133303,81.74838,163065
511,ddurham2,9,0.00552,133312,81.75390,163065
512,dmnboutin,9,0.00552,133321,81.75942,163065
513,dosera,9,0.00552,133330,81.76494,163065
514,dxmann73,9,0.00552,133339,81.77046,163065
515,EricWittmann,9,0.00552,133348,81.77598,163065
516,famod,9,0.00552,133357,81.78150,163065
517,g10f,9,0.00552,133366,81.78702,163065
518,ghenadiibatalski,9,0.00552,133375,81.79254,163065
519,gvonroten,9,0.00552,133384,81.79806,163065
520,hihuangwei,9,0.00552,133393,81.80358,163065
521,ibauersachs,9,0.00552,133402,81.80909,163065
522,iilei,9,0.00552,133411,81.81461,163065
523,javfg,9,0.00552,133420,81.82013,163065
524,jayblanc,9,0.00552,133429,81.82565,163065
525,joggeli34,9,0.00552,133438,81.83117,163065
526,kaiJwitt,9,0.00552,133447,81.83669,163065
527,Kinrany,9,0.00552,133456,81.84221,163065
528,M3lkior,9,0.00552,133465,81.84773,163065
529,marek-surek,9,0.00552,133474,81.85325,163065
530,MBauerDC,9,0.00552,133483,81.85877,163065
531,Monezz,9,0.00552,133492,81.86429,163065
532,mouse256,9,0.00552,133501,81.86981,163065
533,Nowheresly,9,0.00552,133510,81.87533,163065
534,nssecrier,9,0.00552,133519,81.88085,163065
535,Oidlichtnwoada,9,0.00552,133528,81.88636,163065
536,Opa-,9,0.00552,133537,81.89188,163065
537,priyanka-nag,9,0.00552,133546,81.89740,163065
538,regilero,9,0.00552,133555,81.90292,163065
539,ryanemerson,9,0.00552,133564,81.90844,163065
540,sbaeurle,9,0.00552,133573,81.91396,163065
541,shankaryadavy9,9,0.00552,133582,81.91948,163065
542,shobull,9,0.00552,133591,81.92500,163065
543,sreekesh93,9,0.00552,133600,81.93052,163065
544,tanberry,9,0.00552,133609,81.93604,163065
545,terahertz5k,9,0.00552,133618,81.94156,163065
546,Thomasdezeeuw,9,0.00552,133627,81.94708,163065
547,ThoreKr,9,0.00552,133636,81.95260,163065
548,universam1,9,0.00552,133645,81.95811,163065
549,Valeran86,9,0.00552,133654,81.96363,163065
550,varolemre,9,0.00552,133663,81.96915,163065
551,vdahlberg,9,0.00552,133672,81.97467,163065
552,xeras,9,0.00552,133681,81.98019,163065
553,yalpertem,9,0.00552,133690,81.98571,163065
554,zywj,9,0.00552,133699,81.99123,163065
555,0xpr03,8,0.00491,133707,81.99614,163065
556,aelgn,8,0.00491,133715,82.00104,163065
557,Alexander72,8,0.00491,133723,82.00595,163065
558,ammannmi,8,0.00491,133731,82.01085,163065
559,andriimurashkin,8,0.00491,133739,82.01576,163065
560,antaran13,8,0.00491,133747,82.02067,163065
561,arunganesh-a,8,0.00491,133755,82.02557,163065
562,ashishtchaudhari,8,0.00491,133763,82.03048,163065
563,bekwam,8,0.00491,133771,82.03538,163065
564,bernardopacheco,8,0.00491,133779,82.04029,163065
565,biertz,8,0.00491,133787,82.04520,163065
566,bilias,8,0.00491,133795,82.05010,163065
567,BoBeR182,8,0.00491,133803,82.05501,163065
568,brahim-raddahi,8,0.00491,133811,82.05991,163065
569,briangallagher,8,0.00491,133819,82.06482,163065
570,cegiraud,8,0.00491,133827,82.06973,163065
571,chris-allison-precisely,8,0.00491,133835,82.07463,163065
572,christianviana,8,0.00491,133843,82.07954,163065
573,danifr,8,0.00491,133851,82.08444,163065
574,dejwsz,8,0.00491,133859,82.08935,163065
575,djotanov,8,0.00491,133867,82.09426,163065
576,dotbr,8,0.00491,133875,82.09916,163065
577,dpoerschke,8,0.00491,133883,82.10407,163065
578,farmersmurf,8,0.00491,133891,82.10897,163065
579,FlyveHest,8,0.00491,133899,82.11388,163065
580,frankjkelly,8,0.00491,133907,82.11879,163065
581,frederic-kneier,8,0.00491,133915,82.12369,163065
582,fredericoschardong,8,0.00491,133923,82.12860,163065
583,haroonb,8,0.00491,133931,82.13351,163065
584,Hollerweger,8,0.00491,133939,82.13841,163065
585,ibacher,8,0.00491,133947,82.14332,163065
586,jakub-moravec,8,0.00491,133955,82.14822,163065
587,jhollmannk,8,0.00491,133963,82.15313,163065
588,JonasSchubert,8,0.00491,133971,82.15804,163065
589,jonnytest1,8,0.00491,133979,82.16294,163065
590,jsarem,8,0.00491,133987,82.16785,163065
591,kaol,8,0.00491,133995,82.17275,163065
592,kostoww,8,0.00491,134003,82.17766,163065
593,kwame-mintah,8,0.00491,134011,82.18257,163065
594,mabi,8,0.00491,134019,82.18747,163065
595,makettner,8,0.00491,134027,82.19238,163065
596,matheushent,8,0.00491,134035,82.19728,163065
597,MetroMarv,8,0.00491,134043,82.20219,163065
598,mgottl04,8,0.00491,134051,82.20710,163065
599,MPParsley,8,0.00491,134059,82.21200,163065
600,mtmvivek,8,0.00491,134067,82.21691,163065
601,NathanStrobbe,8,0.00491,134075,82.22181,163065
602,nicolasiannarilli,8,0.00491,134083,82.22672,163065
603,nmwael,8,0.00491,134091,82.23163,163065
604,PinPinIre,8,0.00491,134099,82.23653,163065
605,PoojaChandak,8,0.00491,134107,82.24144,163065
606,rahsin11,8,0.00491,134115,82.24634,163065
607,raul-verdi,8,0.00491,134123,82.25125,163065
608,rockxwre,8,0.00491,134131,82.25616,163065
609,sebastienmazade,8,0.00491,134139,82.26106,163065
610,SetoKaiba,8,0.00491,134147,82.26597,163065
611,slimovic,8,0.00491,134155,82.27087,163065
612,todortanevski,8,0.00491,134163,82.27578,163065
613,tubbynl,8,0.00491,134171,82.28069,163065
614,VerHext,8,0.00491,134179,82.28559,163065
615,waldemarennsaed,8,0.00491,134187,82.29050,163065
616,wawyed,8,0.00491,134195,82.29540,163065
617,westmc,8,0.00491,134203,82.30031,163065
618,14DF397FCA,7,0.00429,134210,82.30460,163065
619,adrien-dorsaz,7,0.00429,134217,82.30890,163065
620,almahmoud,7,0.00429,134224,82.31319,163065
621,antek-drzewiecki,7,0.00429,134231,82.31748,163065
622,anthonyraymond,7,0.00429,134238,82.32177,163065
623,apapia,7,0.00429,134245,82.32607,163065
624,b1tw0rker,7,0.00429,134252,82.33036,163065
625,BaptisteMonet,7,0.00429,134259,82.33465,163065
626,barthelch,7,0.00429,134266,82.33894,163065
627,bender316,7,0.00429,134273,82.34324,163065
628,betovieirasilva,7,0.00429,134280,82.34753,163065
629,bitbaggi,7,0.00429,134287,82.35182,163065
630,blevine,7,0.00429,134294,82.35612,163065
631,bovy89,7,0.00429,134301,82.36041,163065
632,buti1021,7,0.00429,134308,82.36470,163065
633,CarloS-JcU,7,0.00429,134315,82.36899,163065
634,CathalOConnorRH,7,0.00429,134322,82.37329,163065
635,cbontemps,7,0.00429,134329,82.37758,163065
636,clara0,7,0.00429,134336,82.38187,163065
637,codaabraham,7,0.00429,134343,82.38617,163065
638,codependent,7,0.00429,134350,82.39046,163065
639,davidfrickert,7,0.00429,134357,82.39475,163065
640,davidperrenoud,7,0.00429,134364,82.39904,163065
641,dennismorello,7,0.00429,134371,82.40334,163065
642,dfs-,7,0.00429,134378,82.40763,163065
643,dpolivaev,7,0.00429,134385,82.41192,163065
644,eatikrh,7,0.00429,134392,82.41621,163065
645,eedzjee,7,0.00429,134399,82.42051,163065
646,elfelip,7,0.00429,134406,82.42480,163065
647,fiorenzino,7,0.00429,134413,82.42909,163065
648,fischer7,7,0.00429,134420,82.43339,163065
649,gonzalad,7,0.00429,134427,82.43768,163065
650,GVincenzo,7,0.00429,134434,82.44197,163065
651,hobbypunk90,7,0.00429,134441,82.44626,163065
652,howkymike,7,0.00429,134448,82.45056,163065
653,ianwallen,7,0.00429,134455,82.45485,163065
654,intricate,7,0.00429,134462,82.45914,163065
655,jaap3,7,0.00429,134469,82.46343,163065
656,jan-berge-ommedal,7,0.00429,134476,82.46773,163065
657,javac9,7,0.00429,134483,82.47202,163065
658,jeroentervoorde,7,0.00429,134490,82.47631,163065
659,JessThrysoee,7,0.00429,134497,82.48061,163065
660,jol002,7,0.00429,134504,82.48490,163065
661,JoniJnm,7,0.00429,134511,82.48919,163065
662,jpenren,7,0.00429,134518,82.49348,163065
663,jruhe-adesso,7,0.00429,134525,82.49778,163065
664,kurisumakise2011,7,0.00429,134532,82.50207,163065
665,larsw,7,0.00429,134539,82.50636,163065
666,Leletir,7,0.00429,134546,82.51066,163065
667,lgwapnitsky,7,0.00429,134553,82.51495,163065
668,lostunicorn,7,0.00429,134560,82.51924,163065
669,luchsamapparat,7,0.00429,134567,82.52353,163065
670,lucrus73,7,0.00429,134574,82.52783,163065
671,ManuelRauber,7,0.00429,134581,82.53212,163065
672,mastepanoski,7,0.00429,134588,82.53641,163065
673,mattiaspantzare,7,0.00429,134595,82.54070,163065
674,maximRNBack,7,0.00429,134602,82.54500,163065
675,milicadjordjevic,7,0.00429,134609,82.54929,163065
676,mkopeyka,7,0.00429,134616,82.55358,163065
677,momyyao,7,0.00429,134623,82.55788,163065
678,mriedmann,7,0.00429,134630,82.56217,163065
679,mroyme,7,0.00429,134637,82.56646,163065
680,msavy,7,0.00429,134644,82.57075,163065
681,mstickel,7,0.00429,134651,82.57505,163065
682,nagarjun-repala,7,0.00429,134658,82.57934,163065
683,NavidMitchell,7,0.00429,134665,82.58363,163065
684,nblock,7,0.00429,134672,82.58793,163065
685,nicoclau,7,0.00429,134679,82.59222,163065
686,nidhin077,7,0.00429,134686,82.59651,163065
687,nloke,7,0.00429,134693,82.60080,163065
688,Nold360,7,0.00429,134700,82.60510,163065
689,nosnilmot,7,0.00429,134707,82.60939,163065
690,onlookor,7,0.00429,134714,82.61368,163065
691,pboehm,7,0.00429,134721,82.61797,163065
692,Persi,7,0.00429,134728,82.62227,163065
693,R0Wi,7,0.00429,134735,82.62656,163065
694,richardyee,7,0.00429,134742,82.63085,163065
695,rlfnb,7,0.00429,134749,82.63515,163065
696,rm3l,7,0.00429,134756,82.63944,163065
697,roblabla,7,0.00429,134763,82.64373,163065
698,Romain7495,7,0.00429,134770,82.64802,163065
699,rustygreen,7,0.00429,134777,82.65232,163065
700,sakitA,7,0.00429,134784,82.65661,163065
701,SmithJosh,7,0.00429,134791,82.66090,163065
702,SpiderD555,7,0.00429,134798,82.66519,163065
703,stefanodemartini,7,0.00429,134805,82.66949,163065
704,stevehogdahl,7,0.00429,134812,82.67378,163065
705,stoffus,7,0.00429,134819,82.67807,163065
706,stummb,7,0.00429,134826,82.68237,163065
707,sunny728,7,0.00429,134833,82.68666,163065
708,tgurr,7,0.00429,134840,82.69095,163065
709,TjeuKayim,7,0.00429,134847,82.69524,163065
710,tnsfk309,7,0.00429,134854,82.69954,163065
711,tobhv,7,0.00429,134861,82.70383,163065
712,tpdgt,7,0.00429,134868,82.70812,163065
713,treydock,7,0.00429,134875,82.71242,163065
714,tuqire,7,0.00429,134882,82.71671,163065
715,wlo,7,0.00429,134889,82.72100,163065
716,XakepSDK,7,0.00429,134896,82.72529,163065
717,yanivmn,7,0.00429,134903,82.72959,163065
718,zzador,7,0.00429,134910,82.73388,163065
719,abbra,6,0.00368,134916,82.73756,163065
720,acn-leoli,6,0.00368,134922,82.74124,163065
721,adnsimona,6,0.00368,134928,82.74492,163065
722,aelkz,6,0.00368,134934,82.74860,163065
723,agniswarm,6,0.00368,134940,82.75228,163065
724,AlexandreHeroux,6,0.00368,134946,82.75596,163065
725,alexandrelussier,6,0.00368,134952,82.75964,163065
726,apinnecke,6,0.00368,134958,82.76332,163065
727,asieraguado,6,0.00368,134964,82.76699,163065
728,avijain7143,6,0.00368,134970,82.77067,163065
729,axgus,6,0.00368,134976,82.77435,163065
730,bernard-denis,6,0.00368,134982,82.77803,163065
731,bmacher,6,0.00368,134988,82.78171,163065
732,bmenant,6,0.00368,134994,82.78539,163065
733,brownp2k,6,0.00368,135000,82.78907,163065
734,bryson,6,0.00368,135006,82.79275,163065
735,c0ntradicti0n,6,0.00368,135012,82.79643,163065
736,carljmosca,6,0.00368,135018,82.80011,163065
737,cjohnson-ironiq,6,0.00368,135024,82.80379,163065
738,claudiunicolaa,6,0.00368,135030,82.80747,163065
739,coeing,6,0.00368,135036,82.81115,163065
740,creleros,6,0.00368,135042,82.81483,163065
741,danazkari,6,0.00368,135048,82.81851,163065
742,danielkocot,6,0.00368,135054,82.82219,163065
743,daniel-shuy,6,0.00368,135060,82.82587,163065
744,danvy,6,0.00368,135066,82.82955,163065
745,devneutz,6,0.00368,135072,82.83323,163065
746,DrakkenSaer,6,0.00368,135078,82.83691,163065
747,drofe,6,0.00368,135084,82.84059,163065
748,ekoeryanto,6,0.00368,135090,82.84426,163065
749,elkman,6,0.00368,135096,82.84794,163065
750,fabianschlier,6,0.00368,135102,82.85162,163065
751,fabienhinault,6,0.00368,135108,82.85530,163065
752,Floppy012,6,0.00368,135114,82.85898,163065
753,franzmathauser,6,0.00368,135120,82.86266,163065
754,FritzOscar,6,0.00368,135126,82.86634,163065
755,FrodeI,6,0.00368,135132,82.87002,163065
756,frozencesium,6,0.00368,135138,82.87370,163065
757,garronej,6,0.00368,135144,82.87738,163065
758,guilhem-lk,6,0.00368,135150,82.88106,163065
759,hahahannes,6,0.00368,135156,82.88474,163065
760,HassanNaqvi94,6,0.00368,135162,82.88842,163065
761,hean0224,6,0.00368,135168,82.89210,163065
762,hpwahyao,6,0.00368,135174,82.89578,163065
763,husira,6,0.00368,135180,82.89946,163065
764,JakKowalCzyk,6,0.00368,135186,82.90314,163065
765,janstrohschein,6,0.00368,135192,82.90682,163065
766,jbcbezerra,6,0.00368,135198,82.91050,163065
767,jbranch-os,6,0.00368,135204,82.91418,163065
768,jcampbell,6,0.00368,135210,82.91785,163065
769,jevanlingen,6,0.00368,135216,82.92153,163065
770,jiri-lunacek,6,0.00368,135222,82.92521,163065
771,joao-rebelo,6,0.00368,135228,82.92889,163065
772,JSCorpo,6,0.00368,135234,82.93257,163065
773,jsight,6,0.00368,135240,82.93625,163065
774,junaidcassbana,6,0.00368,135246,82.93993,163065
775,kannan-ra,6,0.00368,135252,82.94361,163065
776,KleyLima,6,0.00368,135258,82.94729,163065
777,kreativmonkey,6,0.00368,135264,82.95097,163065
778,lachja,6,0.00368,135270,82.95465,163065
779,lfryc,6,0.00368,135276,82.95833,163065
780,lievenjacquot,6,0.00368,135282,82.96201,163065
781,lippling,6,0.00368,135288,82.96569,163065
782,LironT,6,0.00368,135294,82.96937,163065
783,ljani,6,0.00368,135300,82.97305,163065
784,logopk,6,0.00368,135306,82.97673,163065
785,LoicGudet,6,0.00368,135312,82.98041,163065
786,LRipi,6,0.00368,135318,82.98409,163065
787,luigidemasi,6,0.00368,135324,82.98777,163065
788,luisalves00,6,0.00368,135330,82.99145,163065
789,mah01,6,0.00368,135336,82.99512,163065
790,makayabou,6,0.00368,135342,82.99880,163065
791,manojreddydeveloper,6,0.00368,135348,83.00248,163065
792,marekvesely-direct,6,0.00368,135354,83.00616,163065
793,martin-d-ball,6,0.00368,135360,83.00984,163065
794,maxbes,6,0.00368,135366,83.01352,163065
795,maxime1907,6,0.00368,135372,83.01720,163065
796,mazbeh,6,0.00368,135378,83.02088,163065
797,m-mic,6,0.00368,135384,83.02456,163065
798,moremagic,6,0.00368,135390,83.02824,163065
799,Mouhand-Kaddo,6,0.00368,135396,83.03192,163065
800,mpugge,6,0.00368,135402,83.03560,163065
801,mrparkers,6,0.00368,135408,83.03928,163065
802,mthirion,6,0.00368,135414,83.04296,163065
803,mwalliczek,6,0.00368,135420,83.04664,163065
804,ngearhart,6,0.00368,135426,83.05032,163065
805,njs50,6,0.00368,135432,83.05400,163065
806,oridox,6,0.00368,135438,83.05768,163065
807,phasianus,6,0.00368,135444,83.06136,163065
808,PhilippStein,6,0.00368,135450,83.06504,163065
809,pkadej,6,0.00368,135456,83.06871,163065
810,q-b,6,0.00368,135462,83.07239,163065
811,R4VANG3R,6,0.00368,135468,83.07607,163065
812,rishabhsvats,6,0.00368,135474,83.07975,163065
813,robsonyeg,6,0.00368,135480,83.08343,163065
814,rogerioefonseca,6,0.00368,135486,83.08711,163065
815,rowe42,6,0.00368,135492,83.09079,163065
816,rush2sk8,6,0.00368,135498,83.09447,163065
817,RuslanTM,6,0.00368,135504,83.09815,163065
818,RyanLefebvre,6,0.00368,135510,83.10183,163065
819,santicastro,6,0.00368,135516,83.10551,163065
820,santoszv,6,0.00368,135522,83.10919,163065
821,schmeedy,6,0.00368,135528,83.11287,163065
822,scydas,6,0.00368,135534,83.11655,163065
823,SergeyZubatkin,6,0.00368,135540,83.12023,163065
824,serializingme,6,0.00368,135546,83.12391,163065
825,serl,6,0.00368,135552,83.12759,163065
826,sharifrezvani,6,0.00368,135558,83.13127,163065
827,ShefeeqPM,6,0.00368,135564,83.13495,163065
828,simon04,6,0.00368,135570,83.13863,163065
829,Spacelord09,6,0.00368,135576,83.14231,163065
830,spahrson,6,0.00368,135582,83.14598,163065
831,sre4ever,6,0.00368,135588,83.14966,163065
832,sschmiedleitner,6,0.00368,135594,83.15334,163065
833,stephenbjm,6,0.00368,135600,83.15702,163065
834,stevefan1999-personal,6,0.00368,135606,83.16070,163065
835,strk,6,0.00368,135612,83.16438,163065
836,suichangyin,6,0.00368,135618,83.16806,163065
837,syalioune,6,0.00368,135624,83.17174,163065
838,tahesse,6,0.00368,135630,83.17542,163065
839,teuber789,6,0.00368,135636,83.17910,163065
840,tgerakitis,6,0.00368,135642,83.18278,163065
841,TheSlimvReal,6,0.00368,135648,83.18646,163065
842,ThiefMaster,6,0.00368,135654,83.19014,163065
843,thomasmicro,6,0.00368,135660,83.19382,163065
844,thotty,6,0.00368,135666,83.19750,163065
845,timeisgolden,6,0.00368,135672,83.20118,163065
846,tomjo,6,0.00368,135678,83.20486,163065
847,tommss,6,0.00368,135684,83.20854,163065
848,tonial,6,0.00368,135690,83.21222,163065
849,tonswieb,6,0.00368,135696,83.21590,163065
850,tpohl,6,0.00368,135702,83.21958,163065
851,trickert76,6,0.00368,135708,83.22325,163065
852,tspearconquest,6,0.00368,135714,83.22693,163065
853,ttony-kim,6,0.00368,135720,83.23061,163065
854,tuxmaster5000,6,0.00368,135726,83.23429,163065
855,upfluentpatrickpilch,6,0.00368,135732,83.23797,163065
856,volkflo,6,0.00368,135738,83.24165,163065
857,vpmuli,6,0.00368,135744,83.24533,163065
858,wavemoroc001,6,0.00368,135750,83.24901,163065
859,wilderk,6,0.00368,135756,83.25269,163065
860,wjh000123,6,0.00368,135762,83.25637,163065
861,Wobow,6,0.00368,135768,83.26005,163065
862,wowi42,6,0.00368,135774,83.26373,163065
863,xAl3xFx,6,0.00368,135780,83.26741,163065
864,Xuezenghuigithub,6,0.00368,135786,83.27109,163065
865,ya-makariy,6,0.00368,135792,83.27477,163065
866,YevheniiPokhvalii,6,0.00368,135798,83.27845,163065
867,yodeyer,6,0.00368,135804,83.28213,163065
868,yohny,6,0.00368,135810,83.28581,163065
869,1saifj,5,0.00307,135815,83.28887,163065
870,abustya,5,0.00307,135820,83.29194,163065
871,acontreras89,5,0.00307,135825,83.29501,163065
872,ahcamy2021,5,0.00307,135830,83.29807,163065
873,ahmedwarsama,5,0.00307,135835,83.30114,163065
874,ajeetmind,5,0.00307,135840,83.30420,163065
875,alapierre,5,0.00307,135845,83.30727,163065
876,alirizaaribas-ibg,5,0.00307,135850,83.31034,163065
877,allebone,5,0.00307,135855,83.31340,163065
878,Alpenbelieve,5,0.00307,135860,83.31647,163065
879,amhest,5,0.00307,135865,83.31954,163065
880,ammmze,5,0.00307,135870,83.32260,163065
881,Arcahub,5,0.00307,135875,83.32567,163065
882,arekmano,5,0.00307,135880,83.32873,163065
883,ArmanGhost,5,0.00307,135885,83.33180,163065
884,arminfelder,5,0.00307,135890,83.33487,163065
885,ArminRadmueller,5,0.00307,135895,83.33793,163065
886,ArnaultMICHEL,5,0.00307,135900,83.34100,163065
887,Arthur380,5,0.00307,135905,83.34407,163065
888,axi92,5,0.00307,135910,83.34713,163065
889,axl8713,5,0.00307,135915,83.35020,163065
890,aznamier,5,0.00307,135920,83.35326,163065
891,badrange,5,0.00307,135925,83.35633,163065
892,bagges,5,0.00307,135930,83.35940,163065
893,BartoszSiemienczuk,5,0.00307,135935,83.36246,163065
894,bdmayes,5,0.00307,135940,83.36553,163065
895,bergner,5,0.00307,135945,83.36860,163065
896,bertramn,5,0.00307,135950,83.37166,163065
897,bigglesandginger,5,0.00307,135955,83.37473,163065
898,Bitnik212,5,0.00307,135960,83.37779,163065
899,bob-sheknowdas,5,0.00307,135965,83.38086,163065
900,bogdanpetrea,5,0.00307,135970,83.38393,163065
901,boschcrank,5,0.00307,135975,83.38699,163065
902,braoru,5,0.00307,135980,83.39006,163065
903,brecht-vermeersch,5,0.00307,135985,83.39313,163065
904,Camsteack,5,0.00307,135990,83.39619,163065
905,casfe03,5,0.00307,135995,83.39926,163065
906,ccheneau,5,0.00307,136000,83.40232,163065
907,chehrhar,5,0.00307,136005,83.40539,163065
908,ckEriksen,5,0.00307,136010,83.40846,163065
909,codakin,5,0.00307,136015,83.41152,163065
910,cod-soap,5,0.00307,136020,83.41459,163065
911,csckcac,5,0.00307,136025,83.41766,163065
912,Daryes,5,0.00307,136030,83.42072,163065
913,dashaylan,5,0.00307,136035,83.42379,163065
914,Defoncesko,5,0.00307,136040,83.42685,163065
915,deviprsd,5,0.00307,136045,83.42992,163065
916,devlauer,5,0.00307,136050,83.43299,163065
917,devoto13,5,0.00307,136055,83.43605,163065
918,dierberg,5,0.00307,136060,83.43912,163065
919,dillon-sellars,5,0.00307,136065,83.44219,163065
920,dklika,5,0.00307,136070,83.44525,163065
921,doflo-dfa,5,0.00307,136075,83.44832,163065
922,domitopp,5,0.00307,136080,83.45138,163065
923,driverpt,5,0.00307,136085,83.45445,163065
924,drwetter,5,0.00307,136090,83.45752,163065
925,dvallant,5,0.00307,136095,83.46058,163065
926,eckilein,5,0.00307,136100,83.46365,163065
927,ehogeweg,5,0.00307,136105,83.46672,163065
928,EinarArnason,5,0.00307,136110,83.46978,163065
929,elepedus,5,0.00307,136115,83.47285,163065
930,enfochannel,5,0.00307,136120,83.47591,163065
931,fabrc,5,0.00307,136125,83.47898,163065
932,fabu-khiarah,5,0.00307,136130,83.48205,163065
933,fluescher,5,0.00307,136135,83.48511,163065
934,Fryguy,5,0.00307,136140,83.48818,163065
935,ganniravindra,5,0.00307,136145,83.49125,163065
936,geminys,5,0.00307,136150,83.49431,163065
937,GerDner,5,0.00307,136155,83.49738,163065
938,gilbert-fernandes,5,0.00307,136160,83.50044,163065
939,gmarziou,5,0.00307,136165,83.50351,163065
940,GretUp,5,0.00307,136170,83.50658,163065
941,gstester,5,0.00307,136175,83.50964,163065
942,gt-novelt,5,0.00307,136180,83.51271,163065
943,HansK-p,5,0.00307,136185,83.51578,163065
944,happy0088,5,0.00307,136190,83.51884,163065
945,harrylepotter-win,5,0.00307,136195,83.52191,163065
946,hassaneinaltememyictu,5,0.00307,136200,83.52497,163065
947,hecsalazar,5,0.00307,136205,83.52804,163065
948,Heldenkrieger01,5,0.00307,136210,83.53111,163065
949,Herdo,5,0.00307,136215,83.53417,163065
950,HerrDerb,5,0.00307,136220,83.53724,163065
951,hjannasch,5,0.00307,136225,83.54031,163065
952,HJK181,5,0.00307,136230,83.54337,163065
953,hlavki,5,0.00307,136235,83.54644,163065
954,hokiegeek2,5,0.00307,136240,83.54950,163065
955,hookenful,5,0.00307,136245,83.55257,163065
956,hypervisorfdi,5,0.00307,136250,83.55564,163065
957,iFrozenPhoenix,5,0.00307,136255,83.55870,163065
958,ilyabakhlin,5,0.00307,136260,83.56177,163065
959,ImaCrea,5,0.00307,136265,83.56484,163065
960,isaacjensen,5,0.00307,136270,83.56790,163065
961,jamesalester,5,0.00307,136275,83.57097,163065
962,JannieP,5,0.00307,136280,83.57403,163065
963,jermarchand,5,0.00307,136285,83.57710,163065
964,jichen-amplify,5,0.00307,136290,83.58017,163065
965,jobmission,5,0.00307,136295,83.58323,163065
966,joeri-jansen,5,0.00307,136300,83.58630,163065
967,JoMas971,5,0.00307,136305,83.58937,163065
968,jonathangodoy,5,0.00307,136310,83.59243,163065
969,juanjoi-empathy,5,0.00307,136315,83.59550,163065
970,justintime4tea,5,0.00307,136320,83.59856,163065
971,Keeper-of-the-Keys,5,0.00307,136325,83.60163,163065
972,keerden,5,0.00307,136330,83.60470,163065
973,kervel,5,0.00307,136335,83.60776,163065
974,kikolouro,5,0.00307,136340,83.61083,163065
975,KimZhai,5,0.00307,136345,83.61390,163065
976,kingluo,5,0.00307,136350,83.61696,163065
977,kkplein,5,0.00307,136355,83.62003,163065
978,korommatyi,5,0.00307,136360,83.62310,163065
979,kprasad99,5,0.00307,136365,83.62616,163065
980,ladytaz-rowell,5,0.00307,136370,83.62923,163065
981,laurem1381,5,0.00307,136375,83.63229,163065
982,Leaveyou,5,0.00307,136380,83.63536,163065
983,libertosurf,5,0.00307,136385,83.63843,163065
984,lkrzyzanek,5,0.00307,136390,83.64149,163065
985,lnewson,5,0.00307,136395,83.64456,163065
986,lucamaf,5,0.00307,136400,83.64763,163065
987,luneo7,5,0.00307,136405,83.65069,163065
988,m0s1x,5,0.00307,136410,83.65376,163065
989,Mangatome,5,0.00307,136415,83.65682,163065
990,manuschillerdev,5,0.00307,136420,83.65989,163065
991,martaisty,5,0.00307,136425,83.66296,163065
992,masodilosangeles,5,0.00307,136430,83.66602,163065
993,masoodfaisal,5,0.00307,136435,83.66909,163065
994,mattgagliardi,5,0.00307,136440,83.67216,163065
995,max-allan-surevine,5,0.00307,136445,83.67522,163065
996,maxsz,5,0.00307,136450,83.67829,163065
997,mbikl,5,0.00307,136455,83.68135,163065
998,mcattle,5,0.00307,136460,83.68442,163065
999,melissapalmer,5,0.00307,136465,83.68749,163065
1000,mghalbi,5,0.00307,136470,83.69055,163065
1001,MichaelKoch11,5,0.00307,136475,83.69362,163065
1002,mingjliu9,5,0.00307,136480,83.69669,163065
1003,mkdgit,5,0.00307,136485,83.69975,163065
1004,mmadoo,5,0.00307,136490,83.70282,163065
1005,mndzielski,5,0.00307,136495,83.70588,163065
1006,mootezbessifi,5,0.00307,136500,83.70895,163065
1007,moritzschmitz-oviva,5,0.00307,136505,83.71202,163065
1008,MushroomSquad,5,0.00307,136510,83.71508,163065
1009,nathmo,5,0.00307,136515,83.71815,163065
1010,Neeya123,5,0.00307,136520,83.72122,163065
1011,nikel123,5,0.00307,136525,83.72428,163065
1012,Nikos410,5,0.00307,136530,83.72735,163065
1013,NMBprogrammer,5,0.00307,136535,83.73041,163065
1014,Norwae,5,0.00307,136540,83.73348,163065
1015,nuwang,5,0.00307,136545,83.73655,163065
1016,nyko29,5,0.00307,136550,83.73961,163065
1017,omidraha,5,0.00307,136555,83.74268,163065
1018,p53,5,0.00307,136560,83.74575,163065
1019,Painyjames,5,0.00307,136565,83.74881,163065
1020,pantovad,5,0.00307,136570,83.75188,163065
1021,Paramvir-JIndal,5,0.00307,136575,83.75494,163065
1022,paulbares,5,0.00307,136580,83.75801,163065
1023,pavelkokush,5,0.00307,136585,83.76108,163065
1024,pendula95,5,0.00307,136590,83.76414,163065
1025,pjgg,5,0.00307,136595,83.76721,163065
1026,p-muessig,5,0.00307,136600,83.77028,163065
1027,pratiksomangoudar,5,0.00307,136605,83.77334,163065
1028,pritish-nitb,5,0.00307,136610,83.77641,163065
1029,ProBrian,5,0.00307,136615,83.77947,163065
1030,punkratz312,5,0.00307,136620,83.78254,163065
1031,quatauta,5,0.00307,136625,83.78561,163065
1032,rafaelweingartner,5,0.00307,136630,83.78867,163065
1033,RaffaelGrob,5,0.00307,136635,83.79174,163065
1034,railsonsm,5,0.00307,136640,83.79481,163065
1035,ratcashdev,5,0.00307,136645,83.79787,163065
1036,RemiEven,5,0.00307,136650,83.80094,163065
1037,Ricardo-PSilva,5,0.00307,136655,83.80400,163065
1038,rixlabs,5,0.00307,136660,83.80707,163065
1039,RManesiya,5,0.00307,136665,83.81014,163065
1040,robbertbrak,5,0.00307,136670,83.81320,163065
1041,rradillen,5,0.00307,136675,83.81627,163065
1042,ruzkant,5,0.00307,136680,83.81934,163065
1043,SalahAdDin,5,0.00307,136685,83.82240,163065
1044,SalemWafi,5,0.00307,136690,83.82547,163065
1045,samdammers,5,0.00307,136695,83.82853,163065
1046,sashokbg,5,0.00307,136700,83.83160,163065
1047,scandinave,5,0.00307,136705,83.83467,163065
1048,schereradi,5,0.00307,136710,83.83773,163065
1049,SebastianLng,5,0.00307,136715,83.84080,163065
1050,siepkes,5,0.00307,136720,83.84387,163065
1051,sirockin,5,0.00307,136725,83.84693,163065
1052,skyfalke,5,0.00307,136730,83.85000,163065
1053,sparkmylife,5,0.00307,136735,83.85306,163065
1054,Spindl,5,0.00307,136740,83.85613,163065
1055,Stephan202,5,0.00307,136745,83.85920,163065
1056,stianst-test,5,0.00307,136750,83.86226,163065
1057,stromnet,5,0.00307,136755,83.86533,163065
1058,sts,5,0.00307,136760,83.86840,163065
1059,stv2509,5,0.00307,136765,83.87146,163065
1060,sudeepd,5,0.00307,136770,83.87453,163065
1061,svsk417,5,0.00307,136775,83.87759,163065
1062,synth3,5,0.00307,136780,83.88066,163065
1063,T0mWz,5,0.00307,136785,83.88373,163065
1064,tacerus,5,0.00307,136790,83.88679,163065
1065,TafkaMax,5,0.00307,136795,83.88986,163065
1066,tbdaniel27,5,0.00307,136800,83.89293,163065
1067,tbsfrdrch,5,0.00307,136805,83.89599,163065
1068,TheArKaID,5,0.00307,136810,83.89906,163065
1069,thomasdstewart,5,0.00307,136815,83.90212,163065
1070,ThomasTosik,5,0.00307,136820,83.90519,163065
1071,tiagopsantos,5,0.00307,136825,83.90826,163065
1072,TorstenF76,5,0.00307,136830,83.91132,163065
1073,trex667,5,0.00307,136835,83.91439,163065
1074,uhon,5,0.00307,136840,83.91746,163065
1075,unbreakabl3,5,0.00307,136845,83.92052,163065
1076,willer007,5,0.00307,136850,83.92359,163065
1077,WKupper,5,0.00307,136855,83.92666,163065
1078,wlami,5,0.00307,136860,83.92972,163065
1079,yashnalla,5,0.00307,136865,83.93279,163065
1080,zanettea,5,0.00307,136870,83.93585,163065
1081,Zumpel96,5,0.00307,136875,83.93892,163065
1082,ZXRobotum,5,0.00307,136880,83.94199,163065
1083,aaron-kunde,4,0.00245,136884,83.94444,163065
1084,aberhallo,4,0.00245,136888,83.94689,163065
1085,adl1995,4,0.00245,136892,83.94935,163065
1086,afonsobspinto,4,0.00245,136896,83.95180,163065
1087,Agh42,4,0.00245,136900,83.95425,163065
1088,ahamid,4,0.00245,136904,83.95670,163065
1089,aidachami-qc,4,0.00245,136908,83.95916,163065
1090,ajacobs21e,4,0.00245,136912,83.96161,163065
1091,akhil6095,4,0.00245,136916,83.96406,163065
1092,AkiraEisen,4,0.00245,136920,83.96652,163065
1093,akovari,4,0.00245,136924,83.96897,163065
1094,aleluc13,4,0.00245,136928,83.97142,163065
1095,alexagc,4,0.00245,136932,83.97388,163065
1096,alexted,4,0.00245,136936,83.97633,163065
1097,alexwais,4,0.00245,136940,83.97878,163065
1098,alfonsoalongi,4,0.00245,136944,83.98123,163065
1099,alisonbruno97,4,0.00245,136948,83.98369,163065
1100,AllexVeldman,4,0.00245,136952,83.98614,163065
1101,alphec,4,0.00245,136956,83.98859,163065
1102,amoscatelli,4,0.00245,136960,83.99105,163065
1103,AndreaVida,4,0.00245,136964,83.99350,163065
1104,andrew-landsverk-win,4,0.00245,136968,83.99595,163065
1105,AnirudhaGohokar,4,0.00245,136972,83.99841,163065
1106,annie-amplify,4,0.00245,136976,84.00086,163065
1107,anovinger,4,0.00245,136980,84.00331,163065
1108,arne-kroeger,4,0.00245,136984,84.00576,163065
1109,ashutosh-hs,4,0.00245,136988,84.00822,163065
1110,aymns,4,0.00245,136992,84.01067,163065
1111,AzagraMac,4,0.00245,136996,84.01312,163065
1112,bacloud23,4,0.00245,137000,84.01558,163065
1113,belfhi,4,0.00245,137004,84.01803,163065
1114,benediktneumayr,4,0.00245,137008,84.02048,163065
1115,BertrandFritsch,4,0.00245,137012,84.02294,163065
1116,bonnm,4,0.00245,137016,84.02539,163065
1117,bouchardmathieu-qc,4,0.00245,137020,84.02784,163065
1118,brsysadmin,4,0.00245,137024,84.03029,163065
1119,brucelpt,4,0.00245,137028,84.03275,163065
1120,burner-account,4,0.00245,137032,84.03520,163065
1121,byF,4,0.00245,137036,84.03765,163065
1122,cedricguindon,4,0.00245,137040,84.04011,163065
1123,cheribhai,4,0.00245,137044,84.04256,163065
1124,chsun68,4,0.00245,137048,84.04501,163065
1125,cknoblauch,4,0.00245,137052,84.04747,163065
1126,ckwalsh,4,0.00245,137056,84.04992,163065
1127,cmacq2,4,0.00245,137060,84.05237,163065
1128,cnwaldron,4,0.00245,137064,84.05482,163065
1129,codemasterover9000,4,0.00245,137068,84.05728,163065
1130,coeit,4,0.00245,137072,84.05973,163065
1131,collinpreston,4,0.00245,137076,84.06218,163065
1132,cornelinux,4,0.00245,137080,84.06464,163065
1133,corradocavalli,4,0.00245,137084,84.06709,163065
1134,cristhiank,4,0.00245,137088,84.06954,163065
1135,crowne,4,0.00245,137092,84.07200,163065
1136,cwelchrh,4,0.00245,137096,84.07445,163065
1137,d0d00n,4,0.00245,137100,84.07690,163065
1138,d2a-raudenaerde,4,0.00245,137104,84.07935,163065
1139,Daniel-Marynicz,4,0.00245,137108,84.08181,163065
1140,danren,4,0.00245,137112,84.08426,163065
1141,darahayes,4,0.00245,137116,84.08671,163065
1142,darranl,4,0.00245,137120,84.08917,163065
1143,dehort,4,0.00245,137124,84.09162,163065
1144,DenisBessa,4,0.00245,137128,84.09407,163065
1145,DennisBayer,4,0.00245,137132,84.09653,163065
1146,destotelhorus,4,0.00245,137136,84.09898,163065
1147,dev-e,4,0.00245,137140,84.10143,163065
1148,dhoextermann,4,0.00245,137144,84.10388,163065
1149,diego0020,4,0.00245,137148,84.10634,163065
1150,diversit,4,0.00245,137152,84.10879,163065
1151,dlechevalier,4,0.00245,137156,84.11124,163065
1152,dmgeurts,4,0.00245,137160,84.11370,163065
1153,dobrik-ardas,4,0.00245,137164,84.11615,163065
1154,domdomegg,4,0.00245,137168,84.11860,163065
1155,drohwer89,4,0.00245,137172,84.12106,163065
1156,drsmile1001,4,0.00245,137176,84.12351,163065
1157,dsukhoroslov,4,0.00245,137180,84.12596,163065
1158,Dutchboy,4,0.00245,137184,84.12842,163065
1159,dylanplecki,4,0.00245,137188,84.13087,163065
1160,edumanish,4,0.00245,137192,84.13332,163065
1161,eivim,4,0.00245,137196,84.13577,163065
1162,emmanuelbernard,4,0.00245,137200,84.13823,163065
1163,EmmaWrong,4,0.00245,137204,84.14068,163065
1164,eric-picnic,4,0.00245,137208,84.14313,163065
1165,esiqveland,4,0.00245,137212,84.14559,163065
1166,eucleciojosias,4,0.00245,137216,84.14804,163065
1167,evertmulder,4,0.00245,137220,84.15049,163065
1168,ExLeonem,4,0.00245,137224,84.15295,163065
1169,Exordian,4,0.00245,137228,84.15540,163065
1170,Fabbbrrr,4,0.00245,137232,84.15785,163065
1171,FasterLeaner,4,0.00245,137236,84.16030,163065
1172,FAUSheppy,4,0.00245,137240,84.16276,163065
1173,fedeneira,4,0.00245,137244,84.16521,163065
1174,fernandomora,4,0.00245,137248,84.16766,163065
1175,finwo,4,0.00245,137252,84.17012,163065
1176,flapouille,4,0.00245,137256,84.17257,163065
1177,FloLaco,4,0.00245,137260,84.17502,163065
1178,fregge,4,0.00245,137264,84.17748,163065
1179,fritterhoff,4,0.00245,137268,84.17993,163065
1180,FuKe,4,0.00245,137272,84.18238,163065
1181,fvitolo,4,0.00245,137276,84.18483,163065
1182,gcaranzo,4,0.00245,137280,84.18729,163065
1183,gcleaves,4,0.00245,137284,84.18974,163065
1184,gdelbos,4,0.00245,137288,84.19219,163065
1185,georgekankava,4,0.00245,137292,84.19465,163065
1186,giladsh1,4,0.00245,137296,84.19710,163065
1187,ginkel,4,0.00245,137300,84.19955,163065
1188,gitzalm,4,0.00245,137304,84.20201,163065
1189,gkdr,4,0.00245,137308,84.20446,163065
1190,Grandys,4,0.00245,137312,84.20691,163065
1191,grange74,4,0.00245,137316,84.20936,163065
1192,GregoireW,4,0.00245,137320,84.21182,163065
1193,hani647,4,0.00245,137324,84.21427,163065
1194,hanouard,4,0.00245,137328,84.21672,163065
1195,hariubc,4,0.00245,137332,84.21918,163065
1196,harmoney-franck,4,0.00245,137336,84.22163,163065
1197,hartror,4,0.00245,137340,84.22408,163065
1198,helaar,4,0.00245,137344,84.22654,163065
1199,hellofornow,4,0.00245,137348,84.22899,163065
1200,hodossy,4,0.00245,137352,84.23144,163065
1201,hongthang152,4,0.00245,137356,84.23389,163065
1202,howan36,4,0.00245,137360,84.23635,163065
1203,hrstn,4,0.00245,137364,84.23880,163065
1204,hstm,4,0.00245,137368,84.24125,163065
1205,humleflue,4,0.00245,137372,84.24371,163065
1206,ic2hrmk,4,0.00245,137376,84.24616,163065
1207,ihebhasni,4,0.00245,137380,84.24861,163065
1208,illes,4,0.00245,137384,84.25107,163065
1209,infl00p,4,0.00245,137388,84.25352,163065
1210,inoxx03,4,0.00245,137392,84.25597,163065
1211,jacegrantham,4,0.00245,137396,84.25842,163065
1212,jadecristal,4,0.00245,137400,84.26088,163065
1213,jamesmeneghello,4,0.00245,137404,84.26333,163065
1214,janbols,4,0.00245,137408,84.26578,163065
1215,jannes-io,4,0.00245,137412,84.26824,163065
1216,jardakotesovec,4,0.00245,137416,84.27069,163065
1217,JayAhn2,4,0.00245,137420,84.27314,163065
1218,jaysnm,4,0.00245,137424,84.27560,163065
1219,Jdiego06,4,0.00245,137428,84.27805,163065
1220,jimdillon,4,0.00245,137432,84.28050,163065
1221,jloupdef,4,0.00245,137436,84.28295,163065
1222,josh-cain,4,0.00245,137440,84.28541,163065
1223,jotamartos,4,0.00245,137444,84.28786,163065
1224,jstortoise,4,0.00245,137448,84.29031,163065
1225,Kagemusha-san,4,0.00245,137452,84.29277,163065
1226,kaja-mohideen,4,0.00245,137456,84.29522,163065
1227,kattasunil,4,0.00245,137460,84.29767,163065
1228,kbhuvan890,4,0.00245,137464,84.30013,163065
1229,kelfhk,4,0.00245,137468,84.30258,163065
1230,Kent1,4,0.00245,137472,84.30503,163065
1231,kesavkolla,4,0.00245,137476,84.30748,163065
1232,Ketec,4,0.00245,137480,84.30994,163065
1233,klajdipaja,4,0.00245,137484,84.31239,163065
1234,Korhm,4,0.00245,137488,84.31484,163065
1235,krivtsov,4,0.00245,137492,84.31730,163065
1236,kshen91,4,0.00245,137496,84.31975,163065
1237,ksteffe,4,0.00245,137500,84.32220,163065
1238,KyDenZ,4,0.00245,137504,84.32466,163065
1239,LiveSega,4,0.00245,137508,84.32711,163065
1240,ll4strw,4,0.00245,137512,84.32956,163065
1241,LordRazor,4,0.00245,137516,84.33201,163065
1242,LucaFilipozzi,4,0.00245,137520,84.33447,163065
1243,lutato,4,0.00245,137524,84.33692,163065
1244,ly123-liu,4,0.00245,137528,84.33937,163065
1245,m4rc77,4,0.00245,137532,84.34183,163065
1246,machielg,4,0.00245,137536,84.34428,163065
1247,MajorZiploc,4,0.00245,137540,84.34673,163065
1248,makaxel,4,0.00245,137544,84.34919,163065
1249,manaspatnaik,4,0.00245,137548,84.35164,163065
1250,marchalb,4,0.00245,137552,84.35409,163065
1251,mariapavlova,4,0.00245,137556,84.35654,163065
1252,MariiaAlekseichuk,4,0.00245,137560,84.35900,163065
1253,MarioSteinitz,4,0.00245,137564,84.36145,163065
1254,MariuszCwikla,4,0.00245,137568,84.36390,163065
1255,markus-csx,4,0.00245,137572,84.36636,163065
1256,mastery-amit-sahani,4,0.00245,137576,84.36881,163065
1257,matipp,4,0.00245,137580,84.37126,163065
1258,matt-l-w,4,0.00245,137584,84.37372,163065
1259,mbarbero,4,0.00245,137588,84.37617,163065
1260,mc-marcy,4,0.00245,137592,84.37862,163065
1261,mcsage,4,0.00245,137596,84.38108,163065
1262,mdomsch,4,0.00245,137600,84.38353,163065
1263,melahn,4,0.00245,137604,84.38598,163065
1264,Miguel-Bento-Github,4,0.00245,137608,84.38843,163065
1265,mihaipoenaru,4,0.00245,137612,84.39089,163065
1266,mihxil,4,0.00245,137616,84.39334,163065
1267,MikeShiner,4,0.00245,137620,84.39579,163065
1268,mildis,4,0.00245,137624,84.39825,163065
1269,miricy,4,0.00245,137628,84.40070,163065
1270,mixMugz,4,0.00245,137632,84.40315,163065
1271,morenod,4,0.00245,137636,84.40561,163065
1272,mparlee,4,0.00245,137640,84.40806,163065
1273,MrZajic,4,0.00245,137644,84.41051,163065
1274,msiegenthaler,4,0.00245,137648,84.41296,163065
1275,Mstrodl,4,0.00245,137652,84.41542,163065
1276,msuret,4,0.00245,137656,84.41787,163065
1277,nerumo,4,0.00245,137660,84.42032,163065
1278,nicholas-fwang,4,0.00245,137664,84.42278,163065
1279,nils-christian,4,0.00245,137668,84.42523,163065
1280,nkkumawat,4,0.00245,137672,84.42768,163065
1281,nodje,4,0.00245,137676,84.43014,163065
1282,Nogginboink,4,0.00245,137680,84.43259,163065
1283,nschwalbe,4,0.00245,137684,84.43504,163065
1284,nubbel,4,0.00245,137688,84.43749,163065
1285,nvp152,4,0.00245,137692,84.43995,163065
1286,nxpthx,4,0.00245,137696,84.44240,163065
1287,okuura,4,0.00245,137700,84.44485,163065
1288,oldluke92,4,0.00245,137704,84.44731,163065
1289,omasseau,4,0.00245,137708,84.44976,163065
1290,ombarek,4,0.00245,137712,84.45221,163065
1291,onigra,4,0.00245,137716,84.45467,163065
1292,onmomo,4,0.00245,137720,84.45712,163065
1293,oussamamzoughi,4,0.00245,137724,84.45957,163065
1294,pascal-hofmann,4,0.00245,137728,84.46202,163065
1295,PavanKalyan-Gandhapudi,4,0.00245,137732,84.46448,163065
1296,PavelPolyakov,4,0.00245,137736,84.46693,163065
1297,pazepaze,4,0.00245,137740,84.46938,163065
1298,phy25,4,0.00245,137744,84.47184,163065
1299,pipinet,4,0.00245,137748,84.47429,163065
1300,PJaroslaw,4,0.00245,137752,84.47674,163065
1301,pjbober,4,0.00245,137756,84.47920,163065
1302,please-openit,4,0.00245,137760,84.48165,163065
1303,prufrock,4,0.00245,137764,84.48410,163065
1304,pschyma,4,0.00245,137768,84.48655,163065
1305,pwright,4,0.00245,137772,84.48901,163065
1306,QumeaAP,4,0.00245,137776,84.49146,163065
1307,radiodup,4,0.00245,137780,84.49391,163065
1308,Raidok,4,0.00245,137784,84.49637,163065
1309,RaitoBezarius,4,0.00245,137788,84.49882,163065
1310,ramneekers,4,0.00245,137792,84.50127,163065
1311,RamonGebben,4,0.00245,137796,84.50373,163065
1312,RasmusBuchholdt,4,0.00245,137800,84.50618,163065
1313,RayDeCampo,4,0.00245,137804,84.50863,163065
1314,rckrdstrgrd,4,0.00245,137808,84.51108,163065
1315,reachtoamrita,4,0.00245,137812,84.51354,163065
1316,rejinka,4,0.00245,137816,84.51599,163065
1317,renannprado,4,0.00245,137820,84.51844,163065
1318,rfelgent,4,0.00245,137824,84.52090,163065
1319,rgherta,4,0.00245,137828,84.52335,163065
1320,Rick-T,4,0.00245,137832,84.52580,163065
1321,rigon,4,0.00245,137836,84.52826,163065
1322,rmjstn,4,0.00245,137840,84.53071,163065
1323,rodrik,4,0.00245,137844,84.53316,163065
1324,RomainBillot,4,0.00245,137848,84.53561,163065
1325,Ross-ForAllSecure,4,0.00245,137852,84.53807,163065
1326,rsenthilnathan25,4,0.00245,137856,84.54052,163065
1327,russsaidwords,4,0.00245,137860,84.54297,163065
1328,rvanderboom,4,0.00245,137864,84.54543,163065
1329,SaiUpadhyayula,4,0.00245,137868,84.54788,163065
1330,sakanaou,4,0.00245,137872,84.55033,163065
1331,sampsonj,4,0.00245,137876,84.55279,163065
1332,Sascha-Block,4,0.00245,137880,84.55524,163065
1333,satyakresna,4,0.00245,137884,84.55769,163065
1334,schuerg,4,0.00245,137888,84.56014,163065
1335,sdesbois,4,0.00245,137892,84.56260,163065
1336,seb54000,4,0.00245,137896,84.56505,163065
1337,SebastianThorn,4,0.00245,137900,84.56750,163065
1338,selimslab,4,0.00245,137904,84.56996,163065
1339,senaev,4,0.00245,137908,84.57241,163065
1340,ser,4,0.00245,137912,84.57486,163065
1341,sergioifg94,4,0.00245,137916,84.57732,163065
1342,seth-xdam,4,0.00245,137920,84.57977,163065
1343,silviokennecke,4,0.00245,137924,84.58222,163065
1344,Skrethel,4,0.00245,137928,84.58467,163065
1345,snicoll,4,0.00245,137932,84.58713,163065
1346,SNiemann15,4,0.00245,137936,84.58958,163065
1347,somaSzolyak,4,0.00245,137940,84.59203,163065
1348,sonnb,4,0.00245,137944,84.59449,163065
1349,soundsessential,4,0.00245,137948,84.59694,163065
1350,Spittal,4,0.00245,137952,84.59939,163065
1351,spurreiter,4,0.00245,137956,84.60185,163065
1352,Spyna,4,0.00245,137960,84.60430,163065
1353,starJammer,4,0.00245,137964,84.60675,163065
1354,StitzL,4,0.00245,137968,84.60920,163065
1355,suchorski,4,0.00245,137972,84.61166,163065
1356,Suhita1234,4,0.00245,137976,84.61411,163065
1357,sum117,4,0.00245,137980,84.61656,163065
1358,summersab,4,0.00245,137984,84.61902,163065
1359,SuperSandro2000,4,0.00245,137988,84.62147,163065
1360,sutr90,4,0.00245,137992,84.62392,163065
1361,T0miii,4,0.00245,137996,84.62638,163065
1362,tanadeau,4,0.00245,138000,84.62883,163065
1363,tangtang95,4,0.00245,138004,84.63128,163065
1364,tarasstasyuk,4,0.00245,138008,84.63374,163065
1365,tea-mo903,4,0.00245,138012,84.63619,163065
1366,TheCodeDestroyer,4,0.00245,138016,84.63864,163065
1367,ThijsBroersen,4,0.00245,138020,84.64109,163065
1368,Thing342,4,0.00245,138024,84.64355,163065
1369,tilothiele,4,0.00245,138028,84.64600,163065
1370,tim-hanssen,4,0.00245,138032,84.64845,163065
1371,tkucuk,4,0.00245,138036,84.65091,163065
1372,tookeyc,4,0.00245,138040,84.65336,163065
1373,toyaser,4,0.00245,138044,84.65581,163065
1374,transducer,4,0.00245,138048,84.65827,163065
1375,tspringr,4,0.00245,138052,84.66072,163065
1376,tuxtux59,4,0.00245,138056,84.66317,163065
1377,ulrik-s,4,0.00245,138060,84.66562,163065
1378,uwieske,4,0.00245,138064,84.66808,163065
1379,v1nc3nt27,4,0.00245,138068,84.67053,163065
1380,ValentinH,4,0.00245,138072,84.67298,163065
1381,vidi42,4,0.00245,138076,84.67544,163065
1382,v-kamerdinerov,4,0.00245,138080,84.67789,163065
1383,VMM-Mtech,4,0.00245,138084,84.68034,163065
1384,wadael,4,0.00245,138088,84.68280,163065
1385,WestFarmer,4,0.00245,138092,84.68525,163065
1386,Wimmerke,4,0.00245,138096,84.68770,163065
1387,xCryzed,4,0.00245,138100,84.69015,163065
1388,xiaoanne,4,0.00245,138104,84.69261,163065
1389,xoxys,4,0.00245,138108,84.69506,163065
1390,yarons,4,0.00245,138112,84.69751,163065
1391,ykun91,4,0.00245,138116,84.69997,163065
1392,yo1000,4,0.00245,138120,84.70242,163065
1393,yoransabern,4,0.00245,138124,84.70487,163065
1394,yueyub,4,0.00245,138128,84.70733,163065
1395,zhandospdf,4,0.00245,138132,84.70978,163065
1396,zhuqingcui,4,0.00245,138136,84.71223,163065
1397,10101010101010001,3,0.00184,138139,84.71407,163065
1398,9p4,3,0.00184,138142,84.71591,163065
1399,adaumann,3,0.00184,138145,84.71775,163065
1400,ADiTuri,3,0.00184,138148,84.71959,163065
1401,afilippov-re,3,0.00184,138151,84.72143,163065
1402,agaman1792,3,0.00184,138154,84.72327,163065
1403,agolPL,3,0.00184,138157,84.72511,163065
1404,albertmolinermrf,3,0.00184,138160,84.72695,163065
1405,alcidesmig,3,0.00184,138163,84.72879,163065
1406,aletundo,3,0.00184,138166,84.73063,163065
1407,alexandershiltcev-gelato,3,0.00184,138169,84.73247,163065
1408,alexeytopolnitskiy,3,0.00184,138172,84.73431,163065
1409,alexpdp7,3,0.00184,138175,84.73615,163065
1410,algakzru,3,0.00184,138178,84.73799,163065
1411,alias5gar,3,0.00184,138181,84.73983,163065
1412,AlicanAkkus,3,0.00184,138184,84.74167,163065
1413,alirf81,3,0.00184,138187,84.74351,163065
1414,allahshukur-ahmadzada,3,0.00184,138190,84.74535,163065
1415,alliedgorn,3,0.00184,138193,84.74719,163065
1416,amireddym,3,0.00184,138196,84.74903,163065
1417,anasabdullahysfzai,3,0.00184,138199,84.75087,163065
1418,andban,3,0.00184,138202,84.75271,163065
1419,andreasbalevik,3,0.00184,138205,84.75455,163065
1420,AndreasSi,3,0.00184,138208,84.75639,163065
1421,anillewis,3,0.00184,138211,84.75823,163065
1422,annasarte,3,0.00184,138214,84.76007,163065
1423,anonrig,3,0.00184,138217,84.76190,163065
1424,Antje3,3,0.00184,138220,84.76374,163065
1425,AntoineAtLeocare,3,0.00184,138223,84.76558,163065
1426,antoine-roux,3,0.00184,138226,84.76742,163065
1427,anttileppa,3,0.00184,138229,84.76926,163065
1428,anuragpathak21,3,0.00184,138232,84.77110,163065
1429,arcandspark,3,0.00184,138235,84.77294,163065
1430,arend-von-reinersdorff,3,0.00184,138238,84.77478,163065
1431,aresabalo,3,0.00184,138241,84.77662,163065
1432,artemkrim,3,0.00184,138244,84.77846,163065
1433,ashleyww93,3,0.00184,138247,84.78030,163065
1434,astanik,3,0.00184,138250,84.78214,163065
1435,ataraxus,3,0.00184,138253,84.78398,163065
1436,atosscsd-bb,3,0.00184,138256,84.78582,163065
1437,avl-team-pandas,3,0.00184,138259,84.78766,163065
1438,AWodarczyk,3,0.00184,138262,84.78950,163065
1439,awoimbee,3,0.00184,138265,84.79134,163065
1440,AyushiKesarwani,3,0.00184,138268,84.79318,163065
1441,bamanuel,3,0.00184,138271,84.79502,163065
1442,bandrzejczak,3,0.00184,138274,84.79686,163065
1443,beejaygee,3,0.00184,138277,84.79870,163065
1444,beenham,3,0.00184,138280,84.80054,163065
1445,berendjan,3,0.00184,138283,84.80238,163065
1446,bf,3,0.00184,138286,84.80422,163065
1447,bhatpmk,3,0.00184,138289,84.80606,163065
1448,biswassampad,3,0.00184,138292,84.80790,163065
1449,blackandcold,3,0.00184,138295,84.80974,163065
1450,BlackKerio,3,0.00184,138298,84.81158,163065
1451,blakesmith,3,0.00184,138301,84.81342,163065
1452,blazing234,3,0.00184,138304,84.81526,163065
1453,BLeQuerrec,3,0.00184,138307,84.81710,163065
1454,bogbert,3,0.00184,138310,84.81894,163065
1455,bojanbass,3,0.00184,138313,84.82078,163065
1456,bonky42,3,0.00184,138316,84.82262,163065
1457,borrible13th,3,0.00184,138319,84.82446,163065
1458,borudena,3,0.00184,138322,84.82630,163065
1459,bovinemagnet,3,0.00184,138325,84.82814,163065
1460,bplotnick-humane,3,0.00184,138328,84.82998,163065
1461,BrianSiimAndersenEG,3,0.00184,138331,84.83182,163065
1462,bugsbunnyshah,3,0.00184,138334,84.83366,163065
1463,bvklingeren,3,0.00184,138337,84.83550,163065
1464,bxc2739,3,0.00184,138340,84.83733,163065
1465,c3s4r,3,0.00184,138343,84.83917,163065
1466,calh,3,0.00184,138346,84.84101,163065
1467,cascer1,3,0.00184,138349,84.84285,163065
1468,cdecinkoKnight,3,0.00184,138352,84.84469,163065
1469,cdemnkey,3,0.00184,138355,84.84653,163065
1470,cghislai,3,0.00184,138358,84.84837,163065
1471,ch4mpy,3,0.00184,138361,84.85021,163065
1472,Checksum,3,0.00184,138364,84.85205,163065
1473,chinukrish,3,0.00184,138367,84.85389,163065
1474,chris246,3,0.00184,138370,84.85573,163065
1475,christian-2,3,0.00184,138373,84.85757,163065
1476,christoph-theunert,3,0.00184,138376,84.85941,163065
1477,ciphermenial,3,0.00184,138379,84.86125,163065
1478,claytongulick,3,0.00184,138382,84.86309,163065
1479,ClemensSahs,3,0.00184,138385,84.86493,163065
1480,cm253,3,0.00184,138388,84.86677,163065
1481,cocotton,3,0.00184,138391,84.86861,163065
1482,code-vineet,3,0.00184,138394,84.87045,163065
1483,codrinbucur,3,0.00184,138397,84.87229,163065
1484,coelias,3,0.00184,138400,84.87413,163065
1485,col-panic,3,0.00184,138403,84.87597,163065
1486,Conosci,3,0.00184,138406,84.87781,163065
1487,cooper-lyt,3,0.00184,138409,84.87965,163065
1488,creckord,3,0.00184,138412,84.88149,163065
1489,cristinaaanguyen,3,0.00184,138415,84.88333,163065
1490,Crumby,3,0.00184,138418,84.88517,163065
1491,ctomc,3,0.00184,138421,84.88701,163065
1492,ctruchi,3,0.00184,138424,84.88885,163065
1493,cturkalj,3,0.00184,138427,84.89069,163065
1494,cveilleux,3,0.00184,138430,84.89253,163065
1495,cwalker67,3,0.00184,138433,84.89437,163065
1496,cwchristerw,3,0.00184,138436,84.89621,163065
1497,dalu,3,0.00184,138439,84.89805,163065
1498,DamienBoue,3,0.00184,138442,84.89989,163065
1499,damnedOperator,3,0.00184,138445,84.90173,163065
1500,DanApostol,3,0.00184,138448,84.90357,163065
1501,DanielScholte,3,0.00184,138451,84.90541,163065
1502,darabos,3,0.00184,138454,84.90725,163065
1503,dario-campagna,3,0.00184,138457,84.90909,163065
1504,DarrenCook,3,0.00184,138460,84.91093,163065
1505,datacoderid,3,0.00184,138463,84.91276,163065
1506,Davidgiordano74,3,0.00184,138466,84.91460,163065
1507,ddezoysa,3,0.00184,138469,84.91644,163065
1508,ddowling-act,3,0.00184,138472,84.91828,163065
1509,ddrachau,3,0.00184,138475,84.92012,163065
1510,deadlysyn,3,0.00184,138478,84.92196,163065
1511,debovema,3,0.00184,138481,84.92380,163065
1512,deelthor,3,0.00184,138484,84.92564,163065
1513,Delirante,3,0.00184,138487,84.92748,163065
1514,DelusionalLogic,3,0.00184,138490,84.92932,163065
1515,DerGreul,3,0.00184,138493,84.93116,163065
1516,dhardiker,3,0.00184,138496,84.93300,163065
1517,dheeraj-326,3,0.00184,138499,84.93484,163065
1518,diaboy96,3,0.00184,138502,84.93668,163065
1519,diazoxide,3,0.00184,138505,84.93852,163065
1520,dibenlloch,3,0.00184,138508,84.94036,163065
1521,Dichotomia,3,0.00184,138511,84.94220,163065
1522,dlisin,3,0.00184,138514,84.94404,163065
1523,DmitryZagr,3,0.00184,138517,84.94588,163065
1524,DmitryZ-outten,3,0.00184,138520,84.94772,163065
1525,dnz-bdeboer,3,0.00184,138523,84.94956,163065
1526,domids,3,0.00184,138526,84.95140,163065
1527,domsew,3,0.00184,138529,84.95324,163065
1528,dongay,3,0.00184,138532,84.95508,163065
1529,doublechecker,3,0.00184,138535,84.95692,163065
1530,Download,3,0.00184,138538,84.95876,163065
1531,dqvn,3,0.00184,138541,84.96060,163065
1532,DrPsychick,3,0.00184,138544,84.96244,163065
1533,dstefanMSFT,3,0.00184,138547,84.96428,163065
1534,dwaynebailey,3,0.00184,138550,84.96612,163065
1535,dweirshousky-xsb,3,0.00184,138553,84.96796,163065
1536,e36Alex,3,0.00184,138556,84.96980,163065
1537,easpeagle,3,0.00184,138559,84.97164,163065
1538,ebaali,3,0.00184,138562,84.97348,163065
1539,elirenato,3,0.00184,138565,84.97532,163065
1540,Elwell,3,0.00184,138568,84.97716,163065
1541,EmpathicKernel,3,0.00184,138571,84.97900,163065
1542,emreisler,3,0.00184,138574,84.98084,163065
1543,eppsilon,3,0.00184,138577,84.98268,163065
1544,ercpe,3,0.00184,138580,84.98452,163065
1545,ErenYeager80,3,0.00184,138583,84.98636,163065
1546,erobinson,3,0.00184,138586,84.98819,163065
1547,esanya,3,0.00184,138589,84.99003,163065
1548,Esya,3,0.00184,138592,84.99187,163065
1549,ewo2022,3,0.00184,138595,84.99371,163065
1550,Fabian1976,3,0.00184,138598,84.99555,163065
1551,falleneko,3,0.00184,138601,84.99739,163065
1552,fbladilo,3,0.00184,138604,84.99923,163065
1553,felipeavilis,3,0.00184,138607,85.00107,163065
1554,fezi,3,0.00184,138610,85.00291,163065
1555,fgsasha,3,0.00184,138613,85.00475,163065
1556,filipeferraz,3,0.00184,138616,85.00659,163065
1557,Flingoo,3,0.00184,138619,85.00843,163065
1558,Flintholm,3,0.00184,138622,85.01027,163065
1559,f-marino,3,0.00184,138625,85.01211,163065
1560,foosinn,3,0.00184,138628,85.01395,163065
1561,frantello,3,0.00184,138631,85.01579,163065
1562,FreeK,3,0.00184,138634,85.01763,163065
1563,fuero,3,0.00184,138637,85.01947,163065
1564,fuomag9,3,0.00184,138640,85.02131,163065
1565,fwhenin,3,0.00184,138643,85.02315,163065
1566,FX-HAO,3,0.00184,138646,85.02499,163065
1567,GauthierD-,3,0.00184,138649,85.02683,163065
1568,GeertvanHorrik,3,0.00184,138652,85.02867,163065
1569,gencube,3,0.00184,138655,85.03051,163065
1570,GeorgEchterling,3,0.00184,138658,85.03235,163065
1571,GerhardMassenbichler,3,0.00184,138661,85.03419,163065
1572,gfsolis,3,0.00184,138664,85.03603,163065
1573,ghilainm,3,0.00184,138667,85.03787,163065
1574,GithubUser8080,3,0.00184,138670,85.03971,163065
1575,gitreelike,3,0.00184,138673,85.04155,163065
1576,gkfirst8,3,0.00184,138676,85.04339,163065
1577,goldcome,3,0.00184,138679,85.04523,163065
1578,gopalkrishnams,3,0.00184,138682,85.04707,163065
1579,GOVYANSONG,3,0.00184,138685,85.04891,163065
1580,greglloyd-t3,3,0.00184,138688,85.05075,163065
1581,gueuselambix,3,0.00184,138691,85.05259,163065
1582,Guite,3,0.00184,138694,85.05443,163065
1583,gunayus,3,0.00184,138697,85.05627,163065
1584,h1f1x,3,0.00184,138700,85.05811,163065
1585,haassConnyun,3,0.00184,138703,85.05995,163065
1586,HabooshHaddad,3,0.00184,138706,85.06179,163065
1587,hamnis,3,0.00184,138709,85.06362,163065
1588,Handfish,3,0.00184,138712,85.06546,163065
1589,hausanstreicha,3,0.00184,138715,85.06730,163065
1590,hawknewton,3,0.00184,138718,85.06914,163065
1591,hbsnmyj,3,0.00184,138721,85.07098,163065
1592,Hdz,3,0.00184,138724,85.07282,163065
1593,hedgss,3,0.00184,138727,85.07466,163065
1594,heikkilamarko,3,0.00184,138730,85.07650,163065
1595,helmutct,3,0.00184,138733,85.07834,163065
1596,hendrik-schaffer,3,0.00184,138736,85.08018,163065
1597,Heromyth,3,0.00184,138739,85.08202,163065
1598,hhromic,3,0.00184,138742,85.08386,163065
1599,holema,3,0.00184,138745,85.08570,163065
1600,howcroft,3,0.00184,138748,85.08754,163065
1601,HwangTaehyun,3,0.00184,138751,85.08938,163065
1602,hybmg57,3,0.00184,138754,85.09122,163065
1603,iamsharife,3,0.00184,138757,85.09306,163065
1604,iconoeugen,3,0.00184,138760,85.09490,163065
1605,ignaciostellino,3,0.00184,138763,85.09674,163065
1606,igor-nikiforov,3,0.00184,138766,85.09858,163065
1607,ihard,3,0.00184,138769,85.10042,163065
1608,ikwattro,3,0.00184,138772,85.10226,163065
1609,ilhan-mstf,3,0.00184,138775,85.10410,163065
1610,indiealexh,3,0.00184,138778,85.10594,163065
1611,InterStelli,3,0.00184,138781,85.10778,163065
1612,irv075,3,0.00184,138784,85.10962,163065
1613,isfong,3,0.00184,138787,85.11146,163065
1614,Ismaestro,3,0.00184,138790,85.11330,163065
1615,istvandesign,3,0.00184,138793,85.11514,163065
1616,ivenpoker,3,0.00184,138796,85.11698,163065
1617,iWangJiaxiang,3,0.00184,138799,85.11882,163065
1618,j0nm1,3,0.00184,138802,85.12066,163065
1619,jacac,3,0.00184,138805,85.12250,163065
1620,jacekkow,3,0.00184,138808,85.12434,163065
1621,jahenaor,3,0.00184,138811,85.12618,163065
1622,jairsjunior,3,0.00184,138814,85.12802,163065
1623,JakobMiksch,3,0.00184,138817,85.12986,163065
1624,jameshcovington,3,0.00184,138820,85.13170,163065
1625,javacup,3,0.00184,138823,85.13354,163065
1626,jcarlosmm,3,0.00184,138826,85.13538,163065
1627,jcz1,3,0.00184,138829,85.13722,163065
1628,jdelker,3,0.00184,138832,85.13905,163065
1629,jerosa,3,0.00184,138835,85.14089,163065
1630,jesaavedrav,3,0.00184,138838,85.14273,163065
1631,jeswinsimon,3,0.00184,138841,85.14457,163065
1632,jfmeachum,3,0.00184,138844,85.14641,163065
1633,jgiovaresco,3,0.00184,138847,85.14825,163065
1634,joaedwar,3,0.00184,138850,85.15009,163065
1635,JohnBoyB,3,0.00184,138853,85.15193,163065
1636,johnpoth,3,0.00184,138856,85.15377,163065
1637,JonathanWilbur,3,0.00184,138859,85.15561,163065
1638,Joncheski,3,0.00184,138862,85.15745,163065
1639,JPercivall,3,0.00184,138865,85.15929,163065
1640,jschonenberg,3,0.00184,138868,85.16113,163065
1641,jsemohub,3,0.00184,138871,85.16297,163065
1642,jseparovic,3,0.00184,138874,85.16481,163065
1643,jtyrrell-se-jboss,3,0.00184,138877,85.16665,163065
1644,julienmachon,3,0.00184,138880,85.16849,163065
1645,kaenganxt,3,0.00184,138883,85.17033,163065
1646,kafeltz,3,0.00184,138886,85.17217,163065
1647,Kalithasan-Periyasamy,3,0.00184,138889,85.17401,163065
1648,kamuridesu,3,0.00184,138892,85.17585,163065
1649,kardan,3,0.00184,138895,85.17769,163065
1650,kbrabrand,3,0.00184,138898,85.17953,163065
1651,kereis,3,0.00184,138901,85.18137,163065
1652,kerruba-milkman,3,0.00184,138904,85.18321,163065
1653,kevin-cuijpers,3,0.00184,138907,85.18505,163065
1654,kevinswarner,3,0.00184,138910,85.18689,163065
1655,keycloakrules420,3,0.00184,138913,85.18873,163065
1656,Khvatov-Alexey,3,0.00184,138916,85.19057,163065
1657,kinjelom,3,0.00184,138919,85.19241,163065
1658,KirschbaumP,3,0.00184,138922,85.19425,163065
1659,KirylBokiy,3,0.00184,138925,85.19609,163065
1660,klunk66,3,0.00184,138928,85.19793,163065
1661,knoppt,3,0.00184,138931,85.19977,163065
1662,kodemaniak,3,0.00184,138934,85.20161,163065
1663,kolsys,3,0.00184,138937,85.20345,163065
1664,korkutkose,3,0.00184,138940,85.20529,163065
1665,korridor,3,0.00184,138943,85.20713,163065
1666,kpritam,3,0.00184,138946,85.20897,163065
1667,krasholo,3,0.00184,138949,85.21081,163065
1668,kstekovi,3,0.00184,138952,85.21265,163065
1669,kurianbenoy-aot,3,0.00184,138955,85.21449,163065
1670,kushtrimh,3,0.00184,138958,85.21632,163065
1671,kwoot,3,0.00184,138961,85.21816,163065
1672,kyjo,3,0.00184,138964,85.22000,163065
1673,kz-masa,3,0.00184,138967,85.22184,163065
1674,lanfix,3,0.00184,138970,85.22368,163065
1675,Laurenzi,3,0.00184,138973,85.22552,163065
1676,laurids,3,0.00184,138976,85.22736,163065
1677,lauritzh,3,0.00184,138979,85.22920,163065
1678,lazka,3,0.00184,138982,85.23104,163065
1679,LecrisUT,3,0.00184,138985,85.23288,163065
1680,leehambley,3,0.00184,138988,85.23472,163065
1681,leehendricks,3,0.00184,138991,85.23656,163065
1682,lfelipevc,3,0.00184,138994,85.23840,163065
1683,life-tushar1,3,0.00184,138997,85.24024,163065
1684,linarphy,3,0.00184,139000,85.24208,163065
1685,linkafsar,3,0.00184,139003,85.24392,163065
1686,lmm-git,3,0.00184,139006,85.24576,163065
1687,lmorningstar116,3,0.00184,139009,85.24760,163065
1688,lmorocz,3,0.00184,139012,85.24944,163065
1689,lmsurpre,3,0.00184,139015,85.25128,163065
1690,LoganKnechtMagicLeap,3,0.00184,139018,85.25312,163065
1691,losblancos113,3,0.00184,139021,85.25496,163065
1692,lounsbrough,3,0.00184,139024,85.25680,163065
1693,lpetit-yseop,3,0.00184,139027,85.25864,163065
1694,l-robinson,3,0.00184,139030,85.26048,163065
1695,ltressens,3,0.00184,139033,85.26232,163065
1696,Lukas0907,3,0.00184,139036,85.26416,163065
1697,Luthien-in-edhil,3,0.00184,139039,85.26600,163065
1698,m2minthemeadow,3,0.00184,139042,85.26784,163065
1699,Madmess,3,0.00184,139045,85.26968,163065
1700,magalhaes-andre,3,0.00184,139048,85.27152,163065
1701,maksym-plotnikov,3,0.00184,139051,85.27336,163065
1702,malejpavouk,3,0.00184,139054,85.27520,163065
1703,Mango2020,3,0.00184,139057,85.27704,163065
1704,manu11th,3,0.00184,139060,85.27888,163065
1705,maramazza,3,0.00184,139063,85.28072,163065
1706,MarcelCoding,3,0.00184,139066,85.28256,163065
1707,marcels2204,3,0.00184,139069,85.28440,163065
1708,marcuskmw,3,0.00184,139072,85.28624,163065
1709,MarkCupitt,3,0.00184,139075,85.28808,163065
1710,MarkusTStecher,3,0.00184,139078,85.28992,163065
1711,martin-scheelke,3,0.00184,139081,85.29175,163065
1712,marwalsch,3,0.00184,139084,85.29359,163065
1713,matejonnet,3,0.00184,139087,85.29543,163065
1714,matthiasfeist,3,0.00184,139090,85.29727,163065
1715,matt-rauch,3,0.00184,139093,85.29911,163065
1716,maurizio-catellani,3,0.00184,139096,85.30095,163065
1717,MaximilianClemens,3,0.00184,139099,85.30279,163065
1718,MaximVetlugin,3,0.00184,139102,85.30463,163065
1719,mbrugger,3,0.00184,139105,85.30647,163065
1720,mcruzdev,3,0.00184,139108,85.30831,163065
1721,mdunisch,3,0.00184,139111,85.31015,163065
1722,megamorf,3,0.00184,139114,85.31199,163065
1723,mehdiMj-ir,3,0.00184,139117,85.31383,163065
1724,mehtadev17,3,0.00184,139120,85.31567,163065
1725,merajsiddiqui,3,0.00184,139123,85.31751,163065
1726,metametadata,3,0.00184,139126,85.31935,163065
1727,MFAshby,3,0.00184,139129,85.32119,163065
1728,michaelaird,3,0.00184,139132,85.32303,163065
1729,michael-connolly236,3,0.00184,139135,85.32487,163065
1730,michelpromonet,3,0.00184,139138,85.32671,163065
1731,michielpeeters,3,0.00184,139141,85.32855,163065
1732,MiGrandjean,3,0.00184,139144,85.33039,163065
1733,miguel-castro-nearseatech,3,0.00184,139147,85.33223,163065
1734,MikeK184,3,0.00184,139150,85.33407,163065
1735,missourian55,3,0.00184,139153,85.33591,163065
1736,mitko501,3,0.00184,139156,85.33775,163065
1737,mkausl,3,0.00184,139159,85.33959,163065
1738,mkreis,3,0.00184,139162,85.34143,163065
1739,mkucharsky,3,0.00184,139165,85.34327,163065
1740,momoirodouhu,3,0.00184,139168,85.34511,163065
1741,monzonj,3,0.00184,139171,85.34695,163065
1742,motiejuss,3,0.00184,139174,85.34879,163065
1743,mpareja,3,0.00184,139177,85.35063,163065
1744,mpaulgreen,3,0.00184,139180,85.35247,163065
1745,MrDeerly,3,0.00184,139183,85.35431,163065
1746,MRJCrunch,3,0.00184,139186,85.35615,163065
1747,mrodrigo-nexplore,3,0.00184,139189,85.35799,163065
1748,mrooding,3,0.00184,139192,85.35983,163065
1749,mrpardijs,3,0.00184,139195,85.36167,163065
1750,mrshu,3,0.00184,139198,85.36351,163065
1751,mruzicka,3,0.00184,139201,85.36535,163065
1752,MS699,3,0.00184,139204,85.36718,163065
1753,mspasiano,3,0.00184,139207,85.36902,163065
1754,muhe001,3,0.00184,139210,85.37086,163065
1755,mvicomoya,3,0.00184,139213,85.37270,163065
1756,mwaldstein,3,0.00184,139216,85.37454,163065
1757,mwalser,3,0.00184,139219,85.37638,163065
1758,m-wcislo,3,0.00184,139222,85.37822,163065
1759,Nannymeta,3,0.00184,139225,85.38006,163065
1760,nathanejohnson,3,0.00184,139228,85.38190,163065
1761,naushadh,3,0.00184,139231,85.38374,163065
1762,naveenbharadwaj-nc,3,0.00184,139234,85.38558,163065
1763,navrocky,3,0.00184,139237,85.38742,163065
1764,N-Coder,3,0.00184,139240,85.38926,163065
1765,netdip,3,0.00184,139243,85.39110,163065
1766,Neutius,3,0.00184,139246,85.39294,163065
1767,nfreader,3,0.00184,139249,85.39478,163065
1768,nickzelei,3,0.00184,139252,85.39662,163065
1769,nicolasbenoist,3,0.00184,139255,85.39846,163065
1770,NicolasRouffart,3,0.00184,139258,85.40030,163065
1771,nigredo-tori,3,0.00184,139261,85.40214,163065
1772,nikolay-govorov,3,0.00184,139264,85.40398,163065
1773,Nillth,3,0.00184,139267,85.40582,163065
1774,noamsan,3,0.00184,139270,85.40766,163065
1775,npongracic,3,0.00184,139273,85.40950,163065
1776,nsriram,3,0.00184,139276,85.41134,163065
1777,nury-garryyev,3,0.00184,139279,85.41318,163065
1778,ocafebabe,3,0.00184,139282,85.41502,163065
1779,ogaston,3,0.00184,139285,85.41686,163065
1780,oliverabclabs,3,0.00184,139288,85.41870,163065
1781,Olivier-Le-Rigoleur-Acc,3,0.00184,139291,85.42054,163065
1782,opdt,3,0.00184,139294,85.42238,163065
1783,opuertas,3,0.00184,139297,85.42422,163065
1784,oranki,3,0.00184,139300,85.42606,163065
1785,orcunozbay,3,0.00184,139303,85.42790,163065
1786,Orygin,3,0.00184,139306,85.42974,163065
1787,osama-ahmed-wiz,3,0.00184,139309,85.43158,163065
1788,oscar-b,3,0.00184,139312,85.43342,163065
1789,OS-jayanthsanganabatla,3,0.00184,139315,85.43526,163065
1790,os-maroc,3,0.00184,139318,85.43710,163065
1791,oteichmann,3,0.00184,139321,85.43894,163065
1792,ovshevchuk,3,0.00184,139324,85.44078,163065
1793,patlachance,3,0.00184,139327,85.44261,163065
1794,Patre,3,0.00184,139330,85.44445,163065
1795,PatrickMadden,3,0.00184,139333,85.44629,163065
1796,patrik-upspot,3,0.00184,139336,85.44813,163065
1797,patternseek,3,0.00184,139339,85.44997,163065
1798,Paul6552,3,0.00184,139342,85.45181,163065
1799,PavelJacobo,3,0.00184,139345,85.45365,163065
1800,pckhoi,3,0.00184,139348,85.45549,163065
1801,periurium,3,0.00184,139351,85.45733,163065
1802,PerryTheCoder,3,0.00184,139354,85.45917,163065
1803,pfpulux,3,0.00184,139357,85.46101,163065
1804,pgbezerra,3,0.00184,139360,85.46285,163065
1805,pherman,3,0.00184,139363,85.46469,163065
1806,PhilippeVienne,3,0.00184,139366,85.46653,163065
1807,phillipj,3,0.00184,139369,85.46837,163065
1808,phowells,3,0.00184,139372,85.47021,163065
1809,Pirayya,3,0.00184,139375,85.47205,163065
1810,pjammula,3,0.00184,139378,85.47389,163065
1811,platof,3,0.00184,139381,85.47573,163065
1812,Playmountain,3,0.00184,139384,85.47757,163065
1813,pleic,3,0.00184,139387,85.47941,163065
1814,pmorettiharris,3,0.00184,139390,85.48125,163065
1815,pramodprk,3,0.00184,139393,85.48309,163065
1816,pratapkonakala,3,0.00184,139396,85.48493,163065
1817,primillet,3,0.00184,139399,85.48677,163065
1818,prisamuel,3,0.00184,139402,85.48861,163065
1819,priyanka-5,3,0.00184,139405,85.49045,163065
1820,proffase,3,0.00184,139408,85.49229,163065
1821,psevestre,3,0.00184,139411,85.49413,163065
1822,pshafer-als,3,0.00184,139414,85.49597,163065
1823,ptemplier,3,0.00184,139417,85.49781,163065
1824,ptpcy,3,0.00184,139420,85.49965,163065
1825,pulgupta,3,0.00184,139423,85.50149,163065
1826,QuadStingray,3,0.00184,139426,85.50333,163065
1827,r3st,3,0.00184,139429,85.50517,163065
1828,railsstudent,3,0.00184,139432,85.50701,163065
1829,rajeevBlr,3,0.00184,139435,85.50885,163065
1830,rajibhalder,3,0.00184,139438,85.51069,163065
1831,ravinderpayal,3,0.00184,139441,85.51253,163065
1832,razi-ahmad,3,0.00184,139444,85.51437,163065
1833,rbbl-dev,3,0.00184,139447,85.51621,163065
1834,rbri,3,0.00184,139450,85.51804,163065
1835,rdenadai,3,0.00184,139453,85.51988,163065
1836,realityforge,3,0.00184,139456,85.52172,163065
1837,ricehull,3,0.00184,139459,85.52356,163065
1838,ririsoft,3,0.00184,139462,85.52540,163065
1839,RiskManagementGroup,3,0.00184,139465,85.52724,163065
1840,rjokelai,3,0.00184,139468,85.52908,163065
1841,Robespierre19,3,0.00184,139471,85.53092,163065
1842,Robiwahn23,3,0.00184,139474,85.53276,163065
1843,RoiEXLab,3,0.00184,139477,85.53460,163065
1844,rokkiter,3,0.00184,139480,85.53644,163065
1845,rosariop,3,0.00184,139483,85.53828,163065
1846,rtribotte,3,0.00184,139486,85.54012,163065
1847,ruchg1337,3,0.00184,139489,85.54196,163065
1848,RVSO-NC,3,0.00184,139492,85.54380,163065
1849,Sabari22shankar,3,0.00184,139495,85.54564,163065
1850,Salvatore-Als,3,0.00184,139498,85.54748,163065
1851,Saman-jafari,3,0.00184,139501,85.54932,163065
1852,samdidos,3,0.00184,139504,85.55116,163065
1853,samuelMangot,3,0.00184,139507,85.55300,163065
1854,samuelspagl,3,0.00184,139510,85.55484,163065
1855,sandeepvarma95,3,0.00184,139513,85.55668,163065
1856,sankks,3,0.00184,139516,85.55852,163065
1857,sarveshtamba,3,0.00184,139519,85.56036,163065
1858,Sazzels,3,0.00184,139522,85.56220,163065
1859,sbs101,3,0.00184,139525,85.56404,163065
1860,sbusch,3,0.00184,139528,85.56588,163065
1861,schewara,3,0.00184,139531,85.56772,163065
1862,schtrym,3,0.00184,139534,85.56956,163065
1863,sebastianhaeni,3,0.00184,139537,85.57140,163065
1864,sebbrousse,3,0.00184,139540,85.57324,163065
1865,Secarius,3,0.00184,139543,85.57508,163065
1866,Seenox,3,0.00184,139546,85.57692,163065
1867,Sh0TGuN,3,0.00184,139549,85.57876,163065
1868,shamilsun,3,0.00184,139552,85.58060,163065
1869,shane-1,3,0.00184,139555,85.58244,163065
1870,ShivanKKP,3,0.00184,139558,85.58428,163065
1871,shmocs,3,0.00184,139561,85.58612,163065
1872,siddisking,3,0.00184,139564,85.58796,163065
1873,sidguptajhs,3,0.00184,139567,85.58980,163065
1874,simenheg,3,0.00184,139570,85.59164,163065
1875,sjvs,3,0.00184,139573,85.59347,163065
1876,skhro87,3,0.00184,139576,85.59531,163065
1877,Skiepp,3,0.00184,139579,85.59715,163065
1878,skug67,3,0.00184,139582,85.59899,163065
1879,SLorscheid,3,0.00184,139585,85.60083,163065
1880,sma1212,3,0.00184,139588,85.60267,163065
1881,Sobakaa,3,0.00184,139591,85.60451,163065
1882,soufian044,3,0.00184,139594,85.60635,163065
1883,spoore1,3,0.00184,139597,85.60819,163065
1884,srad,3,0.00184,139600,85.61003,163065
1885,srehorn,3,0.00184,139603,85.61187,163065
1886,staedter,3,0.00184,139606,85.61371,163065
1887,starksm64,3,0.00184,139609,85.61555,163065
1888,starmage,3,0.00184,139612,85.61739,163065
1889,staszekbp,3,0.00184,139615,85.61923,163065
1890,steeveborc,3,0.00184,139618,85.62107,163065
1891,stefanmaric,3,0.00184,139621,85.62291,163065
1892,Stefanqn,3,0.00184,139624,85.62475,163065
1893,steve192,3,0.00184,139627,85.62659,163065
1894,steven-aerts,3,0.00184,139630,85.62843,163065
1895,strollo,3,0.00184,139633,85.63027,163065
1896,stylepatrick,3,0.00184,139636,85.63211,163065
1897,suikast42,3,0.00184,139639,85.63395,163065
1898,Super-Sky,3,0.00184,139642,85.63579,163065
1899,superspeed500,3,0.00184,139645,85.63763,163065
1900,svilenvul,3,0.00184,139648,85.63947,163065
1901,sxoinas12,3,0.00184,139651,85.64131,163065
1902,taihoa,3,0.00184,139654,85.64315,163065
1903,tchambard,3,0.00184,139657,85.64499,163065
1904,TeNNoX,3,0.00184,139660,85.64683,163065
1905,tgippi,3,0.00184,139663,85.64867,163065
1906,tgyKomgo,3,0.00184,139666,85.65051,163065
1907,theusman-dev,3,0.00184,139669,85.65235,163065
1908,Thirsa,3,0.00184,139672,85.65419,163065
1909,thomasharin,3,0.00184,139675,85.65603,163065
1910,ThraaxSession,3,0.00184,139678,85.65787,163065
1911,tiberiuzuld,3,0.00184,139681,85.65971,163065
1912,timbilt,3,0.00184,139684,85.66155,163065
1913,Toami79,3,0.00184,139687,85.66339,163065
1914,tobiasge,3,0.00184,139690,85.66523,163065
1915,tolis-e,3,0.00184,139693,85.66707,163065
1916,trailhuntervodafone,3,0.00184,139696,85.66891,163065
1917,tsondergaard,3,0.00184,139699,85.67074,163065
1918,ttedev,3,0.00184,139702,85.67258,163065
1919,twojtylak,3,0.00184,139705,85.67442,163065
1920,TyrantFox,3,0.00184,139708,85.67626,163065
1921,UbaidurRehman1,3,0.00184,139711,85.67810,163065
1922,uklance,3,0.00184,139714,85.67994,163065
1923,ultinous-dancsa,3,0.00184,139717,85.68178,163065
1924,valentin-ok,3,0.00184,139720,85.68362,163065
1925,valeriob,3,0.00184,139723,85.68546,163065
1926,vamsikrishna-VK31,3,0.00184,139726,85.68730,163065
1927,vanetix,3,0.00184,139729,85.68914,163065
1928,vanloswang,3,0.00184,139732,85.69098,163065
1929,VerdonTrigance,3,0.00184,139735,85.69282,163065
1930,Vespasian,3,0.00184,139738,85.69466,163065
1931,vidhya03,3,0.00184,139741,85.69650,163065
1932,VigneshKannaM,3,0.00184,139744,85.69834,163065
1933,VijoPlays,3,0.00184,139747,85.70018,163065
1934,vinh-thieu,3,0.00184,139750,85.70202,163065
1935,vinod-amt,3,0.00184,139753,85.70386,163065
1936,visch,3,0.00184,139756,85.70570,163065
1937,vitornp,3,0.00184,139759,85.70754,163065
1938,vizapata,3,0.00184,139762,85.70938,163065
1939,VMelnalksnis,3,0.00184,139765,85.71122,163065
1940,wangchengxin,3,0.00184,139768,85.71306,163065
1941,webintoit,3,0.00184,139771,85.71490,163065
1942,wernergiam,3,0.00184,139774,85.71674,163065
1943,whh881114,3,0.00184,139777,85.71858,163065
1944,WillemNoort,3,0.00184,139780,85.72042,163065
1945,willsr,3,0.00184,139783,85.72226,163065
1946,wimdeblauwe,3,0.00184,139786,85.72410,163065
1947,wimvanboven,3,0.00184,139789,85.72594,163065
1948,wisebaldone,3,0.00184,139792,85.72778,163065
1949,wodansax,3,0.00184,139795,85.72962,163065
1950,wojja,3,0.00184,139798,85.73146,163065
1951,wuwx,3,0.00184,139801,85.73330,163065
1952,x111d222,3,0.00184,139804,85.73514,163065
1953,xelita,3,0.00184,139807,85.73698,163065
1954,yalattas,3,0.00184,139810,85.73882,163065
1955,yasammez,3,0.00184,139813,85.74066,163065
1956,ydhif,3,0.00184,139816,85.74250,163065
1957,ykuksenko,3,0.00184,139819,85.74434,163065
1958,yuyujiejie,3,0.00184,139822,85.74617,163065
1959,yvesgab,3,0.00184,139825,85.74801,163065
1960,zacisco,3,0.00184,139828,85.74985,163065
1961,ZaheerUdDeen,3,0.00184,139831,85.75169,163065
1962,zandbelt,3,0.00184,139834,85.75353,163065
1963,ZazaKumar,3,0.00184,139837,85.75537,163065
1964,zelaskoa,3,0.00184,139840,85.75721,163065
1965,zeoe,3,0.00184,139843,85.75905,163065
1966,Zetanova,3,0.00184,139846,85.76089,163065
1967,zonybob,3,0.00184,139849,85.76273,163065
1968,zyairzy,3,0.00184,139852,85.76457,163065
1969,1Const1,2,0.00123,139854,85.76580,163065
1970,7890123,2,0.00123,139856,85.76703,163065
1971,aaabdallah,2,0.00123,139858,85.76825,163065
1972,aamiryaqub-10p,2,0.00123,139860,85.76948,163065
1973,aamoyel,2,0.00123,139862,85.77070,163065
1974,aaronharnly,2,0.00123,139864,85.77193,163065
1975,aarti-stack,2,0.00123,139866,85.77316,163065
1976,AB017N0,2,0.00123,139868,85.77438,163065
1977,Abdelouahedd,2,0.00123,139870,85.77561,163065
1978,Abhilash1368,2,0.00123,139872,85.77684,163065
1979,abhishekraghav,2,0.00123,139874,85.77806,163065
1980,abn,2,0.00123,139876,85.77929,163065
1981,abonifacio,2,0.00123,139878,85.78052,163065
1982,abrsystematic,2,0.00123,139880,85.78174,163065
1983,abruegit,2,0.00123,139882,85.78297,163065
1984,Abuesy,2,0.00123,139884,85.78420,163065
1985,acaselli,2,0.00123,139886,85.78542,163065
1986,ad9999,2,0.00123,139888,85.78665,163065
1987,adamalexandru4,2,0.00123,139890,85.78788,163065
1988,adilarli,2,0.00123,139892,85.78910,163065
1989,adlmez,2,0.00123,139894,85.79033,163065
1990,adneneBen,2,0.00123,139896,85.79156,163065
1991,afeiluo,2,0.00123,139898,85.79278,163065
1992,afhole,2,0.00123,139900,85.79401,163065
1993,aflag,2,0.00123,139902,85.79524,163065
1994,agemuend,2,0.00123,139904,85.79646,163065
1995,ahahu,2,0.00123,139906,85.79769,163065
1996,akashsethiya,2,0.00123,139908,85.79891,163065
1997,akbar1214,2,0.00123,139910,85.80014,163065
1998,akshatcm,2,0.00123,139912,85.80137,163065
1999,alansonsci,2,0.00123,139914,85.80259,163065
2000,AlbertLacambraNexplore,2,0.00123,139916,85.80382,163065
2001,albertoSoto,2,0.00123,139918,85.80505,163065
2002,Aleson95,2,0.00123,139920,85.80627,163065
2003,alexandre-melard,2,0.00123,139922,85.80750,163065
2004,alexisdondon,2,0.00123,139924,85.80873,163065
2005,alidandach,2,0.00123,139926,85.80995,163065
2006,alispustina,2,0.00123,139928,85.81118,163065
2007,alt-enio,2,0.00123,139930,85.81241,163065
2008,alvaroarenas,2,0.00123,139932,85.81363,163065
2009,amanfrinati,2,0.00123,139934,85.81486,163065
2010,ambition-consulting,2,0.00123,139936,85.81609,163065
2011,ameotoko,2,0.00123,139938,85.81731,163065
2012,amirensit,2,0.00123,139940,85.81854,163065
2013,amtemelkoska,2,0.00123,139942,85.81977,163065
2014,amulyamalla,2,0.00123,139944,85.82099,163065
2015,an-ant0ni0,2,0.00123,139946,85.82222,163065
2016,anantk24,2,0.00123,139948,85.82344,163065
2017,andeero,2,0.00123,139950,85.82467,163065
2018,andreasringdal,2,0.00123,139952,85.82590,163065
2019,andrepra,2,0.00123,139954,85.82712,163065
2020,andre-taveira,2,0.00123,139956,85.82835,163065
2021,andrewm-aero,2,0.00123,139958,85.82958,163065
2022,AndriusKarpavicius,2,0.00123,139960,85.83080,163065
2023,Andy2003,2,0.00123,139962,85.83203,163065
2024,Andyriod,2,0.00123,139964,85.83326,163065
2025,andytson-inviqa,2,0.00123,139966,85.83448,163065
2026,Angelinsky7,2,0.00123,139968,85.83571,163065
2027,anshulpatel25,2,0.00123,139970,85.83694,163065
2028,AntoineBvn,2,0.00123,139972,85.83816,163065
2029,antoinechamot,2,0.00123,139974,85.83939,163065
2030,Antonboom,2,0.00123,139976,85.84062,163065
2031,antonlva,2,0.00123,139978,85.84184,163065
2032,apiel,2,0.00123,139980,85.84307,163065
2033,ApoorvSeth,2,0.00123,139982,85.84430,163065
2034,arahlf,2,0.00123,139984,85.84552,163065
2035,aravindbargurhiriyannaiah,2,0.00123,139986,85.84675,163065
2036,arconsis,2,0.00123,139988,85.84797,163065
2037,ariestikto,2,0.00123,139990,85.84920,163065
2038,arminrosu,2,0.00123,139992,85.85043,163065
2039,arnzel,2,0.00123,139994,85.85165,163065
2040,arthurchan35,2,0.00123,139996,85.85288,163065
2041,ArthurGourrin,2,0.00123,139998,85.85411,163065
2042,arunpmohan,2,0.00123,140000,85.85533,163065
2043,ashestak-sc,2,0.00123,140002,85.85656,163065
2044,ashish270890,2,0.00123,140004,85.85779,163065
2045,ashisharya01,2,0.00123,140006,85.85901,163065
2046,ashiskumarnahak,2,0.00123,140008,85.86024,163065
2047,ashktn,2,0.00123,140010,85.86147,163065
2048,asoete,2,0.00123,140012,85.86269,163065
2049,asolano-q6,2,0.00123,140014,85.86392,163065
2050,athenacykes,2,0.00123,140016,85.86515,163065
2051,atrifyllis,2,0.00123,140018,85.86637,163065
2052,avanlangup,2,0.00123,140020,85.86760,163065
2053,avereco,2,0.00123,140022,85.86883,163065
2054,awattez,2,0.00123,140024,85.87005,163065
2055,ayondeep,2,0.00123,140026,85.87128,163065
2056,bachilli,2,0.00123,140028,85.87250,163065
2057,backbone87,2,0.00123,140030,85.87373,163065
2058,Badbond,2,0.00123,140032,85.87496,163065
2059,Bakrog,2,0.00123,140034,85.87618,163065
2060,baldmageix,2,0.00123,140036,85.87741,163065
2061,balimidi24,2,0.00123,140038,85.87864,163065
2062,ball1,2,0.00123,140040,85.87986,163065
2063,bantunes82,2,0.00123,140042,85.88109,163065
2064,barashnikov,2,0.00123,140044,85.88232,163065
2065,barelnir,2,0.00123,140046,85.88354,163065
2066,barvek,2,0.00123,140048,85.88477,163065
2067,bboehm86,2,0.00123,140050,85.88600,163065
2068,BcTpe4HbIu,2,0.00123,140052,85.88722,163065
2069,BDive,2,0.00123,140054,85.88845,163065
2070,beatfactor,2,0.00123,140056,85.88968,163065
2071,beau6183,2,0.00123,140058,85.89090,163065
2072,beevelop,2,0.00123,140060,85.89213,163065
2073,beikov,2,0.00123,140062,85.89336,163065
2074,Beingbook,2,0.00123,140064,85.89458,163065
2075,bejondshao,2,0.00123,140066,85.89581,163065
2076,belaban,2,0.00123,140068,85.89703,163065
2077,belinde,2,0.00123,140070,85.89826,163065
2078,benalil,2,0.00123,140072,85.89949,163065
2079,Benesss,2,0.00123,140074,85.90071,163065
2080,benhag,2,0.00123,140076,85.90194,163065
2081,benridley,2,0.00123,140078,85.90317,163065
2082,BergJonatan,2,0.00123,140080,85.90439,163065
2083,betalb,2,0.00123,140082,85.90562,163065
2084,beus,2,0.00123,140084,85.90685,163065
2085,beye-pelz,2,0.00123,140086,85.90807,163065
2086,bfyxzls,2,0.00123,140088,85.90930,163065
2087,bharath-krishna,2,0.00123,140090,85.91053,163065
2088,bhushanthakur93,2,0.00123,140092,85.91175,163065
2089,bigon,2,0.00123,140094,85.91298,163065
2090,bigred8982,2,0.00123,140096,85.91421,163065
2091,billwenboli,2,0.00123,140098,85.91543,163065
2092,bitluke,2,0.00123,140100,85.91666,163065
2093,blanchardb,2,0.00123,140102,85.91789,163065
2094,BlessedDisco,2,0.00123,140104,85.91911,163065
2095,bloy-smartling,2,0.00123,140106,85.92034,163065
2096,boerngen-schmidt,2,0.00123,140108,85.92157,163065
2097,bogdanr,2,0.00123,140110,85.92279,163065
2098,bogi158,2,0.00123,140112,85.92402,163065
2099,bonzo71,2,0.00123,140114,85.92524,163065
2100,borukho,2,0.00123,140116,85.92647,163065
2101,bostrick,2,0.00123,140118,85.92770,163065
2102,Bouhnosaure,2,0.00123,140120,85.92892,163065
2103,bourhisa,2,0.00123,140122,85.93015,163065
2104,bovigny,2,0.00123,140124,85.93138,163065
2105,bplaxco,2,0.00123,140126,85.93260,163065
2106,bradthurber,2,0.00123,140128,85.93383,163065
2107,bratwurzt,2,0.00123,140130,85.93506,163065
2108,Bredstone,2,0.00123,140132,85.93628,163065
2109,BrianImprovento,2,0.00123,140134,85.93751,163065
2110,brmeyer,2,0.00123,140136,85.93874,163065
2111,brunojcm,2,0.00123,140138,85.93996,163065
2112,bryankeane0,2,0.00123,140140,85.94119,163065
2113,bunomonteiro,2,0.00123,140142,85.94242,163065
2114,bwaldvogel,2,0.00123,140144,85.94364,163065
2115,bystrikhorvath,2,0.00123,140146,85.94487,163065
2116,c0bra,2,0.00123,140148,85.94610,163065
2117,c4r1570p4e,2,0.00123,140150,85.94732,163065
2118,cadimmek,2,0.00123,140152,85.94855,163065
2119,Caldfir,2,0.00123,140154,85.94977,163065
2120,camaer,2,0.00123,140156,85.95100,163065
2121,camico,2,0.00123,140158,85.95223,163065
2122,camiloking,2,0.00123,140160,85.95345,163065
2123,canattofilipe,2,0.00123,140162,85.95468,163065
2124,canerkoroglu,2,0.00123,140164,85.95591,163065
2125,carlosen14,2,0.00123,140166,85.95713,163065
2126,carluis321,2,0.00123,140168,85.95836,163065
2127,cdmikechen,2,0.00123,140170,85.95959,163065
2128,cedric780,2,0.00123,140172,85.96081,163065
2129,cesdperez,2,0.00123,140174,85.96204,163065
2130,cfecherolle,2,0.00123,140176,85.96327,163065
2131,CG-ANY,2,0.00123,140178,85.96449,163065
2132,cgol,2,0.00123,140180,85.96572,163065
2133,chary1112004,2,0.00123,140182,85.96695,163065
2134,ChaSophie,2,0.00123,140184,85.96817,163065
2135,chdxD1,2,0.00123,140186,85.96940,163065
2136,chendouble,2,0.00123,140188,85.97063,163065
2137,chexxor,2,0.00123,140190,85.97185,163065
2138,chihhaohuang,2,0.00123,140192,85.97308,163065
2139,chrisdolphy,2,0.00123,140194,85.97430,163065
2140,chris-maclean,2,0.00123,140196,85.97553,163065
2141,ciusji,2,0.00123,140198,85.97676,163065
2142,ckaserer,2,0.00123,140200,85.97798,163065
2143,ckatzorke,2,0.00123,140202,85.97921,163065
2144,cloudcogsio,2,0.00123,140204,85.98044,163065
2145,cmwylie19,2,0.00123,140206,85.98166,163065
2146,cod3monk,2,0.00123,140208,85.98289,163065
2147,commander81,2,0.00123,140210,85.98412,163065
2148,conciso,2,0.00123,140212,85.98534,163065
2149,conet,2,0.00123,140214,85.98657,163065
2150,contabo,2,0.00123,140216,85.98780,163065
2151,corinz,2,0.00123,140218,85.98902,163065
2152,cpoissonnier,2,0.00123,140220,85.99025,163065
2153,CreamyMiracle,2,0.00123,140222,85.99148,163065
2154,cremich,2,0.00123,140224,85.99270,163065
2155,cslovell,2,0.00123,140226,85.99393,163065
2156,ctiml,2,0.00123,140228,85.99516,163065
2157,cvasilak,2,0.00123,140230,85.99638,163065
2158,CVEDetect,2,0.00123,140232,85.99761,163065
2159,cyanidium,2,0.00123,140234,85.99883,163065
2160,CyberDaedalus00,2,0.00123,140236,86.00006,163065
2161,cyChop,2,0.00123,140238,86.00129,163065
2162,czosel,2,0.00123,140240,86.00251,163065
2163,d1ken,2,0.00123,140242,86.00374,163065
2164,daemonfire300,2,0.00123,140244,86.00497,163065
2165,daniel-ITC,2,0.00123,140246,86.00619,163065
2166,danielmoessner,2,0.00123,140248,86.00742,163065
2167,danielpassos,2,0.00123,140250,86.00865,163065
2168,dankots,2,0.00123,140252,86.00987,163065
2169,danmana,2,0.00123,140254,86.01110,163065
2170,dardar4,2,0.00123,140256,86.01233,163065
2171,darjeeling,2,0.00123,140258,86.01355,163065
2172,DaSchTour,2,0.00123,140260,86.01478,163065
2173,dattc612,2,0.00123,140262,86.01601,163065
2174,davidcblaney,2,0.00123,140264,86.01723,163065
2175,daviddelamo,2,0.00123,140266,86.01846,163065
2176,daviderie,2,0.00123,140268,86.01969,163065
2177,davide-talesco,2,0.00123,140270,86.02091,163065
2178,DavidHofs,2,0.00123,140272,86.02214,163065
2179,DavidKittleSEL,2,0.00123,140274,86.02336,163065
2180,daviyang35,2,0.00123,140276,86.02459,163065
2181,dcojo,2,0.00123,140278,86.02582,163065
2182,dcore94,2,0.00123,140280,86.02704,163065
2183,dc-pm,2,0.00123,140282,86.02827,163065
2184,ddjain,2,0.00123,140284,86.02950,163065
2185,ddtxra,2,0.00123,140286,86.03072,163065
2186,deather,2,0.00123,140288,86.03195,163065
2187,debashish1976,2,0.00123,140290,86.03318,163065
2188,debimishra89,2,0.00123,140292,86.03440,163065
2189,debu999,2,0.00123,140294,86.03563,163065
2190,deeeed,2,0.00123,140296,86.03686,163065
2191,deibl,2,0.00123,140298,86.03808,163065
2192,dennisrichter,2,0.00123,140300,86.03931,163065
2193,Depther,2,0.00123,140302,86.04054,163065
2194,DerH4NNES,2,0.00123,140304,86.04176,163065
2195,derweise,2,0.00123,140306,86.04299,163065
2196,derXear,2,0.00123,140308,86.04422,163065
2197,devcraftsman,2,0.00123,140310,86.04544,163065
2198,devnull09,2,0.00123,140312,86.04667,163065
2199,devopstom-user,2,0.00123,140314,86.04790,163065
2200,devromarus,2,0.00123,140316,86.04912,163065
2201,dgoosens,2,0.00123,140318,86.05035,163065
2202,Dharmik70230,2,0.00123,140320,86.05157,163065
2203,dheuvels,2,0.00123,140322,86.05280,163065
2204,dhoeppe,2,0.00123,140324,86.05403,163065
2205,DimitriDR,2,0.00123,140326,86.05525,163065
2206,dimitry-a-baranov,2,0.00123,140328,86.05648,163065
2207,dinesh-chander,2,0.00123,140330,86.05771,163065
2208,diogomonte,2,0.00123,140332,86.05893,163065
2209,dirkgomez,2,0.00123,140334,86.06016,163065
2210,DirkHeinke,2,0.00123,140336,86.06139,163065
2211,disappear89,2,0.00123,140338,86.06261,163065
2212,DJDANNY123,2,0.00123,140340,86.06384,163065
2213,djdmbrwsk,2,0.00123,140342,86.06507,163065
2214,djeikyb,2,0.00123,140344,86.06629,163065
2215,dlangille,2,0.00123,140346,86.06752,163065
2216,Dmitriusan,2,0.00123,140348,86.06875,163065
2217,DmitriyKonenkow,2,0.00123,140350,86.06997,163065
2218,dmitry-weirdo,2,0.00123,140352,86.07120,163065
2219,dmprocha,2,0.00123,140354,86.07243,163065
2220,dnmgns,2,0.00123,140356,86.07365,163065
2221,doctorpangloss,2,0.00123,140358,86.07488,163065
2222,dominic-p,2,0.00123,140360,86.07610,163065
2223,dominiwe,2,0.00123,140362,86.07733,163065
2224,donhuvy,2,0.00123,140364,86.07856,163065
2225,DorianRohr,2,0.00123,140366,86.07978,163065
2226,doukai,2,0.00123,140368,86.08101,163065
2227,DrBoria,2,0.00123,140370,86.08224,163065
2228,drduker,2,0.00123,140372,86.08346,163065
2229,dsone,2,0.00123,140374,86.08469,163065
2230,DurandA,2,0.00123,140376,86.08592,163065
2231,dusklight,2,0.00123,140378,86.08714,163065
2232,DustInComp,2,0.00123,140380,86.08837,163065
2233,DustInCompetent,2,0.00123,140382,86.08960,163065
2234,dvantooster,2,0.00123,140384,86.09082,163065
2235,dzou-hpe,2,0.00123,140386,86.09205,163065
2236,EagleIJoe,2,0.00123,140388,86.09328,163065
2237,eamelink,2,0.00123,140390,86.09450,163065
2238,eashleyfl,2,0.00123,140392,86.09573,163065
2239,EbenZhang,2,0.00123,140394,86.09696,163065
2240,ebram96,2,0.00123,140396,86.09818,163065
2241,Ebram96,2,0.00123,140398,86.09941,163065
2242,ebuslys,2,0.00123,140400,86.10063,163065
2243,EdMcBane,2,0.00123,140402,86.10186,163065
2244,edmilsonss,2,0.00123,140404,86.10309,163065
2245,einar-lanfranco,2,0.00123,140406,86.10431,163065
2246,elavrenchuk,2,0.00123,140408,86.10554,163065
2247,elronzo,2,0.00123,140410,86.10677,163065
2248,emanuelconunaemme,2,0.00123,140412,86.10799,163065
2249,emanuelr93,2,0.00123,140414,86.10922,163065
2250,emilienh,2,0.00123,140416,86.11045,163065
2251,emircankilinc-oviva,2,0.00123,140418,86.11167,163065
2252,entfrickler,2,0.00123,140420,86.11290,163065
2253,epsilon-0,2,0.00123,140422,86.11413,163065
2254,ericmiranda7,2,0.00123,140424,86.11535,163065
2255,ericwout-overheid,2,0.00123,140426,86.11658,163065
2256,erinveasey,2,0.00123,140428,86.11781,163065
2257,erlioniel,2,0.00123,140430,86.11903,163065
2258,erwin314,2,0.00123,140432,86.12026,163065
2259,eshipper-ca,2,0.00123,140434,86.12149,163065
2260,evilham,2,0.00123,140436,86.12271,163065
2261,EVP1989,2,0.00123,140438,86.12394,163065
2262,expouic,2,0.00123,140440,86.12516,163065
2263,fabian-froehlich,2,0.00123,140442,86.12639,163065
2264,farukciber,2,0.00123,140444,86.12762,163065
2265,fawqsir,2,0.00123,140446,86.12884,163065
2266,fazd,2,0.00123,140448,86.13007,163065
2267,fcaylus,2,0.00123,140450,86.13130,163065
2268,febrihasan,2,0.00123,140452,86.13252,163065
2269,FelipeEmerim,2,0.00123,140454,86.13375,163065
2270,Fex97,2,0.00123,140456,86.13498,163065
2271,fiji-flo,2,0.00123,140458,86.13620,163065
2272,firdausramlan,2,0.00123,140460,86.13743,163065
2273,Firjens,2,0.00123,140462,86.13866,163065
2274,fjakop,2,0.00123,140464,86.13988,163065
2275,fkowal,2,0.00123,140466,86.14111,163065
2276,Flalal,2,0.00123,140468,86.14234,163065
2277,flashboss,2,0.00123,140470,86.14356,163065
2278,flaviodonze,2,0.00123,140472,86.14479,163065
2279,florianschiller,2,0.00123,140474,86.14602,163065
2280,FlxPeters,2,0.00123,140476,86.14724,163065
2281,flyingflo,2,0.00123,140478,86.14847,163065
2282,fmaturel,2,0.00123,140480,86.14969,163065
2283,formalizator,2,0.00123,140482,86.15092,163065
2284,fourlincoln10,2,0.00123,140484,86.15215,163065
2285,foxt,2,0.00123,140486,86.15337,163065
2286,fram-sse,2,0.00123,140488,86.15460,163065
2287,francois-roget,2,0.00123,140490,86.15583,163065
2288,frank-fegert,2,0.00123,140492,86.15705,163065
2289,fredplante,2,0.00123,140494,86.15828,163065
2290,freswa,2,0.00123,140496,86.15951,163065
2291,fritzforsit,2,0.00123,140498,86.16073,163065
2292,froks,2,0.00123,140500,86.16196,163065
2293,fseneque,2,0.00123,140502,86.16319,163065
2294,fuad775,2,0.00123,140504,86.16441,163065
2295,fugu13,2,0.00123,140506,86.16564,163065
2296,fyaretskiy,2,0.00123,140508,86.16687,163065
2297,Fydon,2,0.00123,140510,86.16809,163065
2298,gabisonia,2,0.00123,140512,86.16932,163065
2299,gabrielfalcao,2,0.00123,140514,86.17055,163065
2300,gaganinvic,2,0.00123,140516,86.17177,163065
2301,GaganNoorS,2,0.00123,140518,86.17300,163065
2302,gaorongfu,2,0.00123,140520,86.17423,163065
2303,garymach64,2,0.00123,140522,86.17545,163065
2304,garysui,2,0.00123,140524,86.17668,163065
2305,gassan,2,0.00123,140526,86.17790,163065
2306,GatoSnake,2,0.00123,140528,86.17913,163065
2307,gbatalski,2,0.00123,140530,86.18036,163065
2308,gbtec-igormartens,2,0.00123,140532,86.18158,163065
2309,geekdinazor,2,0.00123,140534,86.18281,163065
2310,genbutsu,2,0.00123,140536,86.18404,163065
2311,geowatson,2,0.00123,140538,86.18526,163065
2312,geowrian,2,0.00123,140540,86.18649,163065
2313,gerardborst,2,0.00123,140542,86.18772,163065
2314,gerdsander,2,0.00123,140544,86.18894,163065
2315,gerethd,2,0.00123,140546,86.19017,163065
2316,getjack,2,0.00123,140548,86.19140,163065
2317,ghorchem,2,0.00123,140550,86.19262,163065
2318,giamma13,2,0.00123,140552,86.19385,163065
2319,gicappa,2,0.00123,140554,86.19508,163065
2320,Gillespie59,2,0.00123,140556,86.19630,163065
2321,giner,2,0.00123,140558,86.19753,163065
2322,giordanodavid,2,0.00123,140560,86.19876,163065
2323,gjain-sag,2,0.00123,140562,86.19998,163065
2324,glandais,2,0.00123,140564,86.20121,163065
2325,glappsi,2,0.00123,140566,86.20243,163065
2326,gld23,2,0.00123,140568,86.20366,163065
2327,GlennButera,2,0.00123,140570,86.20489,163065
2328,gmmkmtgk,2,0.00123,140572,86.20611,163065
2329,gmorse81,2,0.00123,140574,86.20734,163065
2330,gohanbg,2,0.00123,140576,86.20857,163065
2331,googoogajoob,2,0.00123,140578,86.20979,163065
2332,gostevning,2,0.00123,140580,86.21102,163065
2333,GotBinGo,2,0.00123,140582,86.21225,163065
2334,gpgekko,2,0.00123,140584,86.21347,163065
2335,Gr0bs,2,0.00123,140586,86.21470,163065
2336,Greegles,2,0.00123,140588,86.21593,163065
2337,greg0ire,2,0.00123,140590,86.21715,163065
2338,grk-pancham,2,0.00123,140592,86.21838,163065
2339,growingspaghetti,2,0.00123,140594,86.21961,163065
2340,gschaden,2,0.00123,140596,86.22083,163065
2341,gsedlacz,2,0.00123,140598,86.22206,163065
2342,guerinth,2,0.00123,140600,86.22329,163065
2343,guilhermearpassos,2,0.00123,140602,86.22451,163065
2344,GuillaumeKLECH,2,0.00123,140604,86.22574,163065
2345,gunpuz,2,0.00123,140606,86.22696,163065
2346,gutweiler,2,0.00123,140608,86.22819,163065
2347,Guy-Incognito,2,0.00123,140610,86.22942,163065
2348,H4pH,2,0.00123,140612,86.23064,163065
2349,hajo1199,2,0.00123,140614,86.23187,163065
2350,hannahshort,2,0.00123,140616,86.23310,163065
2351,harikant-lftt,2,0.00123,140618,86.23432,163065
2352,hariyerramsetty,2,0.00123,140620,86.23555,163065
2353,harpreetsingh29,2,0.00123,140622,86.23678,163065
2354,HarunOr,2,0.00123,140624,86.23800,163065
2355,hdava,2,0.00123,140626,86.23923,163065
2356,helmut72,2,0.00123,140628,86.24046,163065
2357,henriquezw,2,0.00123,140630,86.24168,163065
2358,hepuxuan,2,0.00123,140632,86.24291,163065
2359,herbertscruz,2,0.00123,140634,86.24414,163065
2360,herrmannkathrin,2,0.00123,140636,86.24536,163065
2361,hfye,2,0.00123,140638,86.24659,163065
2362,hh201020,2,0.00123,140640,86.24782,163065
2363,hkicl-wingccw,2,0.00123,140642,86.24904,163065
2364,HMNoumanKhan,2,0.00123,140644,86.25027,163065
2365,hogesako,2,0.00123,140646,86.25149,163065
2366,Horsemouth,2,0.00123,140648,86.25272,163065
2367,horus,2,0.00123,140650,86.25395,163065
2368,hqch0708,2,0.00123,140652,86.25517,163065
2369,hshort,2,0.00123,140654,86.25640,163065
2370,hsywhu,2,0.00123,140656,86.25763,163065
2371,hufon,2,0.00123,140658,86.25885,163065
2372,humrenan,2,0.00123,140660,86.26008,163065
2373,hurtonypeter,2,0.00123,140662,86.26131,163065
2374,husaljarab,2,0.00123,140664,86.26253,163065
2375,hutiantian04,2,0.00123,140666,86.26376,163065
2376,hxtmdev,2,0.00123,140668,86.26499,163065
2377,hyperzlib,2,0.00123,140670,86.26621,163065
2378,Iceforgedmvp,2,0.00123,140672,86.26744,163065
2379,ice-safaali,2,0.00123,140674,86.26867,163065
2380,idc77,2,0.00123,140676,86.26989,163065
2381,igord,2,0.00123,140678,86.27112,163065
2382,ihack2712,2,0.00123,140680,86.27235,163065
2383,ilyesAj,2,0.00123,140682,86.27357,163065
2384,imykolenko,2,0.00123,140684,86.27480,163065
2385,Ines-Belhaj,2,0.00123,140686,86.27602,163065
2386,infohash,2,0.00123,140688,86.27725,163065
2387,ioah86,2,0.00123,140690,86.27848,163065
2388,Iodun,2,0.00123,140692,86.27970,163065
2389,ipavkovic,2,0.00123,140694,86.28093,163065
2390,isla-nye,2,0.00123,140696,86.28216,163065
2391,ismaproco,2,0.00123,140698,86.28338,163065
2392,itconomic-ralph,2,0.00123,140700,86.28461,163065
2393,itwillwork,2,0.00123,140702,86.28584,163065
2394,jaapspiering,2,0.00123,140704,86.28706,163065
2395,JackMeiii,2,0.00123,140706,86.28829,163065
2396,Jacob-,2,0.00123,140708,86.28952,163065
2397,JakeTheSnake,2,0.00123,140710,86.29074,163065
2398,jalfd,2,0.00123,140712,86.29197,163065
2399,Jameru,2,0.00123,140714,86.29320,163065
2400,jamesdh,2,0.00123,140716,86.29442,163065
2401,jamesjulich,2,0.00123,140718,86.29565,163065
2402,janaurka,2,0.00123,140720,86.29688,163065
2403,Jan-Brunner,2,0.00123,140722,86.29810,163065
2404,JanEgner,2,0.00123,140724,86.29933,163065
2405,janostik,2,0.00123,140726,86.30055,163065
2406,jason513,2,0.00123,140728,86.30178,163065
2407,jasonlaw,2,0.00123,140730,86.30301,163065
2408,JavaSwitch,2,0.00123,140732,86.30423,163065
2409,javierpedrido,2,0.00123,140734,86.30546,163065
2410,jaynmfs,2,0.00123,140736,86.30669,163065
2411,jbyjby1,2,0.00123,140738,86.30791,163065
2412,jerdie,2,0.00123,140740,86.30914,163065
2413,JeremyReynard,2,0.00123,140742,86.31037,163065
2414,jeroendewilde,2,0.00123,140744,86.31159,163065
2415,Jeroen-Van-Loocke,2,0.00123,140746,86.31282,163065
2416,jerryguowei,2,0.00123,140748,86.31405,163065
2417,jessesarn,2,0.00123,140750,86.31527,163065
2418,jflipp,2,0.00123,140752,86.31650,163065
2419,JGasp,2,0.00123,140754,86.31773,163065
2420,JGjorgji,2,0.00123,140756,86.31895,163065
2421,jharmison-redhat,2,0.00123,140758,86.32018,163065
2422,jhelsethbushel,2,0.00123,140760,86.32141,163065
2423,jicki,2,0.00123,140762,86.32263,163065
2424,Jiri-Kremser,2,0.00123,140764,86.32386,163065
2425,jledoux-sonergia,2,0.00123,140766,86.32509,163065
2426,jlmartins-sf,2,0.00123,140768,86.32631,163065
2427,jlparrilla,2,0.00123,140770,86.32754,163065
2428,jmuis,2,0.00123,140772,86.32876,163065
2429,jnagy-coles,2,0.00123,140774,86.32999,163065
2430,JoakimLofgren,2,0.00123,140776,86.33122,163065
2431,JoFrMueller,2,0.00123,140778,86.33244,163065
2432,johngrimes,2,0.00123,140780,86.33367,163065
2433,JokerDevops,2,0.00123,140782,86.33490,163065
2434,jonalv,2,0.00123,140784,86.33612,163065
2435,JonasPrimbs,2,0.00123,140786,86.33735,163065
2436,jonasvoelcker,2,0.00123,140788,86.33858,163065
2437,jonathanmmm,2,0.00123,140790,86.33980,163065
2438,JonCSgr,2,0.00123,140792,86.34103,163065
2439,jonybuzz,2,0.00123,140794,86.34226,163065
2440,Josh-Airmap,2,0.00123,140796,86.34348,163065
2441,JoshVee,2,0.00123,140798,86.34471,163065
2442,jowko,2,0.00123,140800,86.34594,163065
2443,jptned,2,0.00123,140802,86.34716,163065
2444,jsbach-jung,2,0.00123,140804,86.34839,163065
2445,jstrebeck,2,0.00123,140806,86.34962,163065
2446,Juern-Univention,2,0.00123,140808,86.35084,163065
2447,JulianMetzger,2,0.00123,140810,86.35207,163065
2448,JulianWebb,2,0.00123,140812,86.35329,163065
2449,juliohm1978,2,0.00123,140814,86.35452,163065
2450,JuliusMu,2,0.00123,140816,86.35575,163065
2451,juluanb,2,0.00123,140818,86.35697,163065
2452,Juravenator,2,0.00123,140820,86.35820,163065
2453,justphil86,2,0.00123,140822,86.35943,163065
2454,jvanzyl,2,0.00123,140824,86.36065,163065
2455,kadhemmejri,2,0.00123,140826,86.36188,163065
2456,kaibo-ondruska,2,0.00123,140828,86.36311,163065
2457,kapiljaveri,2,0.00123,140830,86.36433,163065
2458,kasir-barati,2,0.00123,140832,86.36556,163065
2459,kaspro,2,0.00123,140834,86.36679,163065
2460,kaushi5054,2,0.00123,140836,86.36801,163065
2461,Kayes-Islam,2,0.00123,140838,86.36924,163065
2462,kdvalin,2,0.00123,140840,86.37047,163065
2463,keithn,2,0.00123,140842,86.37169,163065
2464,kekru,2,0.00123,140844,86.37292,163065
2465,keliwath,2,0.00123,140846,86.37415,163065
2466,KennyMk-stack,2,0.00123,140848,86.37537,163065
2467,kennynicks,2,0.00123,140850,86.37660,163065
2468,kenrickles,2,0.00123,140852,86.37782,163065
2469,kenwark,2,0.00123,140854,86.37905,163065
2470,kevinarthur2077,2,0.00123,140856,86.38028,163065
2471,KevinHorvatin,2,0.00123,140858,86.38150,163065
2472,Kicey,2,0.00123,140860,86.38273,163065
2473,kickouille,2,0.00123,140862,86.38396,163065
2474,kikkauz,2,0.00123,140864,86.38518,163065
2475,kilaruoleh-def,2,0.00123,140866,86.38641,163065
2476,KirillAmber,2,0.00123,140868,86.38764,163065
2477,KiriLucas,2,0.00123,140870,86.38886,163065
2478,kkovarik,2,0.00123,140872,86.39009,163065
2479,klassm,2,0.00123,140874,86.39132,163065
2480,klenkes74,2,0.00123,140876,86.39254,163065
2481,koh-osug,2,0.00123,140878,86.39377,163065
2482,kolonuk,2,0.00123,140880,86.39500,163065
2483,konradwudkowski,2,0.00123,140882,86.39622,163065
2484,konstin,2,0.00123,140884,86.39745,163065
2485,Korsche09,2,0.00123,140886,86.39868,163065
2486,kosciak9,2,0.00123,140888,86.39990,163065
2487,kossmoboleat,2,0.00123,140890,86.40113,163065
2488,Kostanos,2,0.00123,140892,86.40235,163065
2489,KreMat,2,0.00123,140894,86.40358,163065
2490,krilleAb,2,0.00123,140896,86.40481,163065
2491,krlm,2,0.00123,140898,86.40603,163065
2492,krp2,2,0.00123,140900,86.40726,163065
2493,kschubert,2,0.00123,140902,86.40849,163065
2494,kv979w,2,0.00123,140904,86.40971,163065
2495,kychandar,2,0.00123,140906,86.41094,163065
2496,laurent-dol,2,0.00123,140908,86.41217,163065
2497,leaqui,2,0.00123,140910,86.41339,163065
2498,Leedwing,2,0.00123,140912,86.41462,163065
2499,leforthomas,2,0.00123,140914,86.41585,163065
2500,lellky,2,0.00123,140916,86.41707,163065
2501,lennartj,2,0.00123,140918,86.41830,163065
2502,lennym,2,0.00123,140920,86.41953,163065
2503,leoudimg,2,0.00123,140922,86.42075,163065
2504,leppaott,2,0.00123,140924,86.42198,163065
2505,lewis-ing,2,0.00123,140926,86.42321,163065
2506,LiamMaru,2,0.00123,140928,86.42443,163065
2507,lilinkevin,2,0.00123,140930,86.42566,163065
2508,linqFR,2,0.00123,140932,86.42688,163065
2509,liweitianux,2,0.00123,140934,86.42811,163065
2510,lme-atolcd,2,0.00123,140936,86.42934,163065
2511,lmode,2,0.00123,140938,86.43056,163065
2512,LmV4corbeau,2,0.00123,140940,86.43179,163065
2513,lodaleaf,2,0.00123,140942,86.43302,163065
2514,lorenzrox,2,0.00123,140944,86.43424,163065
2515,loudmouth,2,0.00123,140946,86.43547,163065
2516,LouizFC,2,0.00123,140948,86.43670,163065
2517,lovasoa,2,0.00123,140950,86.43792,163065
2518,ltricarique,2,0.00123,140952,86.43915,163065
2519,lucasrusso95,2,0.00123,140954,86.44038,163065
2520,luigibertaco,2,0.00123,140956,86.44160,163065
2521,lukas0krupa,2,0.00123,140958,86.44283,163065
2522,lukaseckert,2,0.00123,140960,86.44406,163065
2523,lukecalderon,2,0.00123,140962,86.44528,163065
2524,Lunkwill-Fook,2,0.00123,140964,86.44651,163065
2525,lvian,2,0.00123,140966,86.44774,163065
2526,lwohlhart,2,0.00123,140968,86.44896,163065
2527,lxmnk,2,0.00123,140970,86.45019,163065
2528,lyubomirr,2,0.00123,140972,86.45142,163065
2529,lyxys,2,0.00123,140974,86.45264,163065
2530,lz101010,2,0.00123,140976,86.45387,163065
2531,m00re,2,0.00123,140978,86.45509,163065
2532,m2-farzan,2,0.00123,140980,86.45632,163065
2533,m33li5,2,0.00123,140982,86.45755,163065
2534,maapteh,2,0.00123,140984,86.45877,163065
2535,mabdelmoez,2,0.00123,140986,86.46000,163065
2536,maciejbak85,2,0.00123,140988,86.46123,163065
2537,maciej-zabielski,2,0.00123,140990,86.46245,163065
2538,madeinindiadot,2,0.00123,140992,86.46368,163065
2539,magick93,2,0.00123,140994,86.46491,163065
2540,MaikLoewe,2,0.00123,140996,86.46613,163065
2541,MajorBreakfast,2,0.00123,140998,86.46736,163065
2542,maksymgendin,2,0.00123,141000,86.46859,163065
2543,manfuin,2,0.00123,141002,86.46981,163065
2544,mannp,2,0.00123,141004,86.47104,163065
2545,Manuelbaun,2,0.00123,141006,86.47227,163065
2546,marcgemis,2,0.00123,141008,86.47349,163065
2547,marcinmajkowski,2,0.00123,141010,86.47472,163065
2548,marekful,2,0.00123,141012,86.47595,163065
2549,MarFranMar,2,0.00123,141014,86.47717,163065
2550,mariuszbeltowski,2,0.00123,141016,86.47840,163065
2551,MarkSchmitt,2,0.00123,141018,86.47962,163065
2552,MarkTallentire,2,0.00123,141020,86.48085,163065
2553,MarkusRohlof,2,0.00123,141022,86.48208,163065
2554,MarkusWendorf,2,0.00123,141024,86.48330,163065
2555,maroshi,2,0.00123,141026,86.48453,163065
2556,marsbear,2,0.00123,141028,86.48576,163065
2557,martincm1,2,0.00123,141030,86.48698,163065
2558,martinvisser,2,0.00123,141032,86.48821,163065
2559,masa2146,2,0.00123,141034,86.48944,163065
2560,masoud-moghini,2,0.00123,141036,86.49066,163065
2561,mathias4github,2,0.00123,141038,86.49189,163065
2562,matrium0,2,0.00123,141040,86.49312,163065
2563,maudrid,2,0.00123,141042,86.49434,163065
2564,MauWein,2,0.00123,141044,86.49557,163065
2565,Maypul,2,0.00123,141046,86.49680,163065
2566,MaysaraMohamed,2,0.00123,141048,86.49802,163065
2567,mboisnard,2,0.00123,141050,86.49925,163065
2568,mbrannstrom,2,0.00123,141052,86.50048,163065
2569,mcoeadmin,2,0.00123,141054,86.50170,163065
2570,megicivovic,2,0.00123,141056,86.50293,163065
2571,meijerwynand,2,0.00123,141058,86.50415,163065
2572,meimosor,2,0.00123,141060,86.50538,163065
2573,melegiul,2,0.00123,141062,86.50661,163065
2574,merimamu,2,0.00123,141064,86.50783,163065
2575,merwan,2,0.00123,141066,86.50906,163065
2576,mevech,2,0.00123,141068,86.51029,163065
2577,Mezzenine,2,0.00123,141070,86.51151,163065
2578,michaelkuechler,2,0.00123,141072,86.51274,163065
2579,michaelpearce-gain,2,0.00123,141074,86.51397,163065
2580,michael-ylb,2,0.00123,141076,86.51519,163065
2581,michalgabor,2,0.00123,141078,86.51642,163065
2582,michel-zimmer,2,0.00123,141080,86.51765,163065
2583,mickelsonmichael,2,0.00123,141082,86.51887,163065
2584,miguoliang,2,0.00123,141084,86.52010,163065
2585,MikaelElkiaer,2,0.00123,141086,86.52133,163065
2586,mikeazo,2,0.00123,141088,86.52255,163065
2587,mikehaertl,2,0.00123,141090,86.52378,163065
2588,mike-pt,2,0.00123,141092,86.52501,163065
2589,Mikey797,2,0.00123,141094,86.52623,163065
2590,MikeyBurkman,2,0.00123,141096,86.52746,163065
2591,milosjovac,2,0.00123,141098,86.52868,163065
2592,mimber,2,0.00123,141100,86.52991,163065
2593,mithandir,2,0.00123,141102,86.53114,163065
2594,mmaldonado-wtsh,2,0.00123,141104,86.53236,163065
2595,mmerdes,2,0.00123,141106,86.53359,163065
2596,mocleiri,2,0.00123,141108,86.53482,163065
2597,mohamedezzat999,2,0.00123,141110,86.53604,163065
2598,mohamed-iyed,2,0.00123,141112,86.53727,163065
2599,MohammedNoureldin,2,0.00123,141114,86.53850,163065
2600,mohsinilyas,2,0.00123,141116,86.53972,163065
2601,monojitb02,2,0.00123,141118,86.54095,163065
2602,moongladestorm,2,0.00123,141120,86.54218,163065
2603,morksinaanab,2,0.00123,141122,86.54340,163065
2604,mounikakella,2,0.00123,141124,86.54463,163065
2605,mousavi007,2,0.00123,141126,86.54586,163065
2606,MrBuddyCasino,2,0.00123,141128,86.54708,163065
2607,MrDiba,2,0.00123,141130,86.54831,163065
2608,mrezai,2,0.00123,141132,86.54954,163065
2609,msesterhenn,2,0.00123,141134,86.55076,163065
2610,mtdcr,2,0.00123,141136,86.55199,163065
2611,muhammedyalcin,2,0.00123,141138,86.55321,163065
2612,MuratKaragozgil,2,0.00123,141140,86.55444,163065
2613,MUsman1992,2,0.00123,141142,86.55567,163065
2614,mustang1068,2,0.00123,141144,86.55689,163065
2615,mvalensky,2,0.00123,141146,86.55812,163065
2616,mvdlaan,2,0.00123,141148,86.55935,163065
2617,mvk375,2,0.00123,141150,86.56057,163065
2618,mwallnoefer,2,0.00123,141152,86.56180,163065
2619,myfirstnameispaul,2,0.00123,141154,86.56303,163065
2620,n0emis,2,0.00123,141156,86.56425,163065
2621,nahidDeve,2,0.00123,141158,86.56548,163065
2622,Nathan-Beirens-Amaron,2,0.00123,141160,86.56671,163065
2623,naude-r,2,0.00123,141162,86.56793,163065
2624,Naveenrajelothunkal,2,0.00123,141164,86.56916,163065
2625,nbonavia,2,0.00123,141166,86.57039,163065
2626,nchopra27,2,0.00123,141168,86.57161,163065
2627,nelsonjchen,2,0.00123,141170,86.57284,163065
2628,NeoVG,2,0.00123,141172,86.57407,163065
2629,NerRox,2,0.00123,141174,86.57529,163065
2630,netevolution,2,0.00123,141176,86.57652,163065
2631,neun24,2,0.00123,141178,86.57775,163065
2632,nevlkv,2,0.00123,141180,86.57897,163065
2633,nextMJ,2,0.00123,141182,86.58020,163065
2634,ngerstle,2,0.00123,141184,86.58142,163065
2635,ngoquoc,2,0.00123,141186,86.58265,163065
2636,nguyenjohny,2,0.00123,141188,86.58388,163065
2637,NickG22293,2,0.00123,141190,86.58510,163065
2638,nicoandresr,2,0.00123,141192,86.58633,163065
2639,nicoduj,2,0.00123,141194,86.58756,163065
2640,nicovanlooy,2,0.00123,141196,86.58878,163065
2641,Nikhiljbhandari,2,0.00123,141198,86.59001,163065
2642,niko-vulic,2,0.00123,141200,86.59124,163065
2643,nitishdb,2,0.00123,141202,86.59246,163065
2644,nkreiger,2,0.00123,141204,86.59369,163065
2645,nlgtuankiet,2,0.00123,141206,86.59492,163065
2646,nmiekley,2,0.00123,141208,86.59614,163065
2647,noavarice,2,0.00123,141210,86.59737,163065
2648,NoCoker,2,0.00123,141212,86.59860,163065
2649,Nokorbis,2,0.00123,141214,86.59982,163065
2650,Nosfistis,2,0.00123,141216,86.60105,163065
2651,nplaner,2,0.00123,141218,86.60228,163065
2652,nsimons,2,0.00123,141220,86.60350,163065
2653,ntm97,2,0.00123,141222,86.60473,163065
2654,NurbekGithub,2,0.00123,141224,86.60595,163065
2655,nyang,2,0.00123,141226,86.60718,163065
2656,Nyefan,2,0.00123,141228,86.60841,163065
2657,nzsb,2,0.00123,141230,86.60963,163065
2658,olman74,2,0.00123,141232,86.61086,163065
2659,onepremise,2,0.00123,141234,86.61209,163065
2660,oniet,2,0.00123,141236,86.61331,163065
2661,orcunozbayetiya,2,0.00123,141238,86.61454,163065
2662,owangen,2,0.00123,141240,86.61577,163065
2663,oyaranli,2,0.00123,141242,86.61699,163065
2664,pA1nD,2,0.00123,141244,86.61822,163065
2665,PaddyderBOY,2,0.00123,141246,86.61945,163065
2666,Panayioc,2,0.00123,141248,86.62067,163065
2667,pandu-malik,2,0.00123,141250,86.62190,163065
2668,paoven,2,0.00123,141252,86.62313,163065
2669,papinifrancesco,2,0.00123,141254,86.62435,163065
2670,parthibd,2,0.00123,141256,86.62558,163065
2671,patrickjennings,2,0.00123,141258,86.62681,163065
2672,paul-thompson-helix,2,0.00123,141260,86.62803,163065
2673,pawwal,2,0.00123,141262,86.62926,163065
2674,pazreingold,2,0.00123,141264,86.63048,163065
2675,pcolmer,2,0.00123,141266,86.63171,163065
2676,pemko123,2,0.00123,141268,86.63294,163065
2677,peterbecich,2,0.00123,141270,86.63416,163065
2678,petermazan,2,0.00123,141272,86.63539,163065
2679,peyman1372,2,0.00123,141274,86.63662,163065
2680,phamthuy,2,0.00123,141276,86.63784,163065
2681,phanikiranthaticharla,2,0.00123,141278,86.63907,163065
2682,philippn,2,0.00123,141280,86.64030,163065
2683,phxql,2,0.00123,141282,86.64152,163065
2684,piec,2,0.00123,141284,86.64275,163065
2685,pigreco33,2,0.00123,141286,86.64398,163065
2686,Pimst,2,0.00123,141288,86.64520,163065
2687,piotr-sarna,2,0.00123,141290,86.64643,163065
2688,PiryazevAlex,2,0.00123,141292,86.64766,163065
2689,pjeby,2,0.00123,141294,86.64888,163065
2690,pjmalandrino,2,0.00123,141296,86.65011,163065
2691,p-kimberley,2,0.00123,141298,86.65134,163065
2692,PlutoHDDev,2,0.00123,141300,86.65256,163065
2693,PovilasID,2,0.00123,141302,86.65379,163065
2694,Powersource,2,0.00123,141304,86.65501,163065
2695,ppaulis,2,0.00123,141306,86.65624,163065
2696,ppppfly,2,0.00123,141308,86.65747,163065
2697,PragmaChris,2,0.00123,141310,86.65869,163065
2698,prawee,2,0.00123,141312,86.65992,163065
2699,preetham1290,2,0.00123,141314,86.66115,163065
2700,proth1,2,0.00123,141316,86.66237,163065
2701,prsanjay,2,0.00123,141318,86.66360,163065
2702,ptr1120,2,0.00123,141320,86.66483,163065
2703,pvormste,2,0.00123,141322,86.66605,163065
2704,qhaas,2,0.00123,141324,86.66728,163065
2705,quanah,2,0.00123,141326,86.66851,163065
2706,QubitPi,2,0.00123,141328,86.66973,163065
2707,radek2s,2,0.00123,141330,86.67096,163065
2708,radiantmind,2,0.00123,141332,86.67219,163065
2709,rahulbajaj0509,2,0.00123,141334,86.67341,163065
2710,ramshazar,2,0.00123,141336,86.67464,163065
2711,raoganeshr,2,0.00123,141338,86.67587,163065
2712,raulruizbarea,2,0.00123,141340,86.67709,163065
2713,rawl05,2,0.00123,141342,86.67832,163065
2714,Razzeee,2,0.00123,141344,86.67954,163065
2715,razzius,2,0.00123,141346,86.68077,163065
2716,rbroth,2,0.00123,141348,86.68200,163065
2717,rdocchio,2,0.00123,141350,86.68322,163065
2718,RemDav,2,0.00123,141352,86.68445,163065
2719,remithomasn7,2,0.00123,141354,86.68568,163065
2720,remkolodder,2,0.00123,141356,86.68690,163065
2721,renatodantas,2,0.00123,141358,86.68813,163065
2722,reperalta,2,0.00123,141360,86.68936,163065
2723,reste85,2,0.00123,141362,86.69058,163065
2724,resteasy,2,0.00123,141364,86.69181,163065
2725,rexorient,2,0.00123,141366,86.69304,163065
2726,rgieseke,2,0.00123,141368,86.69426,163065
2727,rh-,2,0.00123,141370,86.69549,163065
2728,rightisleft,2,0.00123,141372,86.69672,163065
2729,Rigobertomarro,2,0.00123,141374,86.69794,163065
2730,rissingh1281,2,0.00123,141376,86.69917,163065
2731,rjmarques,2,0.00123,141378,86.70040,163065
2732,Rjvs,2,0.00123,141380,86.70162,163065
2733,RKVodde,2,0.00123,141382,86.70285,163065
2734,rmarins,2,0.00123,141384,86.70408,163065
2735,robinhh,2,0.00123,141386,86.70530,163065
2736,robske110,2,0.00123,141388,86.70653,163065
2737,robson90,2,0.00123,141390,86.70775,163065
2738,rohitnick,2,0.00123,141392,86.70898,163065
2739,RomainPruvostMHH,2,0.00123,141394,86.71021,163065
2740,romainsi,2,0.00123,141396,86.71143,163065
2741,RomainWilbert,2,0.00123,141398,86.71266,163065
2742,romanown,2,0.00123,141400,86.71389,163065
2743,ronyjoy,2,0.00123,141402,86.71511,163065
2744,rosario-vandebron,2,0.00123,141404,86.71634,163065
2745,ross211,2,0.00123,141406,86.71757,163065
2746,rouxcorp,2,0.00123,141408,86.71879,163065
2747,rpahli,2,0.00123,141410,86.72002,163065
2748,rpieciorak,2,0.00123,141412,86.72125,163065
2749,rpiotrow,2,0.00123,141414,86.72247,163065
2750,rpocklin,2,0.00123,141416,86.72370,163065
2751,rpoltorak,2,0.00123,141418,86.72493,163065
2752,RRMoelker,2,0.00123,141420,86.72615,163065
2753,rstuven,2,0.00123,141422,86.72738,163065
2754,rtarasov,2,0.00123,141424,86.72861,163065
2755,rucelee,2,0.00123,141426,86.72983,163065
2756,rushairer,2,0.00123,141428,86.73106,163065
2757,rvadym,2,0.00123,141430,86.73228,163065
2758,rvdh,2,0.00123,141432,86.73351,163065
2759,rwiskerke,2,0.00123,141434,86.73474,163065
2760,RyanS-J,2,0.00123,141436,86.73596,163065
2761,Ryonez,2,0.00123,141438,86.73719,163065
2762,s1monw1,2,0.00123,141440,86.73842,163065
2763,saevarb,2,0.00123,141442,86.73964,163065
2764,sagar-kalburgi-ripcord,2,0.00123,141444,86.74087,163065
2765,saghayar,2,0.00123,141446,86.74210,163065
2766,sailorgallifrey,2,0.00123,141448,86.74332,163065
2767,samo42,2,0.00123,141450,86.74455,163065
2768,sanasz91mdev,2,0.00123,141452,86.74578,163065
2769,sandergates,2,0.00123,141454,86.74700,163065
2770,saramcicchi,2,0.00123,141456,86.74823,163065
2771,sarumont,2,0.00123,141458,86.74946,163065
2772,satanshiro,2,0.00123,141460,86.75068,163065
2773,Satans-Kruemelmonster,2,0.00123,141462,86.75191,163065
2774,satanTime,2,0.00123,141464,86.75314,163065
2775,satkamar,2,0.00123,141466,86.75436,163065
2776,savv,2,0.00123,141468,86.75559,163065
2777,sbernhard,2,0.00123,141470,86.75681,163065
2778,sboetzel-ewc,2,0.00123,141472,86.75804,163065
2779,sbryzak,2,0.00123,141474,86.75927,163065
2780,schne324,2,0.00123,141476,86.76049,163065
2781,schrill,2,0.00123,141478,86.76172,163065
2782,sclassen,2,0.00123,141480,86.76295,163065
2783,Scuilion,2,0.00123,141482,86.76417,163065
2784,seanmmccormick,2,0.00123,141484,86.76540,163065
2785,sebacla,2,0.00123,141486,86.76663,163065
2786,Sebastien-HCL,2,0.00123,141488,86.76785,163065
2787,senthilkumarsn,2,0.00123,141490,86.76908,163065
2788,sergeyanover,2,0.00123,141492,86.77031,163065
2789,serhii900,2,0.00123,141494,86.77153,163065
2790,serkan-ozal,2,0.00123,141496,86.77276,163065
2791,seumasdunlop,2,0.00123,141498,86.77399,163065
2792,sgpinkus,2,0.00123,141500,86.77521,163065
2793,sgrimm,2,0.00123,141502,86.77644,163065
2794,shacal,2,0.00123,141504,86.77767,163065
2795,shahidhs-ibm,2,0.00123,141506,86.77889,163065
2796,shane-js,2,0.00123,141508,86.78012,163065
2797,shanloid,2,0.00123,141510,86.78134,163065
2798,sharpedavid,2,0.00123,141512,86.78257,163065
2799,sheinbergon,2,0.00123,141514,86.78380,163065
2800,sherzinger,2,0.00123,141516,86.78502,163065
2801,shimondoodkin,2,0.00123,141518,86.78625,163065
2802,shiningstarts,2,0.00123,141520,86.78748,163065
2803,shinny-libinbin,2,0.00123,141522,86.78870,163065
2804,shiube2007,2,0.00123,141524,86.78993,163065
2805,shivasaxena,2,0.00123,141526,86.79116,163065
2806,shmeadyy,2,0.00123,141528,86.79238,163065
2807,Shortleft,2,0.00123,141530,86.79361,163065
2808,Siedlerchr,2,0.00123,141532,86.79484,163065
2809,silveirado,2,0.00123,141534,86.79606,163065
2810,Simbaclaws,2,0.00123,141536,86.79729,163065
2811,simon1tan,2,0.00123,141538,86.79852,163065
2812,SimonMacIntyre,2,0.00123,141540,86.79974,163065
2813,simse07,2,0.00123,141542,86.80097,163065
2814,sinannoureddine,2,0.00123,141544,86.80220,163065
2815,sirishkumar,2,0.00123,141546,86.80342,163065
2816,skyward-luke,2,0.00123,141548,86.80465,163065
2817,slayne,2,0.00123,141550,86.80587,163065
2818,slieschke,2,0.00123,141552,86.80710,163065
2819,slimmtl,2,0.00123,141554,86.80833,163065
2820,sll552,2,0.00123,141556,86.80955,163065
2821,slmagus,2,0.00123,141558,86.81078,163065
2822,smysnk,2,0.00123,141560,86.81201,163065
2823,snupsband,2,0.00123,141562,86.81323,163065
2824,solardiz,2,0.00123,141564,86.81446,163065
2825,solidDoWant,2,0.00123,141566,86.81569,163065
2826,solosky,2,0.00123,141568,86.81691,163065
2827,sortidocorps,2,0.00123,141570,86.81814,163065
2828,spacehorst,2,0.00123,141572,86.81937,163065
2829,spetar,2,0.00123,141574,86.82059,163065
2830,SRTigers98,2,0.00123,141576,86.82182,163065
2831,ssakayroun,2,0.00123,141578,86.82305,163065
2832,sshriramwar,2,0.00123,141580,86.82427,163065
2833,StanRaskin,2,0.00123,141582,86.82550,163065
2834,steadyk,2,0.00123,141584,86.82673,163065
2835,steff333,2,0.00123,141586,86.82795,163065
2836,stephane-dereppe,2,0.00123,141588,86.82918,163065
2837,StephenCoady,2,0.00123,141590,86.83041,163065
2838,StephenOTT,2,0.00123,141592,86.83163,163065
2839,stingrayfunk,2,0.00123,141594,86.83286,163065
2840,stmi11,2,0.00123,141596,86.83408,163065
2841,StoneyEagle,2,0.00123,141598,86.83531,163065
2842,strgalt-t,2,0.00123,141600,86.83654,163065
2843,strifel,2,0.00123,141602,86.83776,163065
2844,Submoon,2,0.00123,141604,86.83899,163065
2845,suchitsancheti,2,0.00123,141606,86.84022,163065
2846,sugov5,2,0.00123,141608,86.84144,163065
2847,Sumithkr,2,0.00123,141610,86.84267,163065
2848,sungaoyong,2,0.00123,141612,86.84390,163065
2849,sunlock,2,0.00123,141614,86.84512,163065
2850,supersoaker,2,0.00123,141616,86.84635,163065
2851,Suplanus,2,0.00123,141618,86.84758,163065
2852,surbas,2,0.00123,141620,86.84880,163065
2853,sureshachary,2,0.00123,141622,86.85003,163065
2854,SusanaLab,2,0.00123,141624,86.85126,163065
2855,swarkentin,2,0.00123,141626,86.85248,163065
2856,Swizz,2,0.00123,141628,86.85371,163065
2857,SXI-XLayer,2,0.00123,141630,86.85494,163065
2858,Syone,2,0.00123,141632,86.85616,163065
2859,syrenius,2,0.00123,141634,86.85739,163065
2860,t0da90,2,0.00123,141636,86.85861,163065
2861,tadamo,2,0.00123,141638,86.85984,163065
2862,tamirMoshiashvili,2,0.00123,141640,86.86107,163065
2863,Tanakan,2,0.00123,141642,86.86229,163065
2864,tanvp112,2,0.00123,141644,86.86352,163065
2865,tarmotoimetaja,2,0.00123,141646,86.86475,163065
2866,tasermonkey,2,0.00123,141648,86.86597,163065
2867,tboock,2,0.00123,141650,86.86720,163065
2868,tbusillo,2,0.00123,141652,86.86843,163065
2869,tchrobocek,2,0.00123,141654,86.86965,163065
2870,TeemuHemminki,2,0.00123,141656,86.87088,163065
2871,TerryHu82,2,0.00123,141658,86.87211,163065
2872,TFaga,2,0.00123,141660,86.87333,163065
2873,ThatDeveloper,2,0.00123,141662,86.87456,163065
2874,TheLuckyLuc,2,0.00123,141664,86.87579,163065
2875,thescouser89,2,0.00123,141666,86.87701,163065
2876,thomas1984,2,0.00123,141668,86.87824,163065
2877,thomasbeaujean,2,0.00123,141670,86.87947,163065
2878,thomas-delrue,2,0.00123,141672,86.88069,163065
2879,ThomasGaebler,2,0.00123,141674,86.88192,163065
2880,ThomasPerkins1123,2,0.00123,141676,86.88314,163065
2881,ThomasR,2,0.00123,141678,86.88437,163065
2882,Thrainsa,2,0.00123,141680,86.88560,163065
2883,thundercost,2,0.00123,141682,86.88682,163065
2884,tianqing108,2,0.00123,141684,86.88805,163065
2885,Ticiano-mw,2,0.00123,141686,86.88928,163065
2886,t-ide,2,0.00123,141688,86.89050,163065
2887,timesy,2,0.00123,141690,86.89173,163065
2888,tim-hutchinson,2,0.00123,141692,86.89296,163065
2889,tim-jagenberg-piscada,2,0.00123,141694,86.89418,163065
2890,Tin-Nguyen,2,0.00123,141696,86.89541,163065
2891,tiny-dancer,2,0.00123,141698,86.89664,163065
2892,tirelibirefe,2,0.00123,141700,86.89786,163065
2893,Tjommel1337,2,0.00123,141702,86.89909,163065
2894,tkrisztian95,2,0.00123,141704,86.90032,163065
2895,tlappe,2,0.00123,141706,86.90154,163065
2896,tn-osimis,2,0.00123,141708,86.90277,163065
2897,tobi6112,2,0.00123,141710,86.90400,163065
2898,toconnorkainos,2,0.00123,141712,86.90522,163065
2899,toddkazakov,2,0.00123,141714,86.90645,163065
2900,tolsam,2,0.00123,141716,86.90767,163065
2901,tommai78101,2,0.00123,141718,86.90890,163065
2902,tonny008,2,0.00123,141720,86.91013,163065
2903,torbjornk,2,0.00123,141722,86.91135,163065
2904,TorbjornZachrisson,2,0.00123,141724,86.91258,163065
2905,Tostino,2,0.00123,141726,86.91381,163065
2906,Toumal,2,0.00123,141728,86.91503,163065
2907,tpischke-bedag,2,0.00123,141730,86.91626,163065
2908,tpodom,2,0.00123,141732,86.91749,163065
2909,trepidity,2,0.00123,141734,86.91871,163065
2910,tricsusz,2,0.00123,141736,86.91994,163065
2911,tristola,2,0.00123,141738,86.92117,163065
2912,trujillm,2,0.00123,141740,86.92239,163065
2913,tschaffter,2,0.00123,141742,86.92362,163065
2914,t-schuster,2,0.00123,141744,86.92485,163065
2915,tsudot,2,0.00123,141746,86.92607,163065
2916,ttaylor249,2,0.00123,141748,86.92730,163065
2917,tthrone-atomic,2,0.00123,141750,86.92853,163065
2918,tulequ,2,0.00123,141752,86.92975,163065
2919,Tung4,2,0.00123,141754,86.93098,163065
2920,tuxetuxe,2,0.00123,141756,86.93220,163065
2921,tuzhms,2,0.00123,141758,86.93343,163065
2922,TXLuong,2,0.00123,141760,86.93466,163065
2923,tyokyo320,2,0.00123,141762,86.93588,163065
2924,uberspot,2,0.00123,141764,86.93711,163065
2925,ukbecemuz1996,2,0.00123,141766,86.93834,163065
2926,Undestor,2,0.00123,141768,86.93956,163065
2927,uqix,2,0.00123,141770,86.94079,163065
2928,urieli,2,0.00123,141772,86.94202,163065
2929,vaibhavkumbhar1,2,0.00123,141774,86.94324,163065
2930,valkum,2,0.00123,141776,86.94447,163065
2931,Varshaa21,2,0.00123,141778,86.94570,163065
2932,veerakishorekallam,2,0.00123,141780,86.94692,163065
2933,vfrans,2,0.00123,141782,86.94815,163065
2934,vgobrecht,2,0.00123,141784,86.94938,163065
2935,Victor-Philipp-Negoescu,2,0.00123,141786,86.95060,163065
2936,viknesh-j,2,0.00123,141788,86.95183,163065
2937,viktorgt,2,0.00123,141790,86.95306,163065
2938,viktorot,2,0.00123,141792,86.95428,163065
2939,viltsuhanninen,2,0.00123,141794,86.95551,163065
2940,vinay2107,2,0.00123,141796,86.95674,163065
2941,vincentpalita,2,0.00123,141798,86.95796,163065
2942,vincent-simpson,2,0.00123,141800,86.95919,163065
2943,Vinutha-Garimella,2,0.00123,141802,86.96041,163065
2944,vkareh,2,0.00123,141804,86.96164,163065
2945,vladimirr9,2,0.00123,141806,86.96287,163065
2946,VladNastase,2,0.00123,141808,86.96409,163065
2947,vlkndogan,2,0.00123,141810,86.96532,163065
2948,volck,2,0.00123,141812,86.96655,163065
2949,volsus83,2,0.00123,141814,86.96777,163065
2950,voortwis,2,0.00123,141816,86.96900,163065
2951,vrnsky,2,0.00123,141818,86.97023,163065
2952,WalkerWatch,2,0.00123,141820,86.97145,163065
2953,waltari2001,2,0.00123,141822,86.97268,163065
2954,wangjie-zzz,2,0.00123,141824,86.97391,163065
2955,wangxinnong,2,0.00123,141826,86.97513,163065
2956,warkentyne,2,0.00123,141828,86.97636,163065
2957,weasel-spagnola,2,0.00123,141830,86.97759,163065
2958,webmozart,2,0.00123,141832,86.97881,163065
2959,wesSTILMAN,2,0.00123,141834,86.98004,163065
2960,WilSimpson,2,0.00123,141836,86.98127,163065
2961,winster,2,0.00123,141838,86.98249,163065
2962,wmartinezh,2,0.00123,141840,86.98372,163065
2963,Wohlraj,2,0.00123,141842,86.98494,163065
2964,wqssyq,2,0.00123,141844,86.98617,163065
2965,Writtscher,2,0.00123,141846,86.98740,163065
2966,wubli,2,0.00123,141848,86.98862,163065
2967,wuwangzhang1216,2,0.00123,141850,86.98985,163065
2968,wuyangang,2,0.00123,141852,86.99108,163065
2969,xcffl,2,0.00123,141854,86.99230,163065
2970,xesjkeee,2,0.00123,141856,86.99353,163065
2971,xstefank,2,0.00123,141858,86.99476,163065
2972,XuluniX,2,0.00123,141860,86.99598,163065
2973,xvrtalt,2,0.00123,141862,86.99721,163065
2974,xxyy,2,0.00123,141864,86.99844,163065
2975,yagoubgrine,2,0.00123,141866,86.99966,163065
2976,yamsergey-oviva,2,0.00123,141868,87.00089,163065
2977,yannickguth,2,0.00123,141870,87.00212,163065
2978,Yaytay,2,0.00123,141872,87.00334,163065
2979,ychyss,2,0.00123,141874,87.00457,163065
2980,Yejneshwar,2,0.00123,141876,87.00580,163065
2981,YeLuoYiFanChen,2,0.00123,141878,87.00702,163065
2982,yesview,2,0.00123,141880,87.00825,163065
2983,ymbcxb,2,0.00123,141882,87.00947,163065
2984,ymlisoft,2,0.00123,141884,87.01070,163065
2985,yoannspace,2,0.00123,141886,87.01193,163065
2986,yolepro,2,0.00123,141888,87.01315,163065
2987,Yonezawa-T2,2,0.00123,141890,87.01438,163065
2988,youjeongsue,2,0.00123,141892,87.01561,163065
2989,yuri1969,2,0.00123,141894,87.01683,163065
2990,yyunikov,2,0.00123,141896,87.01806,163065
2991,zabih-alipour,2,0.00123,141898,87.01929,163065
2992,zahiritpro,2,0.00123,141900,87.02051,163065
2993,zamofingrApex,2,0.00123,141902,87.02174,163065
2994,Zash,2,0.00123,141904,87.02297,163065
2995,zealzhangz,2,0.00123,141906,87.02419,163065
2996,zedbeit,2,0.00123,141908,87.02542,163065
2997,ZengJun-cloud,2,0.00123,141910,87.02665,163065
2998,zfrhv,2,0.00123,141912,87.02787,163065
2999,zhaojiale1213,2,0.00123,141914,87.02910,163065
3000,zinginging,2,0.00123,141916,87.03033,163065
3001,zrezke,2,0.00123,141918,87.03155,163065
3002,zthulj,2,0.00123,141920,87.03278,163065
3003,zvonegit,2,0.00123,141922,87.03400,163065
3004,zwitter1,2,0.00123,141924,87.03523,163065
3005,zzzaJ,2,0.00123,141926,87.03646,163065
3006,01epa,1,0.00061,141927,87.03707,163065
3007,123afzal,1,0.00061,141928,87.03768,163065
3008,13rentgen,1,0.00061,141929,87.03830,163065
3009,4meepo,1,0.00061,141930,87.03891,163065
3010,8acker,1,0.00061,141931,87.03952,163065
3011,9228883664,1,0.00061,141932,87.04014,163065
3012,99graciamanel,1,0.00061,141933,87.04075,163065
3013,a295,1,0.00061,141934,87.04136,163065
3014,a943915349,1,0.00061,141935,87.04198,163065
3015,aad-griff,1,0.00061,141936,87.04259,163065
3016,aaimsh,1,0.00061,141937,87.04320,163065
3017,aaltenbernd,1,0.00061,141938,87.04382,163065
3018,abascivan,1,0.00061,141939,87.04443,163065
3019,Abdelghani-Ben,1,0.00061,141940,87.04504,163065
3020,abebehailu,1,0.00061,141941,87.04566,163065
3021,abelncm,1,0.00061,141942,87.04627,163065
3022,aberthout,1,0.00061,141943,87.04688,163065
3023,abhilashkumar002,1,0.00061,141944,87.04750,163065
3024,abhishekgandhe,1,0.00061,141945,87.04811,163065
3025,a-bocci,1,0.00061,141946,87.04872,163065
3026,abretonc7s,1,0.00061,141947,87.04934,163065
3027,abstractalchemist,1,0.00061,141948,87.04995,163065
3028,acassaignemondeca,1,0.00061,141949,87.05056,163065
3029,acerola1,1,0.00061,141950,87.05118,163065
3030,achojoao,1,0.00061,141951,87.05179,163065
3031,acidoxee,1,0.00061,141952,87.05240,163065
3032,acolombier,1,0.00061,141953,87.05302,163065
3033,AconiteX,1,0.00061,141954,87.05363,163065
3034,acuteaura,1,0.00061,141955,87.05424,163065
3035,adahms,1,0.00061,141956,87.05486,163065
3036,adamMo,1,0.00061,141957,87.05547,163065
3037,adamo901,1,0.00061,141958,87.05608,163065
3038,AdamZaczek,1,0.00061,141959,87.05670,163065
3039,adamzr,1,0.00061,141960,87.05731,163065
3040,ADASNET,1,0.00061,141961,87.05792,163065
3041,addreas,1,0.00061,141962,87.05853,163065
3042,Aditya-oneadvanced,1,0.00061,141963,87.05915,163065
3043,adnanirfan,1,0.00061,141964,87.05976,163065
3044,aeckl,1,0.00061,141965,87.06037,163065
3045,ae-govau,1,0.00061,141966,87.06099,163065
3046,Aeolun,1,0.00061,141967,87.06160,163065
3047,aesthetics,1,0.00061,141968,87.06221,163065
3048,Afzalkhan644,1,0.00061,141969,87.06283,163065
3049,aghArdeshir,1,0.00061,141970,87.06344,163065
3050,AGrzella,1,0.00061,141971,87.06405,163065
3051,ahamroun10,1,0.00061,141972,87.06467,163065
3052,ahatting,1,0.00061,141973,87.06528,163065
3053,ah-ping-luk,1,0.00061,141974,87.06589,163065
3054,ahristov314,1,0.00061,141975,87.06651,163065
3055,ainquel,1,0.00061,141976,87.06712,163065
3056,aipirvu,1,0.00061,141977,87.06773,163065
3057,AirTobe91,1,0.00061,141978,87.06835,163065
3058,aivinog1,1,0.00061,141979,87.06896,163065
3059,ajcollins,1,0.00061,141980,87.06957,163065
3060,ajitlawhate,1,0.00061,141981,87.07019,163065
3061,akikoskinen,1,0.00061,141982,87.07080,163065
3062,akleemans,1,0.00061,141983,87.07141,163065
3063,akloster,1,0.00061,141984,87.07203,163065
3064,akos96kov,1,0.00061,141985,87.07264,163065
3065,alallier,1,0.00061,141986,87.07325,163065
3066,alanosman,1,0.00061,141987,87.07387,163065
3067,alarikmyrin,1,0.00061,141988,87.07448,163065
3068,albert0815,1,0.00061,141989,87.07509,163065
3069,albertot,1,0.00061,141990,87.07571,163065
3070,AlbinGuo,1,0.00061,141991,87.07632,163065
3071,albinscode,1,0.00061,141992,87.07693,163065
3072,alborrajo,1,0.00061,141993,87.07755,163065
3073,albundy83,1,0.00061,141994,87.07816,163065
3074,aleksandar78,1,0.00061,141995,87.07877,163065
3075,alex5513,1,0.00061,141996,87.07939,163065
3076,alexanderhofstaetter,1,0.00061,141997,87.08000,163065
3077,alexBigBoss,1,0.00061,141998,87.08061,163065
3078,alexbuechele,1,0.00061,141999,87.08123,163065
3079,Alexcei88,1,0.00061,142000,87.08184,163065
3080,AlexGoris-KasparSolutions,1,0.00061,142001,87.08245,163065
3081,alexgv99,1,0.00061,142002,87.08307,163065
3082,AlexHung123,1,0.00061,142003,87.08368,163065
3083,alexniko44,1,0.00061,142004,87.08429,163065
3084,alex-vg,1,0.00061,142005,87.08490,163065
3085,alexwang-rh,1,0.00061,142006,87.08552,163065
3086,alf5,1,0.00061,142007,87.08613,163065
3087,alfredsName,1,0.00061,142008,87.08674,163065
3088,Ali-Javanmardi,1,0.00061,142009,87.08736,163065
3089,alimzhanovamir,1,0.00061,142010,87.08797,163065
3090,alirezameskin,1,0.00061,142011,87.08858,163065
3091,allanks,1,0.00061,142012,87.08920,163065
3092,allentc,1,0.00061,142013,87.08981,163065
3093,almarro1,1,0.00061,142014,87.09042,163065
3094,alnemo,1,0.00061,142015,87.09104,163065
3095,alocq,1,0.00061,142016,87.09165,163065
3096,alokrbl,1,0.00061,142017,87.09226,163065
3097,alopezFermax,1,0.00061,142018,87.09288,163065
3098,alpa-coder,1,0.00061,142019,87.09349,163065
3099,alphana,1,0.00061,142020,87.09410,163065
3100,altitude1326,1,0.00061,142021,87.09472,163065
3101,alwa,1,0.00061,142022,87.09533,163065
3102,amanchopra95,1,0.00061,142023,87.09594,163065
3103,ama-patrick,1,0.00061,142024,87.09656,163065
3104,amarlankri,1,0.00061,142025,87.09717,163065
3105,ambuznego,1,0.00061,142026,87.09778,163065
3106,amentee,1,0.00061,142027,87.09840,163065
3107,amitpsat,1,0.00061,142028,87.09901,163065
3108,AmsalkhirAli,1,0.00061,142029,87.09962,163065
3109,anaerobic,1,0.00061,142030,87.10024,163065
3110,AnandChowdhary,1,0.00061,142031,87.10085,163065
3111,andewil,1,0.00061,142032,87.10146,163065
3112,AndreasBBS,1,0.00061,142033,87.10208,163065
3113,andreasgremm,1,0.00061,142034,87.10269,163065
3114,AndreasKneistSIT,1,0.00061,142035,87.10330,163065
3115,andreasschmid-genopace,1,0.00061,142036,87.10392,163065
3116,andreb89,1,0.00061,142037,87.10453,163065
3117,andreclemente,1,0.00061,142038,87.10514,163065
3118,andreibleortu,1,0.00061,142039,87.10576,163065
3119,andreidiaconescu,1,0.00061,142040,87.10637,163065
3120,andreisilvasantos,1,0.00061,142041,87.10698,163065
3121,andrevus,1,0.00061,142042,87.10760,163065
3122,andrewaldasoro,1,0.00061,142043,87.10821,163065
3123,andrew-unaffiliated,1,0.00061,142044,87.10882,163065
3124,andrey-kosychenko,1,0.00061,142045,87.10943,163065
3125,AndreySuworow,1,0.00061,142046,87.11005,163065
3126,Andrius0124,1,0.00061,142047,87.11066,163065
3127,andybarilla,1,0.00061,142048,87.11127,163065
3128,andyflatt,1,0.00061,142049,87.11189,163065
3129,anish-dcruz,1,0.00061,142050,87.11250,163065
3130,anishkumar7836,1,0.00061,142051,87.11311,163065
3131,anjoy8,1,0.00061,142052,87.11373,163065
3132,ankit-hsc,1,0.00061,142053,87.11434,163065
3133,ankkumar-progress,1,0.00061,142054,87.11495,163065
3134,ankursrivastva,1,0.00061,142055,87.11557,163065
3135,anna89382,1,0.00061,142056,87.11618,163065
3136,Annett357,1,0.00061,142057,87.11679,163065
3137,anshubansal2000,1,0.00061,142058,87.11741,163065
3138,antbig,1,0.00061,142059,87.11802,163065
3139,Anthony-Jhoiro,1,0.00061,142060,87.11863,163065
3140,AnthonyRinaldi,1,0.00061,142061,87.11925,163065
3141,anthowlett,1,0.00061,142062,87.11986,163065
3142,antoine-habran,1,0.00061,142063,87.12047,163065
3143,Antoine-Leveque,1,0.00061,142064,87.12109,163065
3144,antoineroux,1,0.00061,142065,87.12170,163065
3145,antonioalmeida,1,0.00061,142066,87.12231,163065
3146,AntonioMT88,1,0.00061,142067,87.12293,163065
3147,anwajler,1,0.00061,142068,87.12354,163065
3148,anwar-bs,1,0.00061,142069,87.12415,163065
3149,aodhen39,1,0.00061,142070,87.12477,163065
3150,aosipenko-sc,1,0.00061,142071,87.12538,163065
3151,apateczechmeister,1,0.00061,142072,87.12599,163065
3152,apavlenko-tp,1,0.00061,142073,87.12661,163065
3153,apellizzn,1,0.00061,142074,87.12722,163065
3154,apigeeks-lee,1,0.00061,142075,87.12783,163065
3155,apolesskiy01,1,0.00061,142076,87.12845,163065
3156,apolit,1,0.00061,142077,87.12906,163065
3157,appeltonen,1,0.00061,142078,87.12967,163065
3158,ap-tianjef,1,0.00061,142079,87.13029,163065
3159,AQS-DTheuke,1,0.00061,142080,87.13090,163065
3160,Aravindpogu,1,0.00061,142081,87.13151,163065
3161,arbue,1,0.00061,142082,87.13213,163065
3162,arctan90,1,0.00061,142083,87.13274,163065
3163,argentinaluiz,1,0.00061,142084,87.13335,163065
3164,arjungrootan,1,0.00061,142085,87.13396,163065
3165,Armen101,1,0.00061,142086,87.13458,163065
3166,Arnaud-F,1,0.00061,142087,87.13519,163065
3167,arne-heil,1,0.00061,142088,87.13580,163065
3168,arnou,1,0.00061,142089,87.13642,163065
3169,artpdr,1,0.00061,142090,87.13703,163065
3170,ArtsenMachin,1,0.00061,142091,87.13764,163065
3171,Arulaln-AR,1,0.00061,142092,87.13826,163065
3172,aryanPatilhm2,1,0.00061,142093,87.13887,163065
3173,ArzelaAscoIi,1,0.00061,142094,87.13948,163065
3174,AsadShakeel,1,0.00061,142095,87.14010,163065
3175,asgarciap,1,0.00061,142096,87.14071,163065
3176,ashishkumar-07,1,0.00061,142097,87.14132,163065
3177,AskAlice,1,0.00061,142098,87.14194,163065
3178,asthraa,1,0.00061,142099,87.14255,163065
3179,asyncify,1,0.00061,142100,87.14316,163065
3180,atashrazm,1,0.00061,142101,87.14378,163065
3181,ATeal,1,0.00061,142102,87.14439,163065
3182,atifc,1,0.00061,142103,87.14500,163065
3183,atomcat1978,1,0.00061,142104,87.14562,163065
3184,atsushi0804,1,0.00061,142105,87.14623,163065
3185,austinlyons,1,0.00061,142106,87.14684,163065
3186,AustinOyugi,1,0.00061,142107,87.14746,163065
3187,AustralEpitech,1,0.00061,142108,87.14807,163065
3188,Axzial,1,0.00061,142109,87.14868,163065
3189,aybarsyildiz,1,0.00061,142110,87.14930,163065
3190,aybhalala,1,0.00061,142111,87.14991,163065
3191,Ayobama,1,0.00061,142112,87.15052,163065
3192,azhurb,1,0.00061,142113,87.15114,163065
3193,babanjot,1,0.00061,142114,87.15175,163065
3194,baddlan,1,0.00061,142115,87.15236,163065
3195,Badisi,1,0.00061,142116,87.15298,163065
3196,Baelx,1,0.00061,142117,87.15359,163065
3197,BaesKevin,1,0.00061,142118,87.15420,163065
3198,bagl3y,1,0.00061,142119,87.15482,163065
3199,bahaa,1,0.00061,142120,87.15543,163065
3200,baileyjames7,1,0.00061,142121,87.15604,163065
3201,baltom,1,0.00061,142122,87.15666,163065
3202,balza,1,0.00061,142123,87.15727,163065
3203,banjarakunal,1,0.00061,142124,87.15788,163065
3204,BarMalkov,1,0.00061,142125,87.15850,163065
3205,barrynorman,1,0.00061,142126,87.15911,163065
3206,basavarajworld,1,0.00061,142127,87.15972,163065
3207,BaseCrusher,1,0.00061,142128,87.16033,163065
3208,bass3l,1,0.00061,142129,87.16095,163065
3209,BATON35,1,0.00061,142130,87.16156,163065
3210,battosai30,1,0.00061,142131,87.16217,163065
3211,bbednarek,1,0.00061,142132,87.16279,163065
3212,bbrand84,1,0.00061,142133,87.16340,163065
3213,bcawrse,1,0.00061,142134,87.16401,163065
3214,bcmedeiros,1,0.00061,142135,87.16463,163065
3215,bcorvest,1,0.00061,142136,87.16524,163065
3216,beamsies,1,0.00061,142137,87.16585,163065
3217,benjamin-berg,1,0.00061,142138,87.16647,163065
3218,BenjaminFavre,1,0.00061,142139,87.16708,163065
3219,benjaminjacobberg,1,0.00061,142140,87.16769,163065
3220,BenjaminVettori,1,0.00061,142141,87.16831,163065
3221,benneq,1,0.00061,142142,87.16892,163065
3222,BerendWouters,1,0.00061,142143,87.16953,163065
3223,berenicehr,1,0.00061,142144,87.17015,163065
3224,berkitamas,1,0.00061,142145,87.17076,163065
3225,bernhardkern,1,0.00061,142146,87.17137,163065
3226,bernhardriegler,1,0.00061,142147,87.17199,163065
3227,bertbaron,1,0.00061,142148,87.17260,163065
3228,bertjwregeer,1,0.00061,142149,87.17321,163065
3229,bhamail,1,0.00061,142150,87.17383,163065
3230,bienkma,1,0.00061,142151,87.17444,163065
3231,bieshaoxiong,1,0.00061,142152,87.17505,163065
3232,bigbellyburger,1,0.00061,142153,87.17567,163065
3233,biligee,1,0.00061,142154,87.17628,163065
3234,BillySchwartz16,1,0.00061,142155,87.17689,163065
3235,binaryfire,1,0.00061,142156,87.17751,163065
3236,bitvilag,1,0.00061,142157,87.17812,163065
3237,bjconlan,1,0.00061,142158,87.17873,163065
3238,bjoernfi,1,0.00061,142159,87.17935,163065
3239,bjolivot,1,0.00061,142160,87.17996,163065
3240,bjornhauge,1,0.00061,142161,87.18057,163065
3241,bk322,1,0.00061,142162,87.18119,163065
3242,bkuker,1,0.00061,142163,87.18180,163065
3243,Blackburn29,1,0.00061,142164,87.18241,163065
3244,BlackLight,1,0.00061,142165,87.18303,163065
3245,blacklobo,1,0.00061,142166,87.18364,163065
3246,BladeWise,1,0.00061,142167,87.18425,163065
3247,blairmorris,1,0.00061,142168,87.18486,163065
3248,Blarne,1,0.00061,142169,87.18548,163065
3249,blazejkw,1,0.00061,142170,87.18609,163065
3250,b-long,1,0.00061,142171,87.18670,163065
3251,BlueRoyal,1,0.00061,142172,87.18732,163065
3252,bo0ts,1,0.00061,142173,87.18793,163065
3253,boazin,1,0.00061,142174,87.18854,163065
3254,bodom0015,1,0.00061,142175,87.18916,163065
3255,boguszj,1,0.00061,142176,87.18977,163065
3256,bohlenc,1,0.00061,142177,87.19038,163065
3257,boldt,1,0.00061,142178,87.19100,163065
3258,borisheithecker,1,0.00061,142179,87.19161,163065
3259,borislucas-dev,1,0.00061,142180,87.19222,163065
3260,Bosch-Eli-Black,1,0.00061,142181,87.19284,163065
3261,bp974,1,0.00061,142182,87.19345,163065
3262,bplommer,1,0.00061,142183,87.19406,163065
3263,bradleywilsher,1,0.00061,142184,87.19468,163065
3264,BradNut,1,0.00061,142185,87.19529,163065
3265,bramvonk,1,0.00061,142186,87.19590,163065
3266,brendonts,1,0.00061,142187,87.19652,163065
3267,briacp,1,0.00061,142188,87.19713,163065
3268,briandooley,1,0.00061,142189,87.19774,163065
3269,brianpark928,1,0.00061,142190,87.19836,163065
3270,BrickmanRodrigo,1,0.00061,142191,87.19897,163065
3271,britoaldan,1,0.00061,142192,87.19958,163065
3272,brix4dayz,1,0.00061,142193,87.20020,163065
3273,brnbs,1,0.00061,142194,87.20081,163065
3274,bruceesmith,1,0.00061,142195,87.20142,163065
3275,bruhalm,1,0.00061,142196,87.20204,163065
3276,Brundolf,1,0.00061,142197,87.20265,163065
3277,brunomendola,1,0.00061,142198,87.20326,163065
3278,BrunyC,1,0.00061,142199,87.20388,163065
3279,brx-craig,1,0.00061,142200,87.20449,163065
3280,bshreyasrao,1,0.00061,142201,87.20510,163065
3281,bsiara,1,0.00061,142202,87.20572,163065
3282,bstansberry,1,0.00061,142203,87.20633,163065
3283,btarhan,1,0.00061,142204,87.20694,163065
3284,btravel,1,0.00061,142205,87.20756,163065
3285,buehlmann,1,0.00061,142206,87.20817,163065
3286,buhtr,1,0.00061,142207,87.20878,163065
3287,bukovjanmic,1,0.00061,142208,87.20940,163065
3288,burkesbi,1,0.00061,142209,87.21001,163065
3289,BuuBux,1,0.00061,142210,87.21062,163065
3290,bw512,1,0.00061,142211,87.21123,163065
3291,bwoody3142,1,0.00061,142212,87.21185,163065
3292,byamthev,1,0.00061,142213,87.21246,163065
3293,byte3,1,0.00061,142214,87.21307,163065
3294,bz0qyz,1,0.00061,142215,87.21369,163065
3295,bziraoui,1,0.00061,142216,87.21430,163065
3296,bzolivereckle,1,0.00061,142217,87.21491,163065
3297,caiquecastro,1,0.00061,142218,87.21553,163065
3298,cakkaya86,1,0.00061,142219,87.21614,163065
3299,cakl,1,0.00061,142220,87.21675,163065
3300,caleb-adams,1,0.00061,142221,87.21737,163065
3301,CameronNemo,1,0.00061,142222,87.21798,163065
3302,CamposBruno,1,0.00061,142223,87.21859,163065
3303,canayozel,1,0.00061,142224,87.21921,163065
3304,caramat,1,0.00061,142225,87.21982,163065
3305,CarlosTenorio,1,0.00061,142226,87.22043,163065
3306,carlosyague,1,0.00061,142227,87.22105,163065
3307,casell,1,0.00061,142228,87.22166,163065
3308,Catty2014,1,0.00061,142229,87.22227,163065
3309,caubenganha,1,0.00061,142230,87.22289,163065
3310,cbaker-s1,1,0.00061,142231,87.22350,163065
3311,cbuswellATarinc,1,0.00061,142232,87.22411,163065
3312,ccckblaze,1,0.00061,142233,87.22473,163065
3313,cchanning,1,0.00061,142234,87.22534,163065
3314,cchepeau-mwb,1,0.00061,142235,87.22595,163065
3315,ccpsupport,1,0.00061,142236,87.22657,163065
3316,cdroulers,1,0.00061,142237,87.22718,163065
3317,celghandour,1,0.00061,142238,87.22779,163065
3318,cen1,1,0.00061,142239,87.22841,163065
3319,cetsupport,1,0.00061,142240,87.22902,163065
3320,cfBrianMiller,1,0.00061,142241,87.22963,163065
3321,cforce,1,0.00061,142242,87.23025,163065
3322,cgabriel1304,1,0.00061,142243,87.23086,163065
3323,cgomm,1,0.00061,142244,87.23147,163065
3324,chagraoui,1,0.00061,142245,87.23209,163065
3325,Chaima12-3,1,0.00061,142246,87.23270,163065
3326,Chalin-Shi,1,0.00061,142247,87.23331,163065
3327,CharkeyQK,1,0.00061,142248,87.23393,163065
3328,charleyka,1,0.00061,142249,87.23454,163065
3329,charlieharcum,1,0.00061,142250,87.23515,163065
3330,charlykno64,1,0.00061,142251,87.23576,163065
3331,Chatard38,1,0.00061,142252,87.23638,163065
3332,chenjher,1,0.00061,142253,87.23699,163065
3333,ChenSino,1,0.00061,142254,87.23760,163065
3334,chetanrun,1,0.00061,142255,87.23822,163065
3335,chh456,1,0.00061,142256,87.23883,163065
3336,Chinnuganga,1,0.00061,142257,87.23944,163065
3337,chintanpatel671,1,0.00061,142258,87.24006,163065
3338,Chive,1,0.00061,142259,87.24067,163065
3339,choma,1,0.00061,142260,87.24128,163065
3340,Chris403,1,0.00061,142261,87.24190,163065
3341,chris-aeviator,1,0.00061,142262,87.24251,163065
3342,chrisbsmith,1,0.00061,142263,87.24312,163065
3343,chriscarpenter12,1,0.00061,142264,87.24374,163065
3344,chrisFrodo,1,0.00061,142265,87.24435,163065
3345,chrisguoado,1,0.00061,142266,87.24496,163065
3346,ChrisKatsaras,1,0.00061,142267,87.24558,163065
3347,chris-m-dp,1,0.00061,142268,87.24619,163065
3348,ChrisMOxon,1,0.00061,142269,87.24680,163065
3349,christianramcke,1,0.00061,142270,87.24742,163065
3350,christlang,1,0.00061,142271,87.24803,163065
3351,christophenoel,1,0.00061,142272,87.24864,163065
3352,christoschadjikyriakou,1,0.00061,142273,87.24926,163065
3353,ChrisYx511,1,0.00061,142274,87.24987,163065
3354,chvndb,1,0.00061,142275,87.25048,163065
3355,ckaridis,1,0.00061,142276,87.25110,163065
3356,ckromero,1,0.00061,142277,87.25171,163065
3357,clafoutis42,1,0.00061,142278,87.25232,163065
3358,claverentz,1,0.00061,142279,87.25294,163065
3359,clbouvier,1,0.00061,142280,87.25355,163065
3360,cleankod,1,0.00061,142281,87.25416,163065
3361,clementta,1,0.00061,142282,87.25478,163065
3362,clerval,1,0.00061,142283,87.25539,163065
3363,cliffmaury,1,0.00061,142284,87.25600,163065
3364,ClintonMorrison,1,0.00061,142285,87.25662,163065
3365,clmoreno,1,0.00061,142286,87.25723,163065
3366,clockrun,1,0.00061,142287,87.25784,163065
3367,cloudSchulze,1,0.00061,142288,87.25846,163065
3368,cmercer,1,0.00061,142289,87.25907,163065
3369,cmerli99,1,0.00061,142290,87.25968,163065
3370,codechaos,1,0.00061,142291,87.26029,163065
3371,CodeLingoTeam,1,0.00061,142292,87.26091,163065
3372,Codemonkybites,1,0.00061,142293,87.26152,163065
3373,CodingDachs,1,0.00061,142294,87.26213,163065
3374,CodingSpiderFox,1,0.00061,142295,87.26275,163065
3375,Coelmount,1,0.00061,142296,87.26336,163065
3376,Collin3,1,0.00061,142297,87.26397,163065
3377,colpari,1,0.00061,142298,87.26459,163065
3378,coltoneshaw,1,0.00061,142299,87.26520,163065
3379,comply-online,1,0.00061,142300,87.26581,163065
3380,ComradeSlice,1,0.00061,142301,87.26643,163065
3381,conormcafee,1,0.00061,142302,87.26704,163065
3382,cookcodeblog,1,0.00061,142303,87.26765,163065
3383,coolhlm,1,0.00061,142304,87.26827,163065
3384,cooperlyt,1,0.00061,142305,87.26888,163065
3385,coracoracora,1,0.00061,142306,87.26949,163065
3386,Corvan,1,0.00061,142307,87.27011,163065
3387,CoryKleiser,1,0.00061,142308,87.27072,163065
3388,cosmedin,1,0.00061,142309,87.27133,163065
3389,costal,1,0.00061,142310,87.27195,163065
3390,cpesch,1,0.00061,142311,87.27256,163065
3391,cpsaez,1,0.00061,142312,87.27317,163065
3392,crackalak,1,0.00061,142313,87.27379,163065
3393,Craftoncu,1,0.00061,142314,87.27440,163065
3394,crazyhaida,1,0.00061,142315,87.27501,163065
3395,crechberger,1,0.00061,142316,87.27563,163065
3396,creisle,1,0.00061,142317,87.27624,163065
3397,croneter,1,0.00061,142318,87.27685,163065
3398,crose-adesso,1,0.00061,142319,87.27747,163065
3399,cruggieri,1,0.00061,142320,87.27808,163065
3400,csabika7,1,0.00061,142321,87.27869,163065
3401,csams,1,0.00061,142322,87.27931,163065
3402,cscs-nchalla,1,0.00061,142323,87.27992,163065
3403,ctmay4,1,0.00061,142324,87.28053,163065
3404,cukal,1,0.00061,142325,87.28115,163065
3405,cw-morpheus15,1,0.00061,142326,87.28176,163065
3406,Cyben,1,0.00061,142327,87.28237,163065
3407,Czini,1,0.00061,142328,87.28299,163065
3408,D3473R,1,0.00061,142329,87.28360,163065
3409,d3hof,1,0.00061,142330,87.28421,163065
3410,d4effij,1,0.00061,142331,87.28483,163065
3411,daanh432,1,0.00061,142332,87.28544,163065
3412,DaBonse,1,0.00061,142333,87.28605,163065
3413,dade-hms,1,0.00061,142334,87.28666,163065
3414,daemonadmin,1,0.00061,142335,87.28728,163065
3415,Daemorinumi,1,0.00061,142336,87.28789,163065
3416,dagb,1,0.00061,142337,87.28850,163065
3417,Dahnepfl,1,0.00061,142338,87.28912,163065
3418,dajester2013,1,0.00061,142339,87.28973,163065
3419,damianofontana85,1,0.00061,142340,87.29034,163065
3420,damienzonly,1,0.00061,142341,87.29096,163065
3421,DaMo86,1,0.00061,142342,87.29157,163065
3422,danelowe,1,0.00061,142343,87.29218,163065
3423,danhooper,1,0.00061,142344,87.29280,163065
3424,dani,1,0.00061,142345,87.29341,163065
3425,danieled-it,1,0.00061,142346,87.29402,163065
3426,daniel-esq,1,0.00061,142347,87.29464,163065
3427,danielfett,1,0.00061,142348,87.29525,163065
3428,danielgratzl,1,0.00061,142349,87.29586,163065
3429,danieljkemp,1,0.00061,142350,87.29648,163065
3430,daniel-meister,1,0.00061,142351,87.29709,163065
3431,Daniilmass,1,0.00061,142352,87.29770,163065
3432,dannyregis,1,0.00061,142353,87.29832,163065
3433,Dannyx323,1,0.00061,142354,87.29893,163065
3434,daonHA,1,0.00061,142355,87.29954,163065
3435,Darkein,1,0.00061,142356,87.30016,163065
3436,darpanj1993,1,0.00061,142357,87.30077,163065
3437,darth-veitcher,1,0.00061,142358,87.30138,163065
3438,darviche,1,0.00061,142359,87.30200,163065
3439,DaShingHu,1,0.00061,142360,87.30261,163065
3440,dasunsrule32,1,0.00061,142361,87.30322,163065
3441,davidanrod,1,0.00061,142362,87.30384,163065
3442,DavidHaltinner,1,0.00061,142363,87.30445,163065
3443,davidlougheed,1,0.00061,142364,87.30506,163065
3444,DAVIDOJONUGWAMOSES,1,0.00061,142365,87.30568,163065
3445,davidpiendl,1,0.00061,142366,87.30629,163065
3446,davidvogel94,1,0.00061,142367,87.30690,163065
3447,davidvsaraiva,1,0.00061,142368,87.30752,163065
3448,DaviGia,1,0.00061,142369,87.30813,163065
3449,davot,1,0.00061,142370,87.30874,163065
3450,davyvanroy,1,0.00061,142371,87.30936,163065
3451,dazasa,1,0.00061,142372,87.30997,163065
3452,dazevedonkey,1,0.00061,142373,87.31058,163065
3453,dbateman,1,0.00061,142374,87.31119,163065
3454,dbayub,1,0.00061,142375,87.31181,163065
3455,dbazile,1,0.00061,142376,87.31242,163065
3456,dcbCIn,1,0.00061,142377,87.31303,163065
3457,dchrzascik,1,0.00061,142378,87.31365,163065
3458,deathwaiting,1,0.00061,142379,87.31426,163065
3459,deepaknaikhnvrm,1,0.00061,142380,87.31487,163065
3460,delrisu,1,0.00061,142381,87.31549,163065
3461,Deltahedron,1,0.00061,142382,87.31610,163065
3462,dementiacs,1,0.00061,142383,87.31671,163065
3463,demonappolyon,1,0.00061,142384,87.31733,163065
3464,DenEwout,1,0.00061,142385,87.31794,163065
3465,denyshetzel,1,0.00061,142386,87.31855,163065
3466,derekjc,1,0.00061,142387,87.31917,163065
3467,derlarsen,1,0.00061,142388,87.31978,163065
3468,derTobsch,1,0.00061,142389,87.32039,163065
3469,derverzweifler,1,0.00061,142390,87.32101,163065
3470,deryoman,1,0.00061,142391,87.32162,163065
3471,dethlex,1,0.00061,142392,87.32223,163065
3472,detinho,1,0.00061,142393,87.32285,163065
3473,devansvd,1,0.00061,142394,87.32346,163065
3474,devent,1,0.00061,142395,87.32407,163065
3475,devinfopercept,1,0.00061,142396,87.32469,163065
3476,dev-jelinek,1,0.00061,142397,87.32530,163065
3477,devlux,1,0.00061,142398,87.32591,163065
3478,DevOps-Infra-Ritense,1,0.00061,142399,87.32653,163065
3479,DevRebs,1,0.00061,142400,87.32714,163065
3480,devSummer76,1,0.00061,142401,87.32775,163065
3481,dexy58,1,0.00061,142402,87.32837,163065
3482,dfherr,1,0.00061,142403,87.32898,163065
3483,dgroup,1,0.00061,142404,87.32959,163065
3484,DhirajSardar,1,0.00061,142405,87.33021,163065
3485,diegoazh,1,0.00061,142406,87.33082,163065
3486,diego-cqen,1,0.00061,142407,87.33143,163065
3487,diegogmanzanares,1,0.00061,142408,87.33205,163065
3488,diegovilar,1,0.00061,142409,87.33266,163065
3489,DikUl,1,0.00061,142410,87.33327,163065
3490,Dilski,1,0.00061,142411,87.33389,163065
3491,dimovelev,1,0.00061,142412,87.33450,163065
3492,dingxiancheng,1,0.00061,142413,87.33511,163065
3493,dirkoberhaus,1,0.00061,142414,87.33573,163065
3494,dishi-github,1,0.00061,142415,87.33634,163065
3495,DiV666,1,0.00061,142416,87.33695,163065
3496,djairhogeuens,1,0.00061,142417,87.33756,163065
3497,djbulsink,1,0.00061,142418,87.33818,163065
3498,dkmbw,1,0.00061,142419,87.33879,163065
3499,dlmorais-13,1,0.00061,142420,87.33940,163065
3500,dmabupt,1,0.00061,142421,87.34002,163065
3501,d-michail,1,0.00061,142422,87.34063,163065
3502,dmitriyvolk,1,0.00061,142423,87.34124,163065
3503,dmitrymalinin,1,0.00061,142424,87.34186,163065
3504,dmitrymikheiev,1,0.00061,142425,87.34247,163065
3505,DmT021,1,0.00061,142426,87.34308,163065
3506,Doccrazy,1,0.00061,142427,87.34370,163065
3507,Doctor-love,1,0.00061,142428,87.34431,163065
3508,DoHaengLee,1,0.00061,142429,87.34492,163065
3509,domWinter,1,0.00061,142430,87.34554,163065
3510,don4of4,1,0.00061,142431,87.34615,163065
3511,donbnk,1,0.00061,142432,87.34676,163065
3512,doombubbles,1,0.00061,142433,87.34738,163065
3513,DorianMazur,1,0.00061,142434,87.34799,163065
3514,dovreshef,1,0.00061,142435,87.34860,163065
3515,dovydasvenckus,1,0.00061,142436,87.34922,163065
3516,dpevzner,1,0.00061,142437,87.34983,163065
3517,dpostnikov,1,0.00061,142438,87.35044,163065
3518,dprasanthv,1,0.00061,142439,87.35106,163065
3519,dputnamfr,1,0.00061,142440,87.35167,163065
3520,dragontree101,1,0.00061,142441,87.35228,163065
3521,drbng,1,0.00061,142442,87.35290,163065
3522,dreamsComeTrue,1,0.00061,142443,87.35351,163065
3523,Dretch,1,0.00061,142444,87.35412,163065
3524,drewgraham,1,0.00061,142445,87.35474,163065
3525,drndos,1,0.00061,142446,87.35535,163065
3526,drobert-bfm,1,0.00061,142447,87.35596,163065
3527,dschemp,1,0.00061,142448,87.35658,163065
3528,d-schoemer,1,0.00061,142449,87.35719,163065
3529,dsnoeck,1,0.00061,142450,87.35780,163065
3530,dsteegen,1,0.00061,142451,87.35842,163065
3531,dsummersl,1,0.00061,142452,87.35903,163065
3532,Duke4848,1,0.00061,142453,87.35964,163065
3533,durimkryeziu,1,0.00061,142454,87.36026,163065
3534,Duskstrider,1,0.00061,142455,87.36087,163065
3535,dvagnero,1,0.00061,142456,87.36148,163065
3536,dygland,1,0.00061,142457,87.36209,163065
3537,dynamic11,1,0.00061,142458,87.36271,163065
3538,dzaengerle,1,0.00061,142459,87.36332,163065
3539,eagle840,1,0.00061,142460,87.36393,163065
3540,ebiscardi,1,0.00061,142461,87.36455,163065
3541,ecarlettiHC,1,0.00061,142462,87.36516,163065
3542,echel0n,1,0.00061,142463,87.36577,163065
3543,echosunstar,1,0.00061,142464,87.36639,163065
3544,ECX-mpoellinger,1,0.00061,142465,87.36700,163065
3545,Edelbitter,1,0.00061,142466,87.36761,163065
3546,edkennard,1,0.00061,142467,87.36823,163065
3547,edupr91,1,0.00061,142468,87.36884,163065
3548,edx-jagadeesh-kumar,1,0.00061,142469,87.36945,163065
3549,eevers-avisi,1,0.00061,142470,87.37007,163065
3550,egemenokten,1,0.00061,142471,87.37068,163065
3551,EggIt,1,0.00061,142472,87.37129,163065
3552,EinavDanielDX,1,0.00061,142473,87.37191,163065
3553,EitZei,1,0.00061,142474,87.37252,163065
3554,elakito,1,0.00061,142475,87.37313,163065
3555,ElefC,1,0.00061,142476,87.37375,163065
3556,eleionomai,1,0.00061,142477,87.37436,163065
3557,ElenaManion,1,0.00061,142478,87.37497,163065
3558,Elf36,1,0.00061,142479,87.37559,163065
3559,Elgina88,1,0.00061,142480,87.37620,163065
3560,elguardian,1,0.00061,142481,87.37681,163065
3561,elnanou,1,0.00061,142482,87.37743,163065
3562,elodie-ferreira,1,0.00061,142483,87.37804,163065
3563,EmadiGhobad,1,0.00061,142484,87.37865,163065
3564,emanueleperuffo,1,0.00061,142485,87.37927,163065
3565,EmDee,1,0.00061,142486,87.37988,163065
3566,emiedes,1,0.00061,142487,87.38049,163065
3567,EmilIfrim,1,0.00061,142488,87.38111,163065
3568,emilv-barium,1,0.00061,142489,87.38172,163065
3569,Emyrk,1,0.00061,142490,87.38233,163065
3570,enVader,1,0.00061,142491,87.38295,163065
3571,EPanni,1,0.00061,142492,87.38356,163065
3572,epif4nio,1,0.00061,142493,87.38417,163065
3573,Epse,1,0.00061,142494,87.38479,163065
3574,ericalexanderorg,1,0.00061,142495,87.38540,163065
3575,erikdstock,1,0.00061,142496,87.38601,163065
3576,erkkon,1,0.00061,142497,87.38662,163065
3577,ernestorumo,1,0.00061,142498,87.38724,163065
3578,ERRECabrera,1,0.00061,142499,87.38785,163065
3579,esbakker,1,0.00061,142500,87.38846,163065
3580,Etherchannel01,1,0.00061,142501,87.38908,163065
3581,etienne-k,1,0.00061,142502,87.38969,163065
3582,EtiNec,1,0.00061,142503,87.39030,163065
3583,ettik,1,0.00061,142504,87.39092,163065
3584,evasyuk,1,0.00061,142505,87.39153,163065
3585,evecimar,1,0.00061,142506,87.39214,163065
3586,eversardoth,1,0.00061,142507,87.39276,163065
3587,evertonocarvalho,1,0.00061,142508,87.39337,163065
3588,evsasha,1,0.00061,142509,87.39398,163065
3589,exilehanharr,1,0.00061,142510,87.39460,163065
3590,eyujy,1,0.00061,142511,87.39521,163065
3591,eyvar-git,1,0.00061,142512,87.39582,163065
3592,ezesil,1,0.00061,142513,87.39644,163065
3593,F1Feng,1,0.00061,142514,87.39705,163065
3594,Fabi93,1,0.00061,142515,87.39766,163065
3595,FabianAhammer,1,0.00061,142516,87.39828,163065
3596,fabianlee,1,0.00061,142517,87.39889,163065
3597,fabide,1,0.00061,142518,87.39950,163065
3598,fabienpomerol,1,0.00061,142519,87.40012,163065
3599,fabiobeoni,1,0.00061,142520,87.40073,163065
3600,fabiobrz,1,0.00061,142521,87.40134,163065
3601,fabriceNanni,1,0.00061,142522,87.40196,163065
3602,falahatiali,1,0.00061,142523,87.40257,163065
3603,farzadpanahi,1,0.00061,142524,87.40318,163065
3604,fb64,1,0.00061,142525,87.40380,163065
3605,Fbain24,1,0.00061,142526,87.40441,163065
3606,fcps3,1,0.00061,142527,87.40502,163065
3607,fdaligand,1,0.00061,142528,87.40564,163065
3608,fdussert,1,0.00061,142529,87.40625,163065
3609,fdutron,1,0.00061,142530,87.40686,163065
3610,feiguzi,1,0.00061,142531,87.40748,163065
3611,felipememphis,1,0.00061,142532,87.40809,163065
3612,ffleandro,1,0.00061,142533,87.40870,163065
3613,fghinzelli,1,0.00061,142534,87.40932,163065
3614,fierg,1,0.00061,142535,87.40993,163065
3615,fifofonix,1,0.00061,142536,87.41054,163065
3616,finelycheng,1,0.00061,142537,87.41116,163065
3617,finiasz,1,0.00061,142538,87.41177,163065
3618,finventario,1,0.00061,142539,87.41238,163065
3619,fischmat,1,0.00061,142540,87.41299,163065
3620,fit2cloud-tangyunhao,1,0.00061,142541,87.41361,163065
3621,fjrial,1,0.00061,142542,87.41422,163065
3622,fkhachatrian,1,0.00061,142543,87.41483,163065
3623,fl0cke,1,0.00061,142544,87.41545,163065
3624,FloSeidel,1,0.00061,142545,87.41606,163065
3625,FloV22,1,0.00061,142546,87.41667,163065
3626,fmatar,1,0.00061,142547,87.41729,163065
3627,fo0,1,0.00061,142548,87.41790,163065
3628,fofo2411,1,0.00061,142549,87.41851,163065
3629,formatq,1,0.00061,142550,87.41913,163065
3630,fpmoles,1,0.00061,142551,87.41974,163065
3631,fraiguana,1,0.00061,142552,87.42035,163065
3632,francilioaraujo,1,0.00061,142553,87.42097,163065
3633,francis-pouatcha,1,0.00061,142554,87.42158,163065
3634,FranckBsk,1,0.00061,142555,87.42219,163065
3635,frank-mugrauer,1,0.00061,142556,87.42281,163065
3636,franzmoca,1,0.00061,142557,87.42342,163065
3637,franz-see,1,0.00061,142558,87.42403,163065
3638,Freakaz0id,1,0.00061,142559,87.42465,163065
3639,freddytuxworth,1,0.00061,142560,87.42526,163065
3640,FredericV,1,0.00061,142561,87.42587,163065
3641,frederikvanhoyweghen,1,0.00061,142562,87.42649,163065
3642,fredlb,1,0.00061,142563,87.42710,163065
3643,fredxing,1,0.00061,142564,87.42771,163065
3644,freezb46,1,0.00061,142565,87.42833,163065
3645,Freir96,1,0.00061,142566,87.42894,163065
3646,Fristi,1,0.00061,142567,87.42955,163065
3647,FritzJo,1,0.00061,142568,87.43017,163065
3648,frizzorh,1,0.00061,142569,87.43078,163065
3649,froli-code,1,0.00061,142570,87.43139,163065
3650,froque,1,0.00061,142571,87.43201,163065
3651,fscz,1,0.00061,142572,87.43262,163065
3652,fsebbah,1,0.00061,142573,87.43323,163065
3653,fstaine,1,0.00061,142574,87.43385,163065
3654,f-stibane,1,0.00061,142575,87.43446,163065
3655,fuesec,1,0.00061,142576,87.43507,163065
3656,fulljackz,1,0.00061,142577,87.43569,163065
3657,FullofQuarks,1,0.00061,142578,87.43630,163065
3658,future-ito-masahiko,1,0.00061,142579,87.43691,163065
3659,fuykun,1,0.00061,142580,87.43752,163065
3660,fwollsch,1,0.00061,142581,87.43814,163065
3661,fzyzcjy,1,0.00061,142582,87.43875,163065
3662,g4c3,1,0.00061,142583,87.43936,163065
3663,gabrielsch,1,0.00061,142584,87.43998,163065
3664,gadielkalleb,1,0.00061,142585,87.44059,163065
3665,galikpschibsted,1,0.00061,142586,87.44120,163065
3666,gallexme,1,0.00061,142587,87.44182,163065
3667,galsilb,1,0.00061,142588,87.44243,163065
3668,galzetta,1,0.00061,142589,87.44304,163065
3669,GandalfUFR,1,0.00061,142590,87.44366,163065
3670,gangapatnam-suresh,1,0.00061,142591,87.44427,163065
3671,gargii,1,0.00061,142592,87.44488,163065
3672,garritschroeder0001,1,0.00061,142593,87.44550,163065
3673,GaToRAiD,1,0.00061,142594,87.44611,163065
3674,GauthierV,1,0.00061,142595,87.44672,163065
3675,GavinCui9,1,0.00061,142596,87.44734,163065
3676,gdhameeja,1,0.00061,142597,87.44795,163065
3677,gedpal,1,0.00061,142598,87.44856,163065
3678,GenuineGuineapig,1,0.00061,142599,87.44918,163065
3679,geo-matheou,1,0.00061,142600,87.44979,163065
3680,georules,1,0.00061,142601,87.45040,163065
3681,gergely-nagy,1,0.00061,142602,87.45102,163065
3682,GerryDominic,1,0.00061,142603,87.45163,163065
3683,gfnord,1,0.00061,142604,87.45224,163065
3684,ggalejandro,1,0.00061,142605,87.45286,163065
3685,ggrussenmeyer,1,0.00061,142606,87.45347,163065
3686,ghost81,1,0.00061,142607,87.45408,163065
3687,giddel,1,0.00061,142608,87.45470,163065
3688,GiganteX,1,0.00061,142609,87.45531,163065
3689,gilliangoud,1,0.00061,142610,87.45592,163065
3690,gilxa1226,1,0.00061,142611,87.45654,163065
3691,gingters,1,0.00061,142612,87.45715,163065
3692,girishbapat,1,0.00061,142613,87.45776,163065
3693,GisleGrimen,1,0.00061,142614,87.45838,163065
3694,GissilyWork,1,0.00061,142615,87.45899,163065
3695,githubcek,1,0.00061,142616,87.45960,163065
3696,Github-Shayype,1,0.00061,142617,87.46022,163065
3697,gknapowski,1,0.00061,142618,87.46083,163065
3698,glennbech,1,0.00061,142619,87.46144,163065
3699,glenncai,1,0.00061,142620,87.46206,163065
3700,g-londhe,1,0.00061,142621,87.46267,163065
3701,glugy,1,0.00061,142622,87.46328,163065
3702,glutengo,1,0.00061,142623,87.46389,163065
3703,gmanolache,1,0.00061,142624,87.46451,163065
3704,gno65,1,0.00061,142625,87.46512,163065
3705,gnofi-amplify,1,0.00061,142626,87.46573,163065
3706,gobeli,1,0.00061,142627,87.46635,163065
3707,gogillu,1,0.00061,142628,87.46696,163065
3708,go-ive,1,0.00061,142629,87.46757,163065
3709,good-engineer,1,0.00061,142630,87.46819,163065
3710,goosecrew,1,0.00061,142631,87.46880,163065
3711,gp187,1,0.00061,142632,87.46941,163065
3712,gracegyu,1,0.00061,142633,87.47003,163065
3713,gregapreseren,1,0.00061,142634,87.47064,163065
3714,greghall76,1,0.00061,142635,87.47125,163065
3715,greg-pendlebury,1,0.00061,142636,87.47187,163065
3716,griftir,1,0.00061,142637,87.47248,163065
3717,grldchz,1,0.00061,142638,87.47309,163065
3718,grzi,1,0.00061,142639,87.47371,163065
3719,gsteppe,1,0.00061,142640,87.47432,163065
3720,gsustek,1,0.00061,142641,87.47493,163065
3721,gudatcomputers,1,0.00061,142642,87.47555,163065
3722,guilhem88,1,0.00061,142643,87.47616,163065
3723,GurjotGrewal123,1,0.00061,142644,87.47677,163065
3724,GutoPereira,1,0.00061,142645,87.47739,163065
3725,gutschalk,1,0.00061,142646,87.47800,163065
3726,gutschet,1,0.00061,142647,87.47861,163065
3727,Gwemox,1,0.00061,142648,87.47923,163065
3728,gwin003,1,0.00061,142649,87.47984,163065
3729,h4gbard,1,0.00061,142650,87.48045,163065
3730,haddly,1,0.00061,142651,87.48107,163065
3731,haderlena,1,0.00061,142652,87.48168,163065
3732,HaithamOumerzoug,1,0.00061,142653,87.48229,163065
3733,hakku19,1,0.00061,142654,87.48291,163065
3734,hamzashahid91,1,0.00061,142655,87.48352,163065
3735,HannahBrown,1,0.00061,142656,87.48413,163065
3736,Hans0924,1,0.00061,142657,87.48475,163065
3737,HardNorth,1,0.00061,142658,87.48536,163065
3738,harishjadhav26,1,0.00061,142659,87.48597,163065
3739,harshdesai991,1,0.00061,142660,87.48659,163065
3740,haymh,1,0.00061,142661,87.48720,163065
3741,hazhirh,1,0.00061,142662,87.48781,163065
3742,hbadri3,1,0.00061,142663,87.48842,163065
3743,hbitsch,1,0.00061,142664,87.48904,163065
3744,hbjydev,1,0.00061,142665,87.48965,163065
3745,heilerich,1,0.00061,142666,87.49026,163065
3746,helenazhang27,1,0.00061,142667,87.49088,163065
3747,HelloTo4x,1,0.00061,142668,87.49149,163065
3748,henczi,1,0.00061,142669,87.49210,163065
3749,hendisantika,1,0.00061,142670,87.49272,163065
3750,HenkLaracker,1,0.00061,142671,87.49333,163065
3751,henk-n,1,0.00061,142672,87.49394,163065
3752,henry2man,1,0.00061,142673,87.49456,163065
3753,hesch,1,0.00061,142674,87.49517,163065
3754,heukoe,1,0.00061,142675,87.49578,163065
3755,hex2a,1,0.00061,142676,87.49640,163065
3756,hfastek,1,0.00061,142677,87.49701,163065
3757,hikemachado,1,0.00061,142678,87.49762,163065
3758,Hildebrand-Ritense,1,0.00061,142679,87.49824,163065
3759,hitk6,1,0.00061,142680,87.49885,163065
3760,HJain01,1,0.00061,142681,87.49946,163065
3761,hmica,1,0.00061,142682,87.50008,163065
3762,hmolsen,1,0.00061,142683,87.50069,163065
3763,hnhai,1,0.00061,142684,87.50130,163065
3764,HNygard,1,0.00061,142685,87.50192,163065
3765,HoaMai0205,1,0.00061,142686,87.50253,163065
3766,hoangdinhnarvar,1,0.00061,142687,87.50314,163065
3767,hoepfnerj,1,0.00061,142688,87.50376,163065
3768,holgerjenczewski1007,1,0.00061,142689,87.50437,163065
3769,holycrab13,1,0.00061,142690,87.50498,163065
3770,honza-kasik,1,0.00061,142691,87.50560,163065
3771,honza-zidek,1,0.00061,142692,87.50621,163065
3772,hornet-9,1,0.00061,142693,87.50682,163065
3773,horori,1,0.00061,142694,87.50744,163065
3774,hraab,1,0.00061,142695,87.50805,163065
3775,hrenard,1,0.00061,142696,87.50866,163065
3776,html04,1,0.00061,142697,87.50928,163065
3777,huangbaron2,1,0.00061,142698,87.50989,163065
3778,hubwoop,1,0.00061,142699,87.51050,163065
3779,HundredBai,1,0.00061,142700,87.51112,163065
3780,husoman,1,0.00061,142701,87.51173,163065
3781,hvhung,1,0.00061,142702,87.51234,163065
3782,HW-Owl,1,0.00061,142703,87.51295,163065
3783,hypervtechnics,1,0.00061,142704,87.51357,163065
3784,ia3andy,1,0.00061,142705,87.51418,163065
3785,iacolucci,1,0.00061,142706,87.51479,163065
3786,IAMJDA,1,0.00061,142707,87.51541,163065
3787,iam-roger-io,1,0.00061,142708,87.51602,163065
3788,IamSuhaz,1,0.00061,142709,87.51663,163065
3789,ianwilk20,1,0.00061,142710,87.51725,163065
3790,ibagaric,1,0.00061,142711,87.51786,163065
3791,icarezee,1,0.00061,142712,87.51847,163065
3792,icc-garciaju,1,0.00061,142713,87.51909,163065
3793,icereed,1,0.00061,142714,87.51970,163065
3794,ichantzaras,1,0.00061,142715,87.52031,163065
3795,iethem,1,0.00061,142716,87.52093,163065
3796,igorlovich,1,0.00061,142717,87.52154,163065
3797,IgorWang,1,0.00061,142718,87.52215,163065
3798,ihostage,1,0.00061,142719,87.52277,163065
3799,iigorr,1,0.00061,142720,87.52338,163065
3800,ikcalB,1,0.00061,142721,87.52399,163065
3801,ikeycc,1,0.00061,142722,87.52461,163065
3802,ilhansubasi,1,0.00061,142723,87.52522,163065
3803,ilhanyumer,1,0.00061,142724,87.52583,163065
3804,iliaskomp,1,0.00061,142725,87.52645,163065
3805,IlyaHoloday,1,0.00061,142726,87.52706,163065
3806,ilyuxa-sw97,1,0.00061,142727,87.52767,163065
3807,imcyee,1,0.00061,142728,87.52829,163065
3808,immieszko,1,0.00061,142729,87.52890,163065
3809,imranshafqat,1,0.00061,142730,87.52951,163065
3810,Ing0R,1,0.00061,142731,87.53013,163065
3811,inglor,1,0.00061,142732,87.53074,163065
3812,invalid-email-address,1,0.00061,142733,87.53135,163065
3813,iokasti,1,0.00061,142734,87.53197,163065
3814,ipax77,1,0.00061,142735,87.53258,163065
3815,iposmashnyi,1,0.00061,142736,87.53319,163065
3816,irgeek,1,0.00061,142737,87.53381,163065
3817,it-aperam,1,0.00061,142738,87.53442,163065
3818,itay-grudev,1,0.00061,142739,87.53503,163065
3819,it-bas,1,0.00061,142740,87.53565,163065
3820,ithilelda,1,0.00061,142741,87.53626,163065
3821,itsalb3rt,1,0.00061,142742,87.53687,163065
3822,ItsTarik,1,0.00061,142743,87.53749,163065
3823,iudex-,1,0.00061,142744,87.53810,163065
3824,IvanDugandzic,1,0.00061,142745,87.53871,163065
3825,ivanilavsky,1,0.00061,142746,87.53932,163065
3826,J3m5,1,0.00061,142747,87.53994,163065
3827,Jaap2D2,1,0.00061,142748,87.54055,163065
3828,jackson2213,1,0.00061,142749,87.54116,163065
3829,jadiaheno,1,0.00061,142750,87.54178,163065
3830,jafkn,1,0.00061,142751,87.54239,163065
3831,jagin,1,0.00061,142752,87.54300,163065
3832,jaimeagudo,1,0.00061,142753,87.54362,163065
3833,jakubbadecki,1,0.00061,142754,87.54423,163065
3834,JaleelB,1,0.00061,142755,87.54484,163065
3835,jamesfoster,1,0.00061,142756,87.54546,163065
3836,jamesmarshall24,1,0.00061,142757,87.54607,163065
3837,JamesPeters98,1,0.00061,142758,87.54668,163065
3838,jamhall,1,0.00061,142759,87.54730,163065
3839,JamieSee,1,0.00061,142760,87.54791,163065
3840,jamie-tillman,1,0.00061,142761,87.54852,163065
3841,jannikhuels,1,0.00061,142762,87.54914,163065
3842,jan-peter-alten-bmw,1,0.00061,142763,87.54975,163065
3843,janssk1,1,0.00061,142764,87.55036,163065
3844,janstey,1,0.00061,142765,87.55098,163065
3845,JanuszTaterka,1,0.00061,142766,87.55159,163065
3846,J-Are,1,0.00061,142767,87.55220,163065
3847,jaredtbates,1,0.00061,142768,87.55282,163065
3848,jas1989,1,0.00061,142769,87.55343,163065
3849,jason-choi1,1,0.00061,142770,87.55404,163065
3850,JasonGantner,1,0.00061,142771,87.55466,163065
3851,JayChandler,1,0.00061,142772,87.55527,163065
3852,jaydavid1996,1,0.00061,142773,87.55588,163065
3853,jazonmiller,1,0.00061,142774,87.55650,163065
3854,JAZZ-FROM-HELL,1,0.00061,142775,87.55711,163065
3855,jbadilla,1,0.00061,142776,87.55772,163065
3856,jbeaken,1,0.00061,142777,87.55834,163065
3857,jbrongtr,1,0.00061,142778,87.55895,163065
3858,jcgoette,1,0.00061,142779,87.55956,163065
3859,jdariasl80,1,0.00061,142780,87.56018,163065
3860,JDDurrant,1,0.00061,142781,87.56079,163065
3861,jdevreese,1,0.00061,142782,87.56140,163065
3862,jdoyleoss,1,0.00061,142783,87.56202,163065
3863,jeanadrien,1,0.00061,142784,87.56263,163065
3864,jeffschulman,1,0.00061,142785,87.56324,163065
3865,jelies,1,0.00061,142786,87.56385,163065
3866,jendib,1,0.00061,142787,87.56447,163065
3867,jenkincstang,1,0.00061,142788,87.56508,163065
3868,jenspopp,1,0.00061,142789,87.56569,163065
3869,jeremymcgee73,1,0.00061,142790,87.56631,163065
3870,jeremy-soh-partior,1,0.00061,142791,87.56692,163065
3871,Jermorin,1,0.00061,142792,87.56753,163065
3872,jeromewaibel,1,0.00061,142793,87.56815,163065
3873,jesjobom,1,0.00061,142794,87.56876,163065
3874,JessArschoot,1,0.00061,142795,87.56937,163065
3875,jesse-savary,1,0.00061,142796,87.56999,163065
3876,jewanisw,1,0.00061,142797,87.57060,163065
3877,jfelsotc,1,0.00061,142798,87.57121,163065
3878,jfix,1,0.00061,142799,87.57183,163065
3879,jfrantzius,1,0.00061,142800,87.57244,163065
3880,jgoux,1,0.00061,142801,87.57305,163065
3881,jgrgt,1,0.00061,142802,87.57367,163065
3882,jhinzmann,1,0.00061,142803,87.57428,163065
3883,jiehuanli,1,0.00061,142804,87.57489,163065
3884,jimbo1007,1,0.00061,142805,87.57551,163065
3885,JimTyrrell,1,0.00061,142806,87.57612,163065
3886,JingJCV,1,0.00061,142807,87.57673,163065
3887,jinojohn92,1,0.00061,142808,87.57735,163065
3888,JiriOndrusek,1,0.00061,142809,87.57796,163065
3889,jitbasemartin,1,0.00061,142810,87.57857,163065
3890,jkouris,1,0.00061,142811,87.57919,163065
3891,jkrenzer,1,0.00061,142812,87.57980,163065
3892,jkristia,1,0.00061,142813,87.58041,163065
3893,jkuhnv,1,0.00061,142814,87.58103,163065
3894,jLebioda,1,0.00061,142815,87.58164,163065
3895,jlefebvre-vsct,1,0.00061,142816,87.58225,163065
3896,jlosantana,1,0.00061,142817,87.58287,163065
3897,JMacalinao,1,0.00061,142818,87.58348,163065
3898,jmax01,1,0.00061,142819,87.58409,163065
3899,jmeekseon,1,0.00061,142820,87.58471,163065
3900,jmong143,1,0.00061,142821,87.58532,163065
3901,jmuczynski,1,0.00061,142822,87.58593,163065
3902,JNygard,1,0.00061,142823,87.58655,163065
3903,jocelynthode,1,0.00061,142824,87.58716,163065
3904,joeitu,1,0.00061,142825,87.58777,163065
3905,JoelBennett,1,0.00061,142826,87.58838,163065
3906,joelgriffiths,1,0.00061,142827,87.58900,163065
3907,joelsonrochamk,1,0.00061,142828,87.58961,163065
3908,joerijansen,1,0.00061,142829,87.59022,163065
3909,joeyberkovitz,1,0.00061,142830,87.59084,163065
3910,JohannesDienstDBSystel,1,0.00061,142831,87.59145,163065
3911,johnmusa1957,1,0.00061,142832,87.59206,163065
3912,JohnPolansky,1,0.00061,142833,87.59268,163065
3913,johnpptz,1,0.00061,142834,87.59329,163065
3914,jok2,1,0.00061,142835,87.59390,163065
3915,jokyboy25,1,0.00061,142836,87.59452,163065
3916,jolisylvain,1,0.00061,142837,87.59513,163065
3917,JonAmuchastegui,1,0.00061,142838,87.59574,163065
3918,JonasPed,1,0.00061,142839,87.59636,163065
3919,Jonas-Sander,1,0.00061,142840,87.59697,163065
3920,jonathansoong15,1,0.00061,142841,87.59758,163065
3921,jonesr91,1,0.00061,142842,87.59820,163065
3922,Joni-Aaltonen,1,0.00061,142843,87.59881,163065
3923,jonlem88,1,0.00061,142844,87.59942,163065
3924,jorgesartori,1,0.00061,142845,87.60004,163065
3925,jornholm,1,0.00061,142846,87.60065,163065
3926,josemoralesp,1,0.00061,142847,87.60126,163065
3927,JoseOliveira01,1,0.00061,142848,87.60188,163065
3928,Joshhw,1,0.00061,142849,87.60249,163065
3929,Joshinwood,1,0.00061,142850,87.60310,163065
3930,joshisimt,1,0.00061,142851,87.60372,163065
3931,josh-nale,1,0.00061,142852,87.60433,163065
3932,JoshuaSchlichting,1,0.00061,142853,87.60494,163065
3933,Josh-West-Bose,1,0.00061,142854,87.60556,163065
3934,jpda,1,0.00061,142855,87.60617,163065
3935,jpmastermind,1,0.00061,142856,87.60678,163065
3936,JPMoresmau,1,0.00061,142857,87.60740,163065
3937,jpmsilva,1,0.00061,142858,87.60801,163065
3938,jprichemont,1,0.00061,142859,87.60862,163065
3939,jputney,1,0.00061,142860,87.60924,163065
3940,jpwarren,1,0.00061,142861,87.60985,163065
3941,jrivers96,1,0.00061,142862,87.61046,163065
3942,jrobinss,1,0.00061,142863,87.61108,163065
3943,jschlyter,1,0.00061,142864,87.61169,163065
3944,jstueckrath,1,0.00061,142865,87.61230,163065
3945,jt55401,1,0.00061,142866,87.61292,163065
3946,jtorbicki,1,0.00061,142867,87.61353,163065
3947,Juhi214-j,1,0.00061,142868,87.61414,163065
3948,juhoha,1,0.00061,142869,87.61475,163065
3949,jukka-wapice,1,0.00061,142870,87.61537,163065
3950,julienfollow,1,0.00061,142871,87.61598,163065
3951,julien-sarik,1,0.00061,142872,87.61659,163065
3952,jungm,1,0.00061,142873,87.61721,163065
3953,juzerali,1,0.00061,142874,87.61782,163065
3954,juzhiyuan,1,0.00061,142875,87.61843,163065
3955,jvanhill,1,0.00061,142876,87.61905,163065
3956,jvdvTechno,1,0.00061,142877,87.61966,163065
3957,jwausle,1,0.00061,142878,87.62027,163065
3958,JWood48,1,0.00061,142879,87.62089,163065
3959,jxsl13,1,0.00061,142880,87.62150,163065
3960,jy95,1,0.00061,142881,87.62211,163065
3961,jziggas,1,0.00061,142882,87.62273,163065
3962,k0sm0navt,1,0.00061,142883,87.62334,163065
3963,kaabar,1,0.00061,142884,87.62395,163065
3964,Kagee,1,0.00061,142885,87.62457,163065
3965,kantum,1,0.00061,142886,87.62518,163065
3966,kapalex,1,0.00061,142887,87.62579,163065
3967,KapowraLL,1,0.00061,142888,87.62641,163065
3968,kareez,1,0.00061,142889,87.62702,163065
3969,karensg,1,0.00061,142890,87.62763,163065
3970,karimerrahli,1,0.00061,142891,87.62825,163065
3971,kariya-mitsuru,1,0.00061,142892,87.62886,163065
3972,karolbryzgiel,1,0.00061,142893,87.62947,163065
3973,karthikrsubs,1,0.00061,142894,87.63009,163065
3974,karvir26,1,0.00061,142895,87.63070,163065
3975,kashifrana449,1,0.00061,142896,87.63131,163065
3976,kave-h,1,0.00061,142897,87.63193,163065
3977,kbumsik,1,0.00061,142898,87.63254,163065
3978,KCBoys,1,0.00061,142899,87.63315,163065
3979,kchaber,1,0.00061,142900,87.63377,163065
3980,kdureidy,1,0.00061,142901,87.63438,163065
3981,kekedaine,1,0.00061,142902,87.63499,163065
3982,kelimutu,1,0.00061,142903,87.63561,163065
3983,kemalk89,1,0.00061,142904,87.63622,163065
3984,KenG98,1,0.00061,142905,87.63683,163065
3985,kenmoini,1,0.00061,142906,87.63745,163065
3986,kennymac,1,0.00061,142907,87.63806,163065
3987,KentaKogumasaka,1,0.00061,142908,87.63867,163065
3988,KenZync,1,0.00061,142909,87.63928,163065
3989,kepeder,1,0.00061,142910,87.63990,163065
3990,kerkmann,1,0.00061,142911,87.64051,163065
3991,kevariste225,1,0.00061,142912,87.64112,163065
3992,Kevin-Andrew,1,0.00061,142913,87.64174,163065
3993,kevinlul,1,0.00061,142914,87.64235,163065
3994,KevinMordijck,1,0.00061,142915,87.64296,163065
3995,kevinresol,1,0.00061,142916,87.64358,163065
3996,kgeis,1,0.00061,142917,87.64419,163065
3997,khanisak,1,0.00061,142918,87.64480,163065
3998,kicaj29,1,0.00061,142919,87.64542,163065
3999,kiisodj,1,0.00061,142920,87.64603,163065
4000,Kilian22,1,0.00061,142921,87.64664,163065
4001,KillerDiller,1,0.00061,142922,87.64726,163065
4002,KindHryhoriiShats,1,0.00061,142923,87.64787,163065
4003,kingjuk,1,0.00061,142924,87.64848,163065
4004,Kingside88,1,0.00061,142925,87.64910,163065
4005,kingxjs,1,0.00061,142926,87.64971,163065
4006,kirbylink,1,0.00061,142927,87.65032,163065
4007,Kirbylix,1,0.00061,142928,87.65094,163065
4008,kiriakos,1,0.00061,142929,87.65155,163065
4009,kiriencoder,1,0.00061,142930,87.65216,163065
4010,kisaga,1,0.00061,142931,87.65278,163065
4011,kitd,1,0.00061,142932,87.65339,163065
4012,kitenco,1,0.00061,142933,87.65400,163065
4013,kjellski,1,0.00061,142934,87.65462,163065
4014,k-jingyang,1,0.00061,142935,87.65523,163065
4015,kkirilov91,1,0.00061,142936,87.65584,163065
4016,kkottke,1,0.00061,142937,87.65646,163065
4017,klajdiPAJA,1,0.00061,142938,87.65707,163065
4018,KlausNie,1,0.00061,142939,87.65768,163065
4019,kleanthisSym,1,0.00061,142940,87.65830,163065
4020,klose4711,1,0.00061,142941,87.65891,163065
4021,kmih,1,0.00061,142942,87.65952,163065
4022,kmoorejr9,1,0.00061,142943,87.66014,163065
4023,KnifeHand,1,0.00061,142944,87.66075,163065
4024,KoEurogard,1,0.00061,142945,87.66136,163065
4025,koldoon,1,0.00061,142946,87.66198,163065
4026,KonstantinCodes,1,0.00061,142947,87.66259,163065
4027,koponkin,1,0.00061,142948,87.66320,163065
4028,koraytugay,1,0.00061,142949,87.66382,163065
4029,kostiapl,1,0.00061,142950,87.66443,163065
4030,koureasstavros,1,0.00061,142951,87.66504,163065
4031,KOVCHENKO,1,0.00061,142952,87.66565,163065
4032,kpbasu,1,0.00061,142953,87.66627,163065
4033,kplantjr,1,0.00061,142954,87.66688,163065
4034,kresnasatya,1,0.00061,142955,87.66749,163065
4035,krillehbg,1,0.00061,142956,87.66811,163065
4036,krishna710942,1,0.00061,142957,87.66872,163065
4037,krishna-kunderu,1,0.00061,142958,87.66933,163065
4038,krugerm-4c,1,0.00061,142959,87.66995,163065
4039,krvajal,1,0.00061,142960,87.67056,163065
4040,krzysztof-zych,1,0.00061,142961,87.67117,163065
4041,ksadjad,1,0.00061,142962,87.67179,163065
4042,kschroeder-of,1,0.00061,142963,87.67240,163065
4043,kspar,1,0.00061,142964,87.67301,163065
4044,Kuchenm0nster,1,0.00061,142965,87.67363,163065
4045,kuhhpid,1,0.00061,142966,87.67424,163065
4046,kunalgithub,1,0.00061,142967,87.67485,163065
4047,kungfuchicken,1,0.00061,142968,87.67547,163065
4048,kvart2006,1,0.00061,142969,87.67608,163065
4049,kvishal2203,1,0.00061,142970,87.67669,163065
4050,kwouters,1,0.00061,142971,87.67731,163065
4051,lachatak,1,0.00061,142972,87.67792,163065
4052,Laith-Grira,1,0.00061,142973,87.67853,163065
4053,LajosCseppento,1,0.00061,142974,87.67915,163065
4054,lajosthiel,1,0.00061,142975,87.67976,163065
4055,lalrishav,1,0.00061,142976,87.68037,163065
4056,lanmarc77,1,0.00061,142977,87.68099,163065
4057,lanmarti,1,0.00061,142978,87.68160,163065
4058,lannonbr,1,0.00061,142979,87.68221,163065
4059,Lantaros,1,0.00061,142980,87.68283,163065
4060,lapphan,1,0.00061,142981,87.68344,163065
4061,larmbuster,1,0.00061,142982,87.68405,163065
4062,lathspell,1,0.00061,142983,87.68467,163065
4063,lbvffvbl,1,0.00061,142984,87.68528,163065
4064,LCerebo,1,0.00061,142985,87.68589,163065
4065,ldesroch,1,0.00061,142986,87.68651,163065
4066,leandrodaf,1,0.00061,142987,87.68712,163065
4067,learnpy2020,1,0.00061,142988,87.68773,163065
4068,LEDfan,1,0.00061,142989,87.68835,163065
4069,leewoobin789,1,0.00061,142990,87.68896,163065
4070,LehouxKevin,1,0.00061,142991,87.68957,163065
4071,lejsekt,1,0.00061,142992,87.69018,163065
4072,lellis32,1,0.00061,142993,87.69080,163065
4073,LelouBil,1,0.00061,142994,87.69141,163065
4074,lelvisl,1,0.00061,142995,87.69202,163065
4075,lemmywrap,1,0.00061,142996,87.69264,163065
4076,lemonit-eric-mao,1,0.00061,142997,87.69325,163065
4077,lenguyenkhoi21,1,0.00061,142998,87.69386,163065
4078,lennartpost,1,0.00061,142999,87.69448,163065
4079,leodip,1,0.00061,143000,87.69509,163065
4080,lepeli,1,0.00061,143001,87.69570,163065
4081,lequy1010,1,0.00061,143002,87.69632,163065
4082,lesterb,1,0.00061,143003,87.69693,163065
4083,letschers,1,0.00061,143004,87.69754,163065
4084,leviia,1,0.00061,143005,87.69816,163065
4085,levyndot,1,0.00061,143006,87.69877,163065
4086,lexakozakov,1,0.00061,143007,87.69938,163065
4087,lexsoto,1,0.00061,143008,87.70000,163065
4088,lgthibault,1,0.00061,143009,87.70061,163065
4089,lhoe,1,0.00061,143010,87.70122,163065
4090,lienide,1,0.00061,143011,87.70184,163065
4091,Lieven-Meersens,1,0.00061,143012,87.70245,163065
4092,LiJunBJZhu,1,0.00061,143013,87.70306,163065
4093,linhtrinh,1,0.00061,143014,87.70368,163065
4094,linm02,1,0.00061,143015,87.70429,163065
4095,lino79,1,0.00061,143016,87.70490,163065
4096,literalplus,1,0.00061,143017,87.70552,163065
4097,littlechicks,1,0.00061,143018,87.70613,163065
4098,little-headbanger,1,0.00061,143019,87.70674,163065
4099,liubinwang2009,1,0.00061,143020,87.70736,163065
4100,Liu-Junlin,1,0.00061,143021,87.70797,163065
4101,livesega,1,0.00061,143022,87.70858,163065
4102,livvius,1,0.00061,143023,87.70920,163065
4103,llka,1,0.00061,143024,87.70981,163065
4104,lloopesg,1,0.00061,143025,87.71042,163065
4105,lluccia,1,0.00061,143026,87.71104,163065
4106,lmller,1,0.00061,143027,87.71165,163065
4107,lmove,1,0.00061,143028,87.71226,163065
4108,lodygens,1,0.00061,143029,87.71288,163065
4109,loetscher,1,0.00061,143030,87.71349,163065
4110,logemann,1,0.00061,143031,87.71410,163065
4111,loiclacombe-transatel,1,0.00061,143032,87.71471,163065
4112,loldiges,1,0.00061,143033,87.71533,163065
4113,longdog,1,0.00061,143034,87.71594,163065
4114,longtimeago,1,0.00061,143035,87.71655,163065
4115,LorenzoLuconi,1,0.00061,143036,87.71717,163065
4116,Lowentwickler,1,0.00061,143037,87.71778,163065
4117,LPCmedia,1,0.00061,143038,87.71839,163065
4118,lraynal,1,0.00061,143039,87.71901,163065
4119,lrodriguez14,1,0.00061,143040,87.71962,163065
4120,lstoeferle,1,0.00061,143041,87.72023,163065
4121,ltorzynski,1,0.00061,143042,87.72085,163065
4122,LucaNeel,1,0.00061,143043,87.72146,163065
4123,LucasFebatis,1,0.00061,143044,87.72207,163065
4124,lucashenning,1,0.00061,143045,87.72269,163065
4125,lucasscheepers,1,0.00061,143046,87.72330,163065
4126,luciferankon,1,0.00061,143047,87.72391,163065
4127,luis-almeida-santos,1,0.00061,143048,87.72453,163065
4128,luje,1,0.00061,143049,87.72514,163065
4129,lukashass,1,0.00061,143050,87.72575,163065
4130,LukasVojacek,1,0.00061,143051,87.72637,163065
4131,lukaszbudnik,1,0.00061,143052,87.72698,163065
4132,lukenjmcd,1,0.00061,143053,87.72759,163065
4133,luke-sensei,1,0.00061,143054,87.72821,163065
4134,luketainton,1,0.00061,143055,87.72882,163065
4135,LukeTx,1,0.00061,143056,87.72943,163065
4136,lunicon,1,0.00061,143057,87.73005,163065
4137,lus,1,0.00061,143058,87.73066,163065
4138,Lusca56,1,0.00061,143059,87.73127,163065
4139,lusoalex,1,0.00061,143060,87.73189,163065
4140,LuxTheDude,1,0.00061,143061,87.73250,163065
4141,m0rph2us,1,0.00061,143062,87.73311,163065
4142,maaroen,1,0.00061,143063,87.73373,163065
4143,maartenraes,1,0.00061,143064,87.73434,163065
4144,maarten-ritense,1,0.00061,143065,87.73495,163065
4145,mablds,1,0.00061,143066,87.73557,163065
4146,macalak,1,0.00061,143067,87.73618,163065
4147,MaciejDybowski,1,0.00061,143068,87.73679,163065
4148,madbrain,1,0.00061,143069,87.73741,163065
4149,madduci,1,0.00061,143070,87.73802,163065
4150,maddy16,1,0.00061,143071,87.73863,163065
4151,madhukkc,1,0.00061,143072,87.73925,163065
4152,madhurjyaroy,1,0.00061,143073,87.73986,163065
4153,madrover,1,0.00061,143074,87.74047,163065
4154,magdalene,1,0.00061,143075,87.74108,163065
4155,magor,1,0.00061,143076,87.74170,163065
4156,MahsaRamezani,1,0.00061,143077,87.74231,163065
4157,Mailstorm-ctrl,1,0.00061,143078,87.74292,163065
4158,maioria,1,0.00061,143079,87.74354,163065
4159,maitrungduc1410,1,0.00061,143080,87.74415,163065
4160,maltegrosse,1,0.00061,143081,87.74476,163065
4161,malweka,1,0.00061,143082,87.74538,163065
4162,mamahara,1,0.00061,143083,87.74599,163065
4163,manimovassagh,1,0.00061,143084,87.74660,163065
4164,Manish3323,1,0.00061,143085,87.74722,163065
4165,manizm,1,0.00061,143086,87.74783,163065
4166,mansimrans78,1,0.00061,143087,87.74844,163065
4167,MansurAliKoroglu,1,0.00061,143088,87.74906,163065
4168,Manu10744,1,0.00061,143089,87.74967,163065
4169,manuserranog,1,0.00061,143090,87.75028,163065
4170,Manydia,1,0.00061,143091,87.75090,163065
4171,mapkyca,1,0.00061,143092,87.75151,163065
4172,maradanasai,1,0.00061,143093,87.75212,163065
4173,marbindrakon,1,0.00061,143094,87.75274,163065
4174,marbon87,1,0.00061,143095,87.75335,163065
4175,marcin-kasinski,1,0.00061,143096,87.75396,163065
4176,marcinskibinski,1,0.00061,143097,87.75458,163065
4177,marcoandreini,1,0.00061,143098,87.75519,163065
4178,marcoBros,1,0.00061,143099,87.75580,163065
4179,MarcTM01,1,0.00061,143100,87.75642,163065
4180,Mario-Eis,1,0.00061,143101,87.75703,163065
4181,MarissaTee,1,0.00061,143102,87.75764,163065
4182,Markus-Schwer,1,0.00061,143103,87.75826,163065
4183,Martin-Aulich,1,0.00061,143104,87.75887,163065
4184,MartinBoehmer,1,0.00061,143105,87.75948,163065
4185,martinhpunkt,1,0.00061,143106,87.76010,163065
4186,Martin-Luft,1,0.00061,143107,87.76071,163065
4187,martoncsukas,1,0.00061,143108,87.76132,163065
4188,marvincorreia,1,0.00061,143109,87.76194,163065
4189,marvinscham,1,0.00061,143110,87.76255,163065
4190,masales,1,0.00061,143111,87.76316,163065
4191,MasanobuHatanaka,1,0.00061,143112,87.76378,163065
4192,ma-scha,1,0.00061,143113,87.76439,163065
4193,mashurex,1,0.00061,143114,87.76500,163065
4194,masteryyh,1,0.00061,143115,87.76561,163065
4195,MatCuk,1,0.00061,143116,87.76623,163065
4196,mateodelnorte,1,0.00061,143117,87.76684,163065
4197,mateuslima90,1,0.00061,143118,87.76745,163065
4198,matgnt,1,0.00061,143119,87.76807,163065
4199,mathias-pahlen,1,0.00061,143120,87.76868,163065
4200,mathiasslawik,1,0.00061,143121,87.76929,163065
4201,mathieu-pousse,1,0.00061,143122,87.76991,163065
4202,matthenslee,1,0.00061,143123,87.77052,163065
4203,matthewstrasiotto,1,0.00061,143124,87.77113,163065
4204,matthiastz,1,0.00061,143125,87.77175,163065
4205,Mattinn,1,0.00061,143126,87.77236,163065
4206,mattrobinsonsre,1,0.00061,143127,87.77297,163065
4207,mattwilliams,1,0.00061,143128,87.77359,163065
4208,matus-olejnik,1,0.00061,143129,87.77420,163065
4209,maulidandev,1,0.00061,143130,87.77481,163065
4210,maxandriani,1,0.00061,143131,87.77543,163065
4211,MaxFichtelmann,1,0.00061,143132,87.77604,163065
4212,maximilianlemberg,1,0.00061,143133,87.77665,163065
4213,maxsommer,1,0.00061,143134,87.77727,163065
4214,max-stytch,1,0.00061,143135,87.77788,163065
4215,mayur9991,1,0.00061,143136,87.77849,163065
4216,mbuchner,1,0.00061,143137,87.77911,163065
4217,mbuotidem,1,0.00061,143138,87.77972,163065
4218,mcbain,1,0.00061,143139,87.78033,163065
4219,mcooney8,1,0.00061,143140,87.78095,163065
4220,mddamato,1,0.00061,143141,87.78156,163065
4221,mduzgun,1,0.00061,143142,87.78217,163065
4222,med93600,1,0.00061,143143,87.78279,163065
4223,meden,1,0.00061,143144,87.78340,163065
4224,meghanaph,1,0.00061,143145,87.78401,163065
4225,meridbt,1,0.00061,143146,87.78463,163065
4226,MerlijnElderhuis,1,0.00061,143147,87.78524,163065
4227,meronz,1,0.00061,143148,87.78585,163065
4228,mfbmina,1,0.00061,143149,87.78647,163065
4229,mferuglio,1,0.00061,143150,87.78708,163065
4230,mflorczak,1,0.00061,143151,87.78769,163065
4231,mgmeiner,1,0.00061,143152,87.78831,163065
4232,mgpcoe,1,0.00061,143153,87.78892,163065
4233,mhagnumdw,1,0.00061,143154,87.78953,163065
4234,mhenke96,1,0.00061,143155,87.79015,163065
4235,mhlindstr,1,0.00061,143156,87.79076,163065
4236,Mhmd-Ali,1,0.00061,143157,87.79137,163065
4237,MHormes,1,0.00061,143158,87.79198,163065
4238,mhristof,1,0.00061,143159,87.79260,163065
4239,mhrsalehi,1,0.00061,143160,87.79321,163065
4240,mhshams,1,0.00061,143161,87.79382,163065
4241,micgme-WittGruppe,1,0.00061,143162,87.79444,163065
4242,michaelgarde,1,0.00061,143163,87.79505,163065
4243,MichaelJahn,1,0.00061,143164,87.79566,163065
4244,MichaK1,1,0.00061,143165,87.79628,163065
4245,michalm86,1,0.00061,143166,87.79689,163065
4246,michalpomykala,1,0.00061,143167,87.79750,163065
4247,MichaoDev,1,0.00061,143168,87.79812,163065
4248,michbudz,1,0.00061,143169,87.79873,163065
4249,micksi,1,0.00061,143170,87.79934,163065
4250,miglocatiq,1,0.00061,143171,87.79996,163065
4251,mihui,1,0.00061,143172,87.80057,163065
4252,mikaayil,1,0.00061,143173,87.80118,163065
4253,mikaoelitiana,1,0.00061,143174,87.80180,163065
4254,MikeKasperlik,1,0.00061,143175,87.80241,163065
4255,MikeKrueger75,1,0.00061,143176,87.80302,163065
4256,mikemicky4321,1,0.00061,143177,87.80364,163065
4257,Mikescops,1,0.00061,143178,87.80425,163065
4258,mikesutton,1,0.00061,143179,87.80486,163065
4259,Milyardo,1,0.00061,143180,87.80548,163065
4260,Mimameid,1,0.00061,143181,87.80609,163065
4261,mimozell,1,0.00061,143182,87.80670,163065
4262,mindarchitect,1,0.00061,143183,87.80732,163065
4263,Mindiell,1,0.00061,143184,87.80793,163065
4264,mindmazeCH,1,0.00061,143185,87.80854,163065
4265,Minhception,1,0.00061,143186,87.80916,163065
4266,minoltan,1,0.00061,143187,87.80977,163065
4267,mirandamichel,1,0.00061,143188,87.81038,163065
4268,mirzaprangon,1,0.00061,143189,87.81100,163065
4269,misanche,1,0.00061,143190,87.81161,163065
4270,misino,1,0.00061,143191,87.81222,163065
4271,mister2d,1,0.00061,143192,87.81284,163065
4272,MisterBaz,1,0.00061,143193,87.81345,163065
4273,Mistic92,1,0.00061,143194,87.81406,163065
4274,mixman68,1,0.00061,143195,87.81468,163065
4275,mjallday,1,0.00061,143196,87.81529,163065
4276,mjattiot,1,0.00061,143197,87.81590,163065
4277,mjeffrey,1,0.00061,143198,87.81651,163065
4278,mjw4tson,1,0.00061,143199,87.81713,163065
4279,mkjpryor,1,0.00061,143200,87.81774,163065
4280,mkurte,1,0.00061,143201,87.81835,163065
4281,mlathara,1,0.00061,143202,87.81897,163065
4282,mlindstr,1,0.00061,143203,87.81958,163065
4283,mlovrovich,1,0.00061,143204,87.82019,163065
4284,mlsen,1,0.00061,143205,87.82081,163065
4285,mmaryo,1,0.00061,143206,87.82142,163065
4286,mmrvelj,1,0.00061,143207,87.82203,163065
4287,mncofinpro,1,0.00061,143208,87.82265,163065
4288,mnhock,1,0.00061,143209,87.82326,163065
4289,MNitschk,1,0.00061,143210,87.82387,163065
4290,mohamed-faris,1,0.00061,143211,87.82449,163065
4291,MohamedGawad,1,0.00061,143212,87.82510,163065
4292,Mohamed-Hammada,1,0.00061,143213,87.82571,163065
4293,mohanrajcognizant,1,0.00061,143214,87.82633,163065
4294,mokrueger,1,0.00061,143215,87.82694,163065
4295,molequetu,1,0.00061,143216,87.82755,163065
4296,Moranilt,1,0.00061,143217,87.82817,163065
4297,morco,1,0.00061,143218,87.82878,163065
4298,morepe,1,0.00061,143219,87.82939,163065
4299,mores,1,0.00061,143220,87.83001,163065
4300,moribvndvs,1,0.00061,143221,87.83062,163065
4301,mosynaq,1,0.00061,143222,87.83123,163065
4302,moussasarr490,1,0.00061,143223,87.83185,163065
4303,movertaker,1,0.00061,143224,87.83246,163065
4304,mpnunes,1,0.00061,143225,87.83307,163065
4305,mpodlodowski,1,0.00061,143226,87.83369,163065
4306,mpressmar,1,0.00061,143227,87.83430,163065
4307,mpromny,1,0.00061,143228,87.83491,163065
4308,mpuggelli-gucci,1,0.00061,143229,87.83553,163065
4309,mpulido73,1,0.00061,143230,87.83614,163065
4310,mr-DFX,1,0.00061,143231,87.83675,163065
4311,mreinli,1,0.00061,143232,87.83737,163065
4312,MrHassanMurtaza,1,0.00061,143233,87.83798,163065
4313,mrkimmy,1,0.00061,143234,87.83859,163065
4314,Mr-Markus,1,0.00061,143235,87.83921,163065
4315,mroate,1,0.00061,143236,87.83982,163065
4316,MrOrz,1,0.00061,143237,87.84043,163065
4317,mrpotato3,1,0.00061,143238,87.84104,163065
4318,mryangza,1,0.00061,143239,87.84166,163065
4319,mschielmann,1,0.00061,143240,87.84227,163065
4320,mschindl,1,0.00061,143241,87.84288,163065
4321,msepehr,1,0.00061,143242,87.84350,163065
4322,mshaposhnik,1,0.00061,143243,87.84411,163065
4323,M-Sivanraj,1,0.00061,143244,87.84472,163065
4324,mspark,1,0.00061,143245,87.84534,163065
4325,msts1906,1,0.00061,143246,87.84595,163065
4326,mterrade,1,0.00061,143247,87.84656,163065
4327,mtziak01,1,0.00061,143248,87.84718,163065
4328,mukulsinghsaini,1,0.00061,143249,87.84779,163065
4329,MumblesNZ,1,0.00061,143250,87.84840,163065
4330,Muntasir2001,1,0.00061,143251,87.84902,163065
4331,murugan425,1,0.00061,143252,87.84963,163065
4332,Mushoz,1,0.00061,143253,87.85024,163065
4333,mverbert,1,0.00061,143254,87.85086,163065
4334,mwhite-amplify,1,0.00061,143255,87.85147,163065
4335,mwiede,1,0.00061,143256,87.85208,163065
4336,mxandeco,1,0.00061,143257,87.85270,163065
4337,MXiao1995,1,0.00061,143258,87.85331,163065
4338,myalcinkuru,1,0.00061,143259,87.85392,163065
4339,myprogo,1,0.00061,143260,87.85454,163065
4340,MyrionsHub,1,0.00061,143261,87.85515,163065
4341,Mystikal57,1,0.00061,143262,87.85576,163065
4342,mytracks,1,0.00061,143263,87.85638,163065
4343,n0n0x,1,0.00061,143264,87.85699,163065
4344,nanachimi,1,0.00061,143265,87.85760,163065
4345,narasimhamurthi,1,0.00061,143266,87.85822,163065
4346,nathangerday,1,0.00061,143267,87.85883,163065
4347,naveenamruth,1,0.00061,143268,87.85944,163065
4348,nbolten,1,0.00061,143269,87.86006,163065
4349,nboxhallburnett,1,0.00061,143270,87.86067,163065
4350,ndsnas,1,0.00061,143271,87.86128,163065
4351,NeckBeardPrince,1,0.00061,143272,87.86190,163065
4352,nehaWakalkar,1,0.00061,143273,87.86251,163065
4353,nelson-lark,1,0.00061,143274,87.86312,163065
4354,nemerna,1,0.00061,143275,87.86374,163065
4355,neo-escieur,1,0.00061,143276,87.86435,163065
4356,NerijusVerseckas,1,0.00061,143277,87.86496,163065
4357,nerrehmit,1,0.00061,143278,87.86558,163065
4358,nesc58,1,0.00061,143279,87.86619,163065
4359,neshkeev,1,0.00061,143280,87.86680,163065
4360,NetForce1,1,0.00061,143281,87.86741,163065
4361,Nethaji03,1,0.00061,143282,87.86803,163065
4362,netoralves,1,0.00061,143283,87.86864,163065
4363,netthier,1,0.00061,143284,87.86925,163065
4364,nhantv95,1,0.00061,143285,87.86987,163065
4365,niceborn,1,0.00061,143286,87.87048,163065
4366,NickPadilla,1,0.00061,143287,87.87109,163065
4367,nickveliki,1,0.00061,143288,87.87171,163065
4368,NicolasHbz,1,0.00061,143289,87.87232,163065
4369,nicolas-nunca,1,0.00061,143290,87.87293,163065
4370,nicolas-torquetum,1,0.00061,143291,87.87355,163065
4371,nidomiro,1,0.00061,143292,87.87416,163065
4372,niek1414,1,0.00061,143293,87.87477,163065
4373,nielslanting,1,0.00061,143294,87.87539,163065
4374,nielspardon,1,0.00061,143295,87.87600,163065
4375,nielss76,1,0.00061,143296,87.87661,163065
4376,nigel-f-wilson,1,0.00061,143297,87.87723,163065
4377,nigtrifork,1,0.00061,143298,87.87784,163065
4378,niketrk,1,0.00061,143299,87.87845,163065
4379,niki17nl,1,0.00061,143300,87.87907,163065
4380,NikitaKemarskiyLeia,1,0.00061,143301,87.87968,163065
4381,nikitindv,1,0.00061,143302,87.88029,163065
4382,nikolaymihaylov,1,0.00061,143303,87.88091,163065
4383,nikoregister,1,0.00061,143304,87.88152,163065
4384,nikosmoum,1,0.00061,143305,87.88213,163065
4385,nilspreusker,1,0.00061,143306,87.88275,163065
4386,nine-testabe,1,0.00061,143307,87.88336,163065
4387,NingGelin,1,0.00061,143308,87.88397,163065
4388,ninogresenz,1,0.00061,143309,87.88459,163065
4389,niroussel,1,0.00061,143310,87.88520,163065
4390,nishanthreddy,1,0.00061,143311,87.88581,163065
4391,Nithe14,1,0.00061,143312,87.88643,163065
4392,nitishborade,1,0.00061,143313,87.88704,163065
4393,Nitue,1,0.00061,143314,87.88765,163065
4394,niveau0,1,0.00061,143315,87.88827,163065
4395,Nizar-Rahme,1,0.00061,143316,87.88888,163065
4396,NizarSteria,1,0.00061,143317,87.88949,163065
4397,nlmarco,1,0.00061,143318,87.89011,163065
4398,nmiddendorff,1,0.00061,143319,87.89072,163065
4399,nmoris,1,0.00061,143320,87.89133,163065
4400,noci2012,1,0.00061,143321,87.89194,163065
4401,noinfo,1,0.00061,143322,87.89256,163065
4402,noirwave,1,0.00061,143323,87.89317,163065
4403,noose,1,0.00061,143324,87.89378,163065
4404,noprysk-ua,1,0.00061,143325,87.89440,163065
4405,NorbertSandor,1,0.00061,143326,87.89501,163065
4406,norcron,1,0.00061,143327,87.89562,163065
4407,nostra83,1,0.00061,143328,87.89624,163065
4408,notTrinity,1,0.00061,143329,87.89685,163065
4409,nprabala,1,0.00061,143330,87.89746,163065
4410,nseb,1,0.00061,143331,87.89808,163065
4411,nte-ms,1,0.00061,143332,87.89869,163065
4412,nukulaar,1,0.00061,143333,87.89930,163065
4413,o1347mat,1,0.00061,143334,87.89992,163065
4414,Oaktreeroot,1,0.00061,143335,87.90053,163065
4415,od-jesser,1,0.00061,143336,87.90114,163065
4416,oguzkilcan,1,0.00061,143337,87.90176,163065
4417,ojathelonius,1,0.00061,143338,87.90237,163065
4418,OJezu,1,0.00061,143339,87.90298,163065
4419,OKELLOMARVIN,1,0.00061,143340,87.90360,163065
4420,okrasz,1,0.00061,143341,87.90421,163065
4421,oleaasbo,1,0.00061,143342,87.90482,163065
4422,oleeander,1,0.00061,143343,87.90544,163065
4423,OlegSchwann,1,0.00061,143344,87.90605,163065
4424,oleh-demkovych,1,0.00061,143345,87.90666,163065
4425,olekristoffer,1,0.00061,143346,87.90728,163065
4426,OleksanderRudenko,1,0.00061,143347,87.90789,163065
4427,olemathias,1,0.00061,143348,87.90850,163065
4428,olexandrbig,1,0.00061,143349,87.90912,163065
4429,OLibutzki,1,0.00061,143350,87.90973,163065
4430,OlivAnno,1,0.00061,143351,87.91034,163065
4431,olivierb2,1,0.00061,143352,87.91096,163065
4432,Olivier-SP,1,0.00061,143353,87.91157,163065
4433,olol13,1,0.00061,143354,87.91218,163065
4434,OmerWaleed,1,0.00061,143355,87.91280,163065
4435,omllobet,1,0.00061,143356,87.91341,163065
4436,ondrejsika,1,0.00061,143357,87.91402,163065
4437,onlyati,1,0.00061,143358,87.91464,163065
4438,oottka,1,0.00061,143359,87.91525,163065
4439,Or05230,1,0.00061,143360,87.91586,163065
4440,oridool,1,0.00061,143361,87.91648,163065
4441,OriSchmitz,1,0.00061,143362,87.91709,163065
4442,OSA413,1,0.00061,143363,87.91770,163065
4443,oscarmeras3,1,0.00061,143364,87.91831,163065
4444,osorionicolas,1,0.00061,143365,87.91893,163065
4445,osresearch,1,0.00061,143366,87.91954,163065
4446,otgrkiss,1,0.00061,143367,87.92015,163065
4447,otudosa,1,0.00061,143368,87.92077,163065
4448,ouzklcn,1,0.00061,143369,87.92138,163065
4449,overheadhunter,1,0.00061,143370,87.92199,163065
4450,owenJiao,1,0.00061,143371,87.92261,163065
4451,oyelekci,1,0.00061,143372,87.92322,163065
4452,ozthemagician,1,0.00061,143373,87.92383,163065
4453,p3tecracknell,1,0.00061,143374,87.92445,163065
4454,PabloMoneylesh,1,0.00061,143375,87.92506,163065
4455,pachisi456,1,0.00061,143376,87.92567,163065
4456,PaleHazy,1,0.00061,143377,87.92629,163065
4457,palok,1,0.00061,143378,87.92690,163065
4458,Panderium,1,0.00061,143379,87.92751,163065
4459,panva,1,0.00061,143380,87.92813,163065
4460,parrobe,1,0.00061,143381,87.92874,163065
4461,parweb,1,0.00061,143382,87.92935,163065
4462,paschm,1,0.00061,143383,87.92997,163065
4463,Pastello,1,0.00061,143384,87.93058,163065
4464,patils40,1,0.00061,143385,87.93119,163065
4465,patilvamsi,1,0.00061,143386,87.93181,163065
4466,PatrickElsingDev,1,0.00061,143387,87.93242,163065
4467,PatrickHaas,1,0.00061,143388,87.93303,163065
4468,PatrykTurczynowski,1,0.00061,143389,87.93365,163065
4469,patrykwegrzyn,1,0.00061,143390,87.93426,163065
4470,pattersongp,1,0.00061,143391,87.93487,163065
4471,PaulGgithub,1,0.00061,143392,87.93549,163065
4472,paulkilla,1,0.00061,143393,87.93610,163065
4473,paulkmoore,1,0.00061,143394,87.93671,163065
4474,paulmowat,1,0.00061,143395,87.93733,163065
4475,paultempleman,1,0.00061,143396,87.93794,163065
4476,PavelGavlik,1,0.00061,143397,87.93855,163065
4477,PavelVlha,1,0.00061,143398,87.93917,163065
4478,PawelBalcerek,1,0.00061,143399,87.93978,163065
4479,paweles,1,0.00061,143400,87.94039,163065
4480,pazkooda,1,0.00061,143401,87.94101,163065
4481,pazoozoo42,1,0.00061,143402,87.94162,163065
4482,pazrein,1,0.00061,143403,87.94223,163065
4483,pbarbashov,1,0.00061,143404,87.94284,163065
4484,pcfleischer,1,0.00061,143405,87.94346,163065
4485,pcracknell,1,0.00061,143406,87.94407,163065
4486,pdevito3,1,0.00061,143407,87.94468,163065
4487,pdomineaux,1,0.00061,143408,87.94530,163065
4488,pdt-ayidi,1,0.00061,143409,87.94591,163065
4489,pearcgc,1,0.00061,143410,87.94652,163065
4490,pedroAlba,1,0.00061,143411,87.94714,163065
4491,PedroDiasVeloso,1,0.00061,143412,87.94775,163065
4492,pedro-martins,1,0.00061,143413,87.94836,163065
4493,peermaute,1,0.00061,143414,87.94898,163065
4494,pehunka,1,0.00061,143415,87.94959,163065
4495,peps14,1,0.00061,143416,87.95020,163065
4496,PePTojr,1,0.00061,143417,87.95082,163065
4497,peschee,1,0.00061,143418,87.95143,163065
4498,petarnikolov,1,0.00061,143419,87.95204,163065
4499,peterbraden,1,0.00061,143420,87.95266,163065
4500,petermy,1,0.00061,143421,87.95327,163065
4501,PeterPopma,1,0.00061,143422,87.95388,163065
4502,PeterSveter90,1,0.00061,143423,87.95450,163065
4503,peterzandbergen,1,0.00061,143424,87.95511,163065
4504,pflaeging,1,0.00061,143425,87.95572,163065
4505,pfstrifork,1,0.00061,143426,87.95634,163065
4506,Pfuenzle,1,0.00061,143427,87.95695,163065
4507,pglavica,1,0.00061,143428,87.95756,163065
4508,pgnd,1,0.00061,143429,87.95818,163065
4509,PhilippeKayser,1,0.00061,143430,87.95879,163065
4510,PhilippHeuer,1,0.00061,143431,87.95940,163065
4511,phllpmcphrsn,1,0.00061,143432,87.96002,163065
4512,phpinheirobr,1,0.00061,143433,87.96063,163065
4513,PhungVanHoa,1,0.00061,143434,87.96124,163065
4514,piabor,1,0.00061,143435,87.96186,163065
4515,pieper,1,0.00061,143436,87.96247,163065
4516,piersony,1,0.00061,143437,87.96308,163065
4517,pikadun,1,0.00061,143438,87.96370,163065
4518,pike-msonda,1,0.00061,143439,87.96431,163065
4519,Pinguwien,1,0.00061,143440,87.96492,163065
4520,pingwin,1,0.00061,143441,87.96554,163065
4521,pinkyjpainadath,1,0.00061,143442,87.96615,163065
4522,piotrekfilip,1,0.00061,143443,87.96676,163065
4523,pixellos,1,0.00061,143444,87.96737,163065
4524,pjamroziak,1,0.00061,143445,87.96799,163065
4525,pjohndavid,1,0.00061,143446,87.96860,163065
4526,planonsoftware,1,0.00061,143447,87.96921,163065
4527,pleutres,1,0.00061,143448,87.96983,163065
4528,Plunts,1,0.00061,143449,87.97044,163065
4529,pmentz,1,0.00061,143450,87.97105,163065
4530,point67,1,0.00061,143451,87.97167,163065
4531,poklakni,1,0.00061,143452,87.97228,163065
4532,poopnimator,1,0.00061,143453,87.97289,163065
4533,pop654123,1,0.00061,143454,87.97351,163065
4534,popcornylu,1,0.00061,143455,87.97412,163065
4535,ported-pw,1,0.00061,143456,87.97473,163065
4536,potob,1,0.00061,143457,87.97535,163065
4537,powermax,1,0.00061,143458,87.97596,163065
4538,pparthenhs,1,0.00061,143459,87.97657,163065
4539,ppshinebl,1,0.00061,143460,87.97719,163065
4540,prajintst,1,0.00061,143461,87.97780,163065
4541,pranayCodes,1,0.00061,143462,87.97841,163065
4542,prashantch80,1,0.00061,143463,87.97903,163065
4543,predictap-droscoe,1,0.00061,143464,87.97964,163065
4544,pReya,1,0.00061,143465,87.98025,163065
4545,Prikalel,1,0.00061,143466,87.98087,163065
4546,prinztob,1,0.00061,143467,87.98148,163065
4547,Priska2,1,0.00061,143468,87.98209,163065
4548,priyankyshah,1,0.00061,143469,87.98271,163065
4549,probert94,1,0.00061,143470,87.98332,163065
4550,ProcopVladimirAlexandru,1,0.00061,143471,87.98393,163065
4551,profTwinglings,1,0.00061,143472,87.98455,163065
4552,prohith14,1,0.00061,143473,87.98516,163065
4553,proSingularity,1,0.00061,143474,87.98577,163065
4554,proton5000,1,0.00061,143475,87.98639,163065
4555,Prototik,1,0.00061,143476,87.98700,163065
4556,Prutheus,1,0.00061,143477,87.98761,163065
4557,przmv,1,0.00061,143478,87.98823,163065
4558,psav,1,0.00061,143479,87.98884,163065
4559,pso-aeb,1,0.00061,143480,87.98945,163065
4560,Psynbiotik,1,0.00061,143481,87.99007,163065
4561,psyreactor,1,0.00061,143482,87.99068,163065
4562,puzzlermike,1,0.00061,143483,87.99129,163065
4563,pvnmurthy,1,0.00061,143484,87.99191,163065
4564,pweatherby-ccctc,1,0.00061,143485,87.99252,163065
4565,pyryjook,1,0.00061,143486,87.99313,163065
4566,pzieminski,1,0.00061,143487,87.99374,163065
4567,q5616417,1,0.00061,143488,87.99436,163065
4568,qixiangyang,1,0.00061,143489,87.99497,163065
4569,Qlio,1,0.00061,143490,87.99558,163065
4570,qromani,1,0.00061,143491,87.99620,163065
4571,quangnguyen,1,0.00061,143492,87.99681,163065
4572,quangtm210395,1,0.00061,143493,87.99742,163065
4573,quasiben,1,0.00061,143494,87.99804,163065
4574,quetzalcoatl,1,0.00061,143495,87.99865,163065
4575,quintenbons,1,0.00061,143496,87.99926,163065
4576,quitschibo,1,0.00061,143497,87.99988,163065
4577,r00ta,1,0.00061,143498,88.00049,163065
4578,r0nin,1,0.00061,143499,88.00110,163065
4579,radonthetyrant,1,0.00061,143500,88.00172,163065
4580,raduromaniuc,1,0.00061,143501,88.00233,163065
4581,raffopiteco,1,0.00061,143502,88.00294,163065
4582,rafterhuang,1,0.00061,143503,88.00356,163065
4583,rafzei,1,0.00061,143504,88.00417,163065
4584,rahim86,1,0.00061,143505,88.00478,163065
4585,rahulshelar,1,0.00061,143506,88.00540,163065
4586,railsmechanic,1,0.00061,143507,88.00601,163065
4587,rainerfrey-inxmail,1,0.00061,143508,88.00662,163065
4588,raisty,1,0.00061,143509,88.00724,163065
4589,RajatNair,1,0.00061,143510,88.00785,163065
4590,rajatsehgal2010,1,0.00061,143511,88.00846,163065
4591,rajeshvaranasi66,1,0.00061,143512,88.00908,163065
4592,rajith77,1,0.00061,143513,88.00969,163065
4593,rajivmulajker,1,0.00061,143514,88.01030,163065
4594,raj-katonic,1,0.00061,143515,88.01092,163065
4595,RalfS4M,1,0.00061,143516,88.01153,163065
4596,raman-nbg,1,0.00061,143517,88.01214,163065
4597,raminbp,1,0.00061,143518,88.01276,163065
4598,Rangiferus,1,0.00061,143519,88.01337,163065
4599,RANSoftRA,1,0.00061,143520,88.01398,163065
4600,raphaelzoellner,1,0.00061,143521,88.01460,163065
4601,RaqieT,1,0.00061,143522,88.01521,163065
4602,rasikmhetre,1,0.00061,143523,88.01582,163065
4603,RasmusWernerLarsen,1,0.00061,143524,88.01644,163065
4604,Raufozdemir,1,0.00061,143525,88.01705,163065
4605,raulmartinezr,1,0.00061,143526,88.01766,163065
4606,ravitejapagala,1,0.00061,143527,88.01827,163065
4607,raydac,1,0.00061,143528,88.01889,163065
4608,Rayhanns04,1,0.00061,143529,88.01950,163065
4609,raystorm-place,1,0.00061,143530,88.02011,163065
4610,raz08,1,0.00061,143531,88.02073,163065
4611,razbag,1,0.00061,143532,88.02134,163065
4612,razvan-tufisi,1,0.00061,143533,88.02195,163065
4613,rblome,1,0.00061,143534,88.02257,163065
4614,rcapp,1,0.00061,143535,88.02318,163065
4615,rdelcampog,1,0.00061,143536,88.02379,163065
4616,rd-mara-hegemann,1,0.00061,143537,88.02441,163065
4617,rd-robert-avram,1,0.00061,143538,88.02502,163065
4618,reddybhavaniprasad,1,0.00061,143539,88.02563,163065
4619,reimgun,1,0.00061,143540,88.02625,163065
4620,reinisp,1,0.00061,143541,88.02686,163065
4621,rekkisomo,1,0.00061,143542,88.02747,163065
4622,remigauthierdocaposte,1,0.00061,143543,88.02809,163065
4623,remixedrewired,1,0.00061,143544,88.02870,163065
4624,remkop,1,0.00061,143545,88.02931,163065
4625,remyduthu,1,0.00061,143546,88.02993,163065
4626,remyj38,1,0.00061,143547,88.03054,163065
4627,reneploetz,1,0.00061,143548,88.03115,163065
4628,ReneZeidler,1,0.00061,143549,88.03177,163065
4629,reoring,1,0.00061,143550,88.03238,163065
4630,rep-movsd,1,0.00061,143551,88.03299,163065
4631,reppners,1,0.00061,143552,88.03361,163065
4632,rezaokhravi,1,0.00061,143553,88.03422,163065
4633,rfoster2576,1,0.00061,143554,88.03483,163065
4634,rfx77,1,0.00061,143555,88.03545,163065
4635,rg-artcom,1,0.00061,143556,88.03606,163065
4636,rgrupac,1,0.00061,143557,88.03667,163065
4637,rherlt,1,0.00061,143558,88.03729,163065
4638,Rhiod,1,0.00061,143559,88.03790,163065
4639,rhryciuk,1,0.00061,143560,88.03851,163065
4640,ricardofragacamelo,1,0.00061,143561,88.03913,163065
4641,riccardomasini,1,0.00061,143562,88.03974,163065
4642,richardfontana,1,0.00061,143563,88.04035,163065
4643,richardjkendall,1,0.00061,143564,88.04097,163065
4644,ricojansen,1,0.00061,143565,88.04158,163065
4645,rindibudiaramdhan,1,0.00061,143566,88.04219,163065
4646,rishiHPE,1,0.00061,143567,88.04281,163065
4647,rizkykojek,1,0.00061,143568,88.04342,163065
4648,rjsoph,1,0.00061,143569,88.04403,163065
4649,rLitto,1,0.00061,143570,88.04464,163065
4650,rmalenko,1,0.00061,143571,88.04526,163065
4651,rmnijgh,1,0.00061,143572,88.04587,163065
4652,RMRanasinghe,1,0.00061,143573,88.04648,163065
4653,rnetuka,1,0.00061,143574,88.04710,163065
4654,robertbakker1,1,0.00061,143575,88.04771,163065
4655,robert-franz,1,0.00061,143576,88.04832,163065
4656,robertmx,1,0.00061,143577,88.04894,163065
4657,RobertoLetica1,1,0.00061,143578,88.04955,163065
4658,robertsantiago,1,0.00061,143579,88.05016,163065
4659,RobinKnipe,1,0.00061,143580,88.05078,163065
4660,robodrome,1,0.00061,143581,88.05139,163065
4661,robsoncombr,1,0.00061,143582,88.05200,163065
4662,rogatec,1,0.00061,143583,88.05262,163065
4663,RogiervR,1,0.00061,143584,88.05323,163065
4664,roinou,1,0.00061,143585,88.05384,163065
4665,RomainMou,1,0.00061,143586,88.05446,163065
4666,roman-mueller,1,0.00061,143587,88.05507,163065
4667,romanoidprg,1,0.00061,143588,88.05568,163065
4668,rombow,1,0.00061,143589,88.05630,163065
4669,RonneGisun,1,0.00061,143590,88.05691,163065
4670,ronny-standtke,1,0.00061,143591,88.05752,163065
4671,ronycha,1,0.00061,143592,88.05814,163065
4672,RoopanV,1,0.00061,143593,88.05875,163065
4673,Roriz,1,0.00061,143594,88.05936,163065
4674,rorytorneymf,1,0.00061,143595,88.05998,163065
4675,Ross-H-Projects,1,0.00061,143596,88.06059,163065
4676,Rosslu,1,0.00061,143597,88.06120,163065
4677,RossRogers,1,0.00061,143598,88.06182,163065
4678,Rostish,1,0.00061,143599,88.06243,163065
4679,Rovanion,1,0.00061,143600,88.06304,163065
4680,roxanemace,1,0.00061,143601,88.06366,163065
4681,RRadziejewski,1,0.00061,143602,88.06427,163065
4682,rspido,1,0.00061,143603,88.06488,163065
4683,rsprice,1,0.00061,143604,88.06550,163065
4684,rsreddy1992,1,0.00061,143605,88.06611,163065
4685,rtrive,1,0.00061,143606,88.06672,163065
4686,RubenSoh,1,0.00061,143607,88.06734,163065
4687,RumRogerz,1,0.00061,143608,88.06795,163065
4688,rungwe,1,0.00061,143609,88.06856,163065
4689,rutuparna-java,1,0.00061,143610,88.06917,163065
4690,rv-ragul,1,0.00061,143611,88.06979,163065
4691,rwd5213,1,0.00061,143612,88.07040,163065
4692,rwxdash,1,0.00061,143613,88.07101,163065
4693,rx294,1,0.00061,143614,88.07163,163065
4694,rxdhlx,1,0.00061,143615,88.07224,163065
4695,ryanckoch,1,0.00061,143616,88.07285,163065
4696,ryelo,1,0.00061,143617,88.07347,163065
4697,rz-admins,1,0.00061,143618,88.07408,163065
4698,s0ck4t7,1,0.00061,143619,88.07469,163065
4699,s1341,1,0.00061,143620,88.07531,163065
4700,s7726,1,0.00061,143621,88.07592,163065
4701,sadranishilpa,1,0.00061,143622,88.07653,163065
4702,safeer2345,1,0.00061,143623,88.07715,163065
4703,sagarguptay2j,1,0.00061,143624,88.07776,163065
4704,sagarzond-synerzip,1,0.00061,143625,88.07837,163065
4705,SagenKoder,1,0.00061,143626,88.07899,163065
4706,saguntumkar,1,0.00061,143627,88.07960,163065
4707,SahanDll,1,0.00061,143628,88.08021,163065
4708,saisiva249,1,0.00061,143629,88.08083,163065
4709,SakuraAxy,1,0.00061,143630,88.08144,163065
4710,salamati-ehsan,1,0.00061,143631,88.08205,163065
4711,SameerChorge94,1,0.00061,143632,88.08267,163065
4712,SamHCoco,1,0.00061,143633,88.08328,163065
4713,sam-hieken,1,0.00061,143634,88.08389,163065
4714,samtay,1,0.00061,143635,88.08451,163065
4715,samuel-minonne,1,0.00061,143636,88.08512,163065
4716,samuelportz,1,0.00061,143637,88.08573,163065
4717,SamuelWei,1,0.00061,143638,88.08635,163065
4718,sandeepubyon,1,0.00061,143639,88.08696,163065
4719,sapo-di,1,0.00061,143640,88.08757,163065
4720,SAppleton,1,0.00061,143641,88.08819,163065
4721,sarpk,1,0.00061,143642,88.08880,163065
4722,sasiedu,1,0.00061,143643,88.08941,163065
4723,sasin-jonas,1,0.00061,143644,88.09003,163065
4724,sasori-developer,1,0.00061,143645,88.09064,163065
4725,sassko,1,0.00061,143646,88.09125,163065
4726,Saswatxp,1,0.00061,143647,88.09187,163065
4727,sattha,1,0.00061,143648,88.09248,163065
4728,savasdd,1,0.00061,143649,88.09309,163065
4729,savon-noir,1,0.00061,143650,88.09370,163065
4730,savvyjindal,1,0.00061,143651,88.09432,163065
4731,sbappoo,1,0.00061,143652,88.09493,163065
4732,sbeaupre,1,0.00061,143653,88.09554,163065
4733,sbellerkoerber,1,0.00061,143654,88.09616,163065
4734,sbenhazez,1,0.00061,143655,88.09677,163065
4735,sberthier,1,0.00061,143656,88.09738,163065
4736,sbruhse,1,0.00061,143657,88.09800,163065
4737,sbystrov,1,0.00061,143658,88.09861,163065
4738,scabarrus,1,0.00061,143659,88.09922,163065
4739,schipplock,1,0.00061,143660,88.09984,163065
4740,schmidtk,1,0.00061,143661,88.10045,163065
4741,SchneiderMK,1,0.00061,143662,88.10106,163065
4742,schnieders,1,0.00061,143663,88.10168,163065
4743,schosven,1,0.00061,143664,88.10229,163065
4744,SchuhMichael,1,0.00061,143665,88.10290,163065
4745,scila1996,1,0.00061,143666,88.10352,163065
4746,scizeron,1,0.00061,143667,88.10413,163065
4747,scoopex,1,0.00061,143668,88.10474,163065
4748,scottkarnold,1,0.00061,143669,88.10536,163065
4749,Scrumplex,1,0.00061,143670,88.10597,163065
4750,sculeb,1,0.00061,143671,88.10658,163065
4751,Scy147,1,0.00061,143672,88.10720,163065
4752,sdenovan,1,0.00061,143673,88.10781,163065
4753,sdkn74,1,0.00061,143674,88.10842,163065
4754,sebaspf,1,0.00061,143675,88.10904,163065
4755,sebastian-czech,1,0.00061,143676,88.10965,163065
4756,sebastianopilla,1,0.00061,143677,88.11026,163065
4757,SebastianSchroeder,1,0.00061,143678,88.11088,163065
4758,Sebastian-Wilhelm,1,0.00061,143679,88.11149,163065
4759,sebastienmoreno,1,0.00061,143680,88.11210,163065
4760,sebastienroul,1,0.00061,143681,88.11272,163065
4761,sebcam,1,0.00061,143682,88.11333,163065
4762,sebidude,1,0.00061,143683,88.11394,163065
4763,sec-solfa,1,0.00061,143684,88.11456,163065
4764,securemationCode,1,0.00061,143685,88.11517,163065
4765,segersb,1,0.00061,143686,88.11578,163065
4766,seiyria,1,0.00061,143687,88.11640,163065
4767,Selion05,1,0.00061,143688,88.11701,163065
4768,SemereTsehaye,1,0.00061,143689,88.11762,163065
4769,sennew,1,0.00061,143690,88.11824,163065
4770,senwangrockets,1,0.00061,143691,88.11885,163065
4771,Seppdo,1,0.00061,143692,88.11946,163065
4772,serg1236,1,0.00061,143693,88.12007,163065
4773,SergioCruzA,1,0.00061,143694,88.12069,163065
4774,serhatko,1,0.00061,143695,88.12130,163065
4775,seriouszyx,1,0.00061,143696,88.12191,163065
4776,serkanozturkpmp,1,0.00061,143697,88.12253,163065
4777,seseso,1,0.00061,143698,88.12314,163065
4778,severgun,1,0.00061,143699,88.12375,163065
4779,sexygeoff,1,0.00061,143700,88.12437,163065
4780,sfragis,1,0.00061,143701,88.12498,163065
4781,sgdc3,1,0.00061,143702,88.12559,163065
4782,SHABZ1994,1,0.00061,143703,88.12621,163065
4783,shahlokesh02,1,0.00061,143704,88.12682,163065
4784,shailsirohi,1,0.00061,143705,88.12743,163065
4785,ShanaSkydancer,1,0.00061,143706,88.12805,163065
4786,sharebear,1,0.00061,143707,88.12866,163065
4787,sharedprophet,1,0.00061,143708,88.12927,163065
4788,sharifyy,1,0.00061,143709,88.12989,163065
4789,sharonchansy,1,0.00061,143710,88.13050,163065
4790,shashank-khede,1,0.00061,143711,88.13111,163065
4791,Shashirokz,1,0.00061,143712,88.13173,163065
4792,shawnritchie,1,0.00061,143713,88.13234,163065
4793,Shawydu,1,0.00061,143714,88.13295,163065
4794,Sheeren-Caw,1,0.00061,143715,88.13357,163065
4795,shekhargulati,1,0.00061,143716,88.13418,163065
4796,ShellyXueHan,1,0.00061,143717,88.13479,163065
4797,shibacomputer,1,0.00061,143718,88.13541,163065
4798,Shikha10Nagar,1,0.00061,143719,88.13602,163065
4799,shinny-hongyan,1,0.00061,143720,88.13663,163065
4800,Shishir53,1,0.00061,143721,88.13725,163065
4801,ShivaMedishetty,1,0.00061,143722,88.13786,163065
4802,shivamtiwari18,1,0.00061,143723,88.13847,163065
4803,shivan,1,0.00061,143724,88.13909,163065
4804,ShixiangWang,1,0.00061,143725,88.13970,163065
4805,shkiltos,1,0.00061,143726,88.14031,163065
4806,Shoptaki,1,0.00061,143727,88.14093,163065
4807,shyamashish,1,0.00061,143728,88.14154,163065
4808,siarhei-skavarodkin,1,0.00061,143729,88.14215,163065
4809,Siddhesh-Ghadi,1,0.00061,143730,88.14277,163065
4810,sighanse,1,0.00061,143731,88.14338,163065
4811,siilike,1,0.00061,143732,88.14399,163065
4812,SillyButt,1,0.00061,143733,88.14460,163065
4813,SimonMARTIN87,1,0.00061,143734,88.14522,163065
4814,simonneaves,1,0.00061,143735,88.14583,163065
4815,Simsteve7,1,0.00061,143736,88.14644,163065
4816,Singh1Harjot,1,0.00061,143737,88.14706,163065
4817,Sirivasv,1,0.00061,143738,88.14767,163065
4818,siropkin,1,0.00061,143739,88.14828,163065
4819,sirux88,1,0.00061,143740,88.14890,163065
4820,SISheogorath,1,0.00061,143741,88.14951,163065
4821,sj,1,0.00061,143742,88.15012,163065
4822,Sk3pper,1,0.00061,143743,88.15074,163065
4823,sk8ter,1,0.00061,143744,88.15135,163065
4824,skershaw,1,0.00061,143745,88.15196,163065
4825,skinkie,1,0.00061,143746,88.15258,163065
4826,SKO85,1,0.00061,143747,88.15319,163065
4827,skreim,1,0.00061,143748,88.15380,163065
4828,Skyllarr,1,0.00061,143749,88.15442,163065
4829,slacksach,1,0.00061,143750,88.15503,163065
4830,SLee9211,1,0.00061,143751,88.15564,163065
4831,sls89,1,0.00061,143752,88.15626,163065
4832,sltanhs,1,0.00061,143753,88.15687,163065
4833,smallgod,1,0.00061,143754,88.15748,163065
4834,smhjamali,1,0.00061,143755,88.15810,163065
4835,smorales,1,0.00061,143756,88.15871,163065
4836,smotron,1,0.00061,143757,88.15932,163065
4837,sndmn,1,0.00061,143758,88.15994,163065
4838,SnehaMore20,1,0.00061,143759,88.16055,163065
4839,SnejKire,1,0.00061,143760,88.16116,163065
4840,sniffingsugar,1,0.00061,143761,88.16178,163065
4841,snowping,1,0.00061,143762,88.16239,163065
4842,SoccerBoyMalloy,1,0.00061,143763,88.16300,163065
4843,sokil,1,0.00061,143764,88.16362,163065
4844,sombralibre,1,0.00061,143765,88.16423,163065
4845,soorajjis,1,0.00061,143766,88.16484,163065
4846,sophievdf,1,0.00061,143767,88.16546,163065
4847,sopilol,1,0.00061,143768,88.16607,163065
4848,sorin-dragomir,1,0.00061,143769,88.16668,163065
4849,SoylentBob,1,0.00061,143770,88.16730,163065
4850,spaletta,1,0.00061,143771,88.16791,163065
4851,splimter,1,0.00061,143772,88.16852,163065
4852,springroll12,1,0.00061,143773,88.16914,163065
4853,squalou,1,0.00061,143774,88.16975,163065
4854,squaricdot,1,0.00061,143775,88.17036,163065
4855,sreevidyaJ,1,0.00061,143776,88.17097,163065
4856,sriharsha-bhasuru,1,0.00061,143777,88.17159,163065
4857,srowatt,1,0.00061,143778,88.17220,163065
4858,ss123581321,1,0.00061,143779,88.17281,163065
4859,ssmtlbn,1,0.00061,143780,88.17343,163065
4860,stakx,1,0.00061,143781,88.17404,163065
4861,stann1,1,0.00061,143782,88.17465,163065
4862,statik,1,0.00061,143783,88.17527,163065
4863,Stefan774,1,0.00061,143784,88.17588,163065
4864,stefankleff,1,0.00061,143785,88.17649,163065
4865,steffakasid,1,0.00061,143786,88.17711,163065
4866,stefvdwel,1,0.00061,143787,88.17772,163065
4867,stephanepiel,1,0.00061,143788,88.17833,163065
4868,StephGit,1,0.00061,143789,88.17895,163065
4869,StephyCat,1,0.00061,143790,88.17956,163065
4870,sternenseemann,1,0.00061,143791,88.18017,163065
4871,Steve2955,1,0.00061,143792,88.18079,163065
4872,steven-ooi,1,0.00061,143793,88.18140,163065
4873,steveytam,1,0.00061,143794,88.18201,163065
4874,stgrace,1,0.00061,143795,88.18263,163065
4875,sthenault,1,0.00061,143796,88.18324,163065
4876,stickycode,1,0.00061,143797,88.18385,163065
4877,StijnCaerts,1,0.00061,143798,88.18447,163065
4878,stockrel,1,0.00061,143799,88.18508,163065
4879,stormboy,1,0.00061,143800,88.18569,163065
4880,Strangeboylego,1,0.00061,143801,88.18631,163065
4881,StymiedSloth,1,0.00061,143802,88.18692,163065
4882,subinamathew,1,0.00061,143803,88.18753,163065
4883,suchabar,1,0.00061,143804,88.18815,163065
4884,sudkvij,1,0.00061,143805,88.18876,163065
4885,suem,1,0.00061,143806,88.18937,163065
4886,sugilite,1,0.00061,143807,88.18999,163065
4887,suhasbhairav,1,0.00061,143808,88.19060,163065
4888,sukanyamanian,1,0.00061,143809,88.19121,163065
4889,sulthan309,1,0.00061,143810,88.19183,163065
4890,sum2000,1,0.00061,143811,88.19244,163065
4891,sumanraovakt,1,0.00061,143812,88.19305,163065
4892,sumitdas66,1,0.00061,143813,88.19367,163065
4893,sunflowerno0b,1,0.00061,143814,88.19428,163065
4894,sunmeplz,1,0.00061,143815,88.19489,163065
4895,SupawishPK,1,0.00061,143816,88.19550,163065
4896,suryans1,1,0.00061,143817,88.19612,163065
4897,suyambuganesh,1,0.00061,143818,88.19673,163065
4898,svanacker,1,0.00061,143819,88.19734,163065
4899,svarlamov,1,0.00061,143820,88.19796,163065
4900,sven-borkert,1,0.00061,143821,88.19857,163065
4901,svenhartmann,1,0.00061,143822,88.19918,163065
4902,svenvogel,1,0.00061,143823,88.19980,163065
4903,sveri,1,0.00061,143824,88.20041,163065
4904,svichkar,1,0.00061,143825,88.20102,163065
4905,svkoblov,1,0.00061,143826,88.20164,163065
4906,svmn,1,0.00061,143827,88.20225,163065
4907,svzieg,1,0.00061,143828,88.20286,163065
4908,swathimocharla,1,0.00061,143829,88.20348,163065
4909,swerbun,1,0.00061,143830,88.20409,163065
4910,swhitman0,1,0.00061,143831,88.20470,163065
4911,sy6sy2,1,0.00061,143832,88.20532,163065
4912,SylarK,1,0.00061,143833,88.20593,163065
4913,SylvainAssemat,1,0.00061,143834,88.20654,163065
4914,sylvaingirardbe,1,0.00061,143835,88.20716,163065
4915,Syniex,1,0.00061,143836,88.20777,163065
4916,Syn-Tylor,1,0.00061,143837,88.20838,163065
4917,systemtrap,1,0.00061,143838,88.20900,163065
4918,szanelli-unitn,1,0.00061,143839,88.20961,163065
4919,szlachet,1,0.00061,143840,88.21022,163065
4920,Szugro2,1,0.00061,143841,88.21084,163065
4921,tahergalal,1,0.00061,143842,88.21145,163065
4922,taigi100,1,0.00061,143843,88.21206,163065
4923,talasjanos,1,0.00061,143844,88.21268,163065
4924,taliano89,1,0.00061,143845,88.21329,163065
4925,talyz,1,0.00061,143846,88.21390,163065
4926,taminomara,1,0.00061,143847,88.21452,163065
4927,tarek-fourati,1,0.00061,143848,88.21513,163065
4928,tarektaamali,1,0.00061,143849,88.21574,163065
4929,tatavmargaryan,1,0.00061,143850,88.21636,163065
4930,Tav0,1,0.00061,143851,88.21697,163065
4931,Tavark,1,0.00061,143852,88.21758,163065
4932,tbaro,1,0.00061,143853,88.21820,163065
4933,tblakers,1,0.00061,143854,88.21881,163065
4934,tbocinec,1,0.00061,143855,88.21942,163065
4935,TDesjardins,1,0.00061,143856,88.22003,163065
4936,tdoor,1,0.00061,143857,88.22065,163065
4937,TeixeiraNelson,1,0.00061,143858,88.22126,163065
4938,TejashreeD,1,0.00061,143859,88.22187,163065
4939,tejl,1,0.00061,143860,88.22249,163065
4940,telion2,1,0.00061,143861,88.22310,163065
4941,templed,1,0.00061,143862,88.22371,163065
4942,tendaim,1,0.00061,143863,88.22433,163065
4943,tepene,1,0.00061,143864,88.22494,163065
4944,TGITS,1,0.00061,143865,88.22555,163065
4945,thaDude,1,0.00061,143866,88.22617,163065
4946,thaherplank,1,0.00061,143867,88.22678,163065
4947,tharukan,1,0.00061,143868,88.22739,163065
4948,thatsadeveloper,1,0.00061,143869,88.22801,163065
4949,thedmi,1,0.00061,143870,88.22862,163065
4950,thehairy,1,0.00061,143871,88.22923,163065
4951,Theoderich,1,0.00061,143872,88.22985,163065
4952,TheParanoik,1,0.00061,143873,88.23046,163065
4953,thePier,1,0.00061,143874,88.23107,163065
4954,thetilliwilli,1,0.00061,143875,88.23169,163065
4955,theucke,1,0.00061,143876,88.23230,163065
4956,thezanke,1,0.00061,143877,88.23291,163065
4957,thmo,1,0.00061,143878,88.23353,163065
4958,ThomasAunvik,1,0.00061,143879,88.23414,163065
4959,thomas-jakemeyn,1,0.00061,143880,88.23475,163065
4960,thomasvargiu,1,0.00061,143881,88.23537,163065
4961,Thorndike,1,0.00061,143882,88.23598,163065
4962,ThorstenKunz,1,0.00061,143883,88.23659,163065
4963,thpham,1,0.00061,143884,88.23721,163065
4964,thradec,1,0.00061,143885,88.23782,163065
4965,Threnklyn,1,0.00061,143886,88.23843,163065
4966,tiagosimao,1,0.00061,143887,88.23905,163065
4967,tigermarques,1,0.00061,143888,88.23966,163065
4968,Tillaert,1,0.00061,143889,88.24027,163065
4969,timas,1,0.00061,143890,88.24089,163065
4970,timcouchoud,1,0.00061,143891,88.24150,163065
4971,TimmiORG,1,0.00061,143892,88.24211,163065
4972,timoschlueter,1,0.00061,143893,88.24273,163065
4973,timzaak,1,0.00061,143894,88.24334,163065
4974,tirth1,1,0.00061,143895,88.24395,163065
4975,TitanRob16,1,0.00061,143896,88.24457,163065
4976,titix29,1,0.00061,143897,88.24518,163065
4977,tjay31,1,0.00061,143898,88.24579,163065
4978,tlzskk,1,0.00061,143899,88.24640,163065
4979,toannh0104,1,0.00061,143900,88.24702,163065
4980,toarm,1,0.00061,143901,88.24763,163065
4981,tob123,1,0.00061,143902,88.24824,163065
4982,to-bee,1,0.00061,143903,88.24886,163065
4983,tobiashaefner,1,0.00061,143904,88.24947,163065
4984,TobiasMende,1,0.00061,143905,88.25008,163065
4985,tobias-trame,1,0.00061,143906,88.25070,163065
4986,tobimuell,1,0.00061,143907,88.25131,163065
4987,toby78,1,0.00061,143908,88.25192,163065
4988,toddbernhard,1,0.00061,143909,88.25254,163065
4989,tolgaulas,1,0.00061,143910,88.25315,163065
4990,TomasNiDo,1,0.00061,143911,88.25376,163065
4991,tomcz7,1,0.00061,143912,88.25438,163065
4992,tomrutsaert,1,0.00061,143913,88.25499,163065
4993,tomsontom,1,0.00061,143914,88.25560,163065
4994,toniharju,1,0.00061,143915,88.25622,163065
4995,tonygeorgiev,1,0.00061,143916,88.25683,163065
4996,tonymarsh,1,0.00061,143917,88.25744,163065
4997,torsteis,1,0.00061,143918,88.25806,163065
4998,torsten-liermann,1,0.00061,143919,88.25867,163065
4999,ToshY,1,0.00061,143920,88.25928,163065
5000,toziol,1,0.00061,143921,88.25990,163065
5001,trajakovic,1,0.00061,143922,88.26051,163065
5002,tremaze,1,0.00061,143923,88.26112,163065
5003,tricky10,1,0.00061,143924,88.26174,163065
5004,TrippyHank,1,0.00061,143925,88.26235,163065
5005,tristan-vineti,1,0.00061,143926,88.26296,163065
5006,tronicum,1,0.00061,143927,88.26358,163065
5007,trotman23,1,0.00061,143928,88.26419,163065
5008,trusanen-fluidit,1,0.00061,143929,88.26480,163065
5009,tschannik,1,0.00061,143930,88.26542,163065
5010,tschia,1,0.00061,143931,88.26603,163065
5011,tschlechtweg,1,0.00061,143932,88.26664,163065
5012,tschlegel,1,0.00061,143933,88.26726,163065
5013,tstaals,1,0.00061,143934,88.26787,163065
5014,ttu75,1,0.00061,143935,88.26848,163065
5015,ttupekadd,1,0.00061,143936,88.26910,163065
5016,tuliocota,1,0.00061,143937,88.26971,163065
5017,tuliofergulha,1,0.00061,143938,88.27032,163065
5018,tumbl3w33d,1,0.00061,143939,88.27093,163065
5019,tunaranch,1,0.00061,143940,88.27155,163065
5020,tunessofia,1,0.00061,143941,88.27216,163065
5021,turlarion,1,0.00061,143942,88.27277,163065
5022,tuxcrafter,1,0.00061,143943,88.27339,163065
5023,tvelingkar,1,0.00061,143944,88.27400,163065
5024,T-VN,1,0.00061,143945,88.27461,163065
5025,twgraham,1,0.00061,143946,88.27523,163065
5026,tylervz,1,0.00061,143947,88.27584,163065
5027,tzuge,1,0.00061,143948,88.27645,163065
5028,UberJohn,1,0.00061,143949,88.27707,163065
5029,ujwalparker,1,0.00061,143950,88.27768,163065
5030,ullgren,1,0.00061,143951,88.27829,163065
5031,umbrellait-timur-khismatullin,1,0.00061,143952,88.27891,163065
5032,Und3rMySk1n,1,0.00061,143953,88.27952,163065
5033,unetone,1,0.00061,143954,88.28013,163065
5034,unreal-altran,1,0.00061,143955,88.28075,163065
5035,unteem,1,0.00061,143956,88.28136,163065
5036,urferr,1,0.00061,143957,88.28197,163065
5037,user1537,1,0.00061,143958,88.28259,163065
5038,usersina,1,0.00061,143959,88.28320,163065
5039,uubk,1,0.00061,143960,88.28381,163065
5040,vaccarov,1,0.00061,143961,88.28443,163065
5041,vanakema,1,0.00061,143962,88.28504,163065
5042,vanduc1102,1,0.00061,143963,88.28565,163065
5043,vanhoanHoang,1,0.00061,143964,88.28627,163065
5044,varijkapil13,1,0.00061,143965,88.28688,163065
5045,varjoinen,1,0.00061,143966,88.28749,163065
5046,vasnakos,1,0.00061,143967,88.28811,163065
5047,vazul,1,0.00061,143968,88.28872,163065
5048,vbiginner,1,0.00061,143969,88.28933,163065
5049,vc43,1,0.00061,143970,88.28995,163065
5050,VDap,1,0.00061,143971,88.29056,163065
5051,vdeygas,1,0.00061,143972,88.29117,163065
5052,vect-rlaplaud,1,0.00061,143973,88.29179,163065
5053,VeeTheVee,1,0.00061,143974,88.29240,163065
5054,venkyhodigere,1,0.00061,143975,88.29301,163065
5055,vennekilde,1,0.00061,143976,88.29363,163065
5056,verifidev,1,0.00061,143977,88.29424,163065
5057,verzada,1,0.00061,143978,88.29485,163065
5058,vfiebig,1,0.00061,143979,88.29546,163065
5059,VGerris,1,0.00061,143980,88.29608,163065
5060,vichak,1,0.00061,143981,88.29669,163065
5061,victorabclagerfors,1,0.00061,143982,88.29730,163065
5062,victoriouswarrior,1,0.00061,143983,88.29792,163065
5063,victorlopezsalazar,1,0.00061,143984,88.29853,163065
5064,victropolis,1,0.00061,143985,88.29914,163065
5065,viglu,1,0.00061,143986,88.29976,163065
5066,Vigneshsekar,1,0.00061,143987,88.30037,163065
5067,vijay94,1,0.00061,143988,88.30098,163065
5068,vijaykumarv7,1,0.00061,143989,88.30160,163065
5069,vikramadeshpande,1,0.00061,143990,88.30221,163065
5070,viliampucik,1,0.00061,143991,88.30282,163065
5071,vincejv,1,0.00061,143992,88.30344,163065
5072,vincentbarat,1,0.00061,143993,88.30405,163065
5073,vincentpalita-whoz,1,0.00061,143994,88.30466,163065
5074,Vineeth-Kotichukkala,1,0.00061,143995,88.30528,163065
5075,vippalanikhil,1,0.00061,143996,88.30589,163065
5076,vishgyana,1,0.00061,143997,88.30650,163065
5077,Vishvak31,1,0.00061,143998,88.30712,163065
5078,vitorcastrozup,1,0.00061,143999,88.30773,163065
5079,vkalachevskyi,1,0.00061,144000,88.30834,163065
5080,vksaamy,1,0.00061,144001,88.30896,163065
5081,vmichailidisdev,1,0.00061,144002,88.30957,163065
5082,vmichelin-cpage,1,0.00061,144003,88.31018,163065
5083,vnea,1,0.00061,144004,88.31080,163065
5084,volym3ad,1,0.00061,144005,88.31141,163065
5085,Vrael,1,0.00061,144006,88.31202,163065
5086,vrindanayak,1,0.00061,144007,88.31264,163065
5087,vschs007,1,0.00061,144008,88.31325,163065
5088,vsomasvr,1,0.00061,144009,88.31386,163065
5089,vukomir,1,0.00061,144010,88.31448,163065
5090,vvarga007,1,0.00061,144011,88.31509,163065
5091,vvp1983,1,0.00061,144012,88.31570,163065
5092,w1rth,1,0.00061,144013,88.31632,163065
5093,w4tsn,1,0.00061,144014,88.31693,163065
5094,waglik,1,0.00061,144015,88.31754,163065
5095,waigel,1,0.00061,144016,88.31816,163065
5096,wan-gan,1,0.00061,144017,88.31877,163065
5097,wansors,1,0.00061,144018,88.31938,163065
5098,Wapax,1,0.00061,144019,88.32000,163065
5099,wasdi-sysadmin-br,1,0.00061,144020,88.32061,163065
5100,wattariBat,1,0.00061,144021,88.32122,163065
5101,waweber,1,0.00061,144022,88.32183,163065
5102,waza-ari,1,0.00061,144023,88.32245,163065
5103,wbauern,1,0.00061,144024,88.32306,163065
5104,webfrank,1,0.00061,144025,88.32367,163065
5105,webkim,1,0.00061,144026,88.32429,163065
5106,WeCodingNow,1,0.00061,144027,88.32490,163065
5107,werkon,1,0.00061,144028,88.32551,163065
5108,WernerScholtz,1,0.00061,144029,88.32613,163065
5109,Westie,1,0.00061,144030,88.32674,163065
5110,Wetwer,1,0.00061,144031,88.32735,163065
5111,Whalen24,1,0.00061,144032,88.32797,163065
5112,whitepiratebaku,1,0.00061,144033,88.32858,163065
5113,wikey,1,0.00061,144034,88.32919,163065
5114,willbenica,1,0.00061,144035,88.32981,163065
5115,williancolognesitrimble,1,0.00061,144036,88.33042,163065
5116,willisjtc,1,0.00061,144037,88.33103,163065
5117,WillNilges,1,0.00061,144038,88.33165,163065
5118,wiltomdus,1,0.00061,144039,88.33226,163065
5119,wincognito,1,0.00061,144040,88.33287,163065
5120,winterrobert,1,0.00061,144041,88.33349,163065
5121,wirk,1,0.00061,144042,88.33410,163065
5122,wirmler,1,0.00061,144043,88.33471,163065
5123,wisec,1,0.00061,144044,88.33533,163065
5124,wkrtouk,1,0.00061,144045,88.33594,163065
5125,wmira,1,0.00061,144046,88.33655,163065
5126,wnameless,1,0.00061,144047,88.33717,163065
5127,wnhrt,1,0.00061,144048,88.33778,163065
5128,wojtekkul,1,0.00061,144049,88.33839,163065
5129,wongkwl,1,0.00061,144050,88.33901,163065
5130,woutermont,1,0.00061,144051,88.33962,163065
5131,wrinkle81,1,0.00061,144052,88.34023,163065
5132,wspurgin,1,0.00061,144053,88.34085,163065
5133,wtell400,1,0.00061,144054,88.34146,163065
5134,Wuelle,1,0.00061,144055,88.34207,163065
5135,wuyuyan,1,0.00061,144056,88.34269,163065
5136,wwebers,1,0.00061,144057,88.34330,163065
5137,wzslw,1,0.00061,144058,88.34391,163065
5138,xalopp,1,0.00061,144059,88.34453,163065
5139,xdenser,1,0.00061,144060,88.34514,163065
5140,XiangRongLin,1,0.00061,144061,88.34575,163065
5141,xor222xor,1,0.00061,144062,88.34636,163065
5142,xpie,1,0.00061,144063,88.34698,163065
5143,xsmart,1,0.00061,144064,88.34759,163065
5144,xtreme-uz,1,0.00061,144065,88.34820,163065
5145,xuing,1,0.00061,144066,88.34882,163065
5146,xumoooo,1,0.00061,144067,88.34943,163065
5147,yakyouk,1,0.00061,144068,88.35004,163065
5148,Yallan,1,0.00061,144069,88.35066,163065
5149,yangboyd,1,0.00061,144070,88.35127,163065
5150,yangle94,1,0.00061,144071,88.35188,163065
5151,yash-aroraa,1,0.00061,144072,88.35250,163065
5152,yashkumaratri,1,0.00061,144073,88.35311,163065
5153,yav124,1,0.00061,144074,88.35372,163065
5154,yeroc,1,0.00061,144075,88.35434,163065
5155,yildiliu,1,0.00061,144076,88.35495,163065
5156,yingzili-de,1,0.00061,144077,88.35556,163065
5157,ynfle,1,0.00061,144078,88.35618,163065
5158,yogesh-pal,1,0.00061,144079,88.35679,163065
5159,Yolonaise,1,0.00061,144080,88.35740,163065
5160,yossir-dp,1,0.00061,144081,88.35802,163065
5161,yousefshaher,1,0.00061,144082,88.35863,163065
5162,ytrinh,1,0.00061,144083,88.35924,163065
5163,yuan-kuan,1,0.00061,144084,88.35986,163065
5164,YuGongYu,1,0.00061,144085,88.36047,163065
5165,yuichi-nakamura,1,0.00061,144086,88.36108,163065
5166,Yuiie,1,0.00061,144087,88.36170,163065
5167,yukha-dw,1,0.00061,144088,88.36231,163065
5168,yuliia-tinana,1,0.00061,144089,88.36292,163065
5169,yuling3086,1,0.00061,144090,88.36354,163065
5170,Yu-Qi,1,0.00061,144091,88.36415,163065
5171,yurikn1,1,0.00061,144092,88.36476,163065
5172,yurissouza,1,0.00061,144093,88.36538,163065
5173,yushaojian,1,0.00061,144094,88.36599,163065
5174,yzarca,1,0.00061,144095,88.36660,163065
5175,z3ky,1,0.00061,144096,88.36722,163065
5176,zachmann,1,0.00061,144097,88.36783,163065
5177,zachradtka,1,0.00061,144098,88.36844,163065
5178,zainulabideen87,1,0.00061,144099,88.36906,163065
5179,zakarth,1,0.00061,144100,88.36967,163065
5180,ZA-NVG,1,0.00061,144101,88.37028,163065
5181,zavndw,1,0.00061,144102,88.37090,163065
5182,zaycker,1,0.00061,144103,88.37151,163065
5183,zcc39r,1,0.00061,144104,88.37212,163065
5184,zcw888,1,0.00061,144105,88.37273,163065
5185,zechmeister,1,0.00061,144106,88.37335,163065
5186,zemadz,1,0.00061,144107,88.37396,163065
5187,zeniel,1,0.00061,144108,88.37457,163065
5188,zeynepuyyanik,1,0.00061,144109,88.37519,163065
5189,zgldh,1,0.00061,144110,88.37580,163065
5190,ZhangqyTJ,1,0.00061,144111,88.37641,163065
5191,Zhark10,1,0.00061,144112,88.37703,163065
5192,zhengyang1988,1,0.00061,144113,88.37764,163065
5193,zima91,1,0.00061,144114,88.37825,163065
5194,Zipunrar,1,0.00061,144115,88.37887,163065
5195,zjesse713,1,0.00061,144116,88.37948,163065
5196,Zocker1999NET,1,0.00061,144117,88.38009,163065
5197,zotornit,1,0.00061,144118,88.38071,163065
5198,zozor,1,0.00061,144119,88.38132,163065
5199,ZPascal,1,0.00061,144120,88.38193,163065
5200,Zwordi,1,0.00061,144121,88.38255,163065
