rank_number,actor,contributions,percent,cumulative_sum,cumulative_percent,all_contributions
1,autrilla,1890,25.68982,1890,25.68982,7357
2,jvehent,1129,15.34593,3019,41.03575,7357
3,felixfontein,191,2.59617,3210,43.63192,7357
4,twolfson,80,1.08740,3290,44.71931,7357
5,ikedam,67,0.91070,3357,45.63001,7357
6,rouge8,45,0.61166,3402,46.24167,7357
7,Mic92,39,0.53011,3441,46.77178,7357
8,relud,35,0.47574,3476,47.24752,7357
9,Kamahl19,27,0.36700,3503,47.61452,7357
10,mmorev,25,0.33981,3528,47.95433,7357
11,ametaireau,23,0.31263,3551,48.26696,7357
12,endorama,23,0.31263,3574,48.57958,7357
13,milescrabill,23,0.31263,3597,48.89221,7357
14,bhourigan,22,0.29903,3619,49.19125,7357
15,adrianosela,19,0.25826,3638,49.44950,7357
16,scjudd,19,0.25826,3657,49.70776,7357
17,cameronkerrnz,18,0.24466,3675,49.95243,7357
18,dovreshef,17,0.23107,3692,50.18350,7357
19,FnTm,17,0.23107,3709,50.41457,7357
20,paulolieuthier,17,0.23107,3726,50.64564,7357
21,akunaatrium,15,0.20389,3741,50.84953,7357
22,ancat,15,0.20389,3756,51.05342,7357
23,ckolos,14,0.19029,3770,51.24371,7357
24,Natim,14,0.19029,3784,51.43401,7357
25,NeilMadden,14,0.19029,3798,51.62430,7357
26,abeluck,13,0.17670,3811,51.80101,7357
27,deed02392,13,0.17670,3824,51.97771,7357
28,hwine,13,0.17670,3837,52.15441,7357
29,jpsrn,13,0.17670,3850,52.33111,7357
30,lvh,12,0.16311,3862,52.49422,7357
31,mrgleeco,12,0.16311,3874,52.65733,7357
32,BorisKourt,11,0.14952,3885,52.80685,7357
33,devinburnette,11,0.14952,3896,52.95637,7357
34,Enrico204,10,0.13592,3906,53.09229,7357
35,lbonanomi,10,0.13592,3916,53.22822,7357
36,ryan-dyer-sp,10,0.13592,3926,53.36414,7357
37,ChristianWeissCG,9,0.12233,3935,53.48648,7357
38,adrian-gierakowski,8,0.10874,3943,53.59522,7357
39,budimanjojo,8,0.10874,3951,53.70396,7357
40,chroto,8,0.10874,3959,53.81270,7357
41,dudicoco,8,0.10874,3967,53.92144,7357
42,enote-kane,8,0.10874,3975,54.03018,7357
43,iensu,8,0.10874,3983,54.13892,7357
44,jar-o,8,0.10874,3991,54.24766,7357
45,Jdban,8,0.10874,3999,54.35640,7357
46,joe-getcouragenow,8,0.10874,4007,54.46514,7357
47,joshkaplinsky,8,0.10874,4015,54.57388,7357
48,ldue,8,0.10874,4023,54.68262,7357
49,mulder999,8,0.10874,4031,54.79136,7357
50,uwehdaub,8,0.10874,4039,54.90010,7357
51,vnzongzna,8,0.10874,4047,55.00884,7357
52,ajdergute,7,0.09515,4054,55.10398,7357
53,bcolucci,7,0.09515,4061,55.19913,7357
54,brad-jones,7,0.09515,4068,55.29428,7357
55,enchorb,7,0.09515,4075,55.38943,7357
56,kouk,7,0.09515,4082,55.48457,7357
57,ricje,7,0.09515,4089,55.57972,7357
58,RishabhBhatnagar,7,0.09515,4096,55.67487,7357
59,SohamChakraborty,7,0.09515,4103,55.77001,7357
60,Vampouille,7,0.09515,4110,55.86516,7357
61,AntoineRondelet,6,0.08155,4116,55.94672,7357
62,azhi,6,0.08155,4122,56.02827,7357
63,blancharda,6,0.08155,4128,56.10983,7357
64,choffmeister,6,0.08155,4134,56.19138,7357
65,Dimmy-Yang,6,0.08155,4140,56.27294,7357
66,eddiewebb,6,0.08155,4146,56.35449,7357
67,heydonovan,6,0.08155,4152,56.43605,7357
68,imskr,6,0.08155,4158,56.51760,7357
69,inverse,6,0.08155,4164,56.59916,7357
70,jbuck,6,0.08155,4170,56.68071,7357
71,jc00ke,6,0.08155,4176,56.76227,7357
72,jpriebe,6,0.08155,4182,56.84382,7357
73,kentso,6,0.08155,4188,56.92538,7357
74,leitu,6,0.08155,4194,57.00693,7357
75,nilium,6,0.08155,4200,57.08849,7357
76,oldpatricka,6,0.08155,4206,57.17004,7357
77,rpappalax,6,0.08155,4212,57.25160,7357
78,SinisterMinister,6,0.08155,4218,57.33315,7357
79,uumo,6,0.08155,4224,57.41471,7357
80,Varriount,6,0.08155,4230,57.49626,7357
81,AdamekAdam,5,0.06796,4235,57.56422,7357
82,binlab,5,0.06796,4240,57.63219,7357
83,bprager,5,0.06796,4245,57.70015,7357
84,commandline,5,0.06796,4250,57.76811,7357
85,conorsch,5,0.06796,4255,57.83607,7357
86,cousine,5,0.06796,4260,57.90404,7357
87,FiloSottile,5,0.06796,4265,57.97200,7357
88,goodspark,5,0.06796,4270,58.03996,7357
89,hoangelos,5,0.06796,4275,58.10792,7357
90,huang12zheng,5,0.06796,4280,58.17589,7357
91,itwasntandy,5,0.06796,4285,58.24385,7357
92,jpluscplusm,5,0.06796,4290,58.31181,7357
93,LandazuriPaul,5,0.06796,4295,58.37977,7357
94,lukeab,5,0.06796,4300,58.44774,7357
95,olevchyk,5,0.06796,4305,58.51570,7357
96,oskarkook,5,0.06796,4310,58.58366,7357
97,p0bailey,5,0.06796,4315,58.65162,7357
98,philipcristiano,5,0.06796,4320,58.71959,7357
99,Sebor,5,0.06796,4325,58.78755,7357
100,sergey-shambir,5,0.06796,4330,58.85551,7357
101,SirishaGopigiri,5,0.06796,4335,58.92347,7357
102,skuethe,5,0.06796,4340,58.99144,7357
103,speculatrix,5,0.06796,4345,59.05940,7357
104,stefanthorpe,5,0.06796,4350,59.12736,7357
105,stoyle,5,0.06796,4355,59.19532,7357
106,tuukkamustonen,5,0.06796,4360,59.26329,7357
107,zmitry,5,0.06796,4365,59.33125,7357
108,0xflotus,4,0.05437,4369,59.38562,7357
109,atifrasheed79,4,0.05437,4373,59.43999,7357
110,BenoitKnecht,4,0.05437,4377,59.49436,7357
111,bkreitch,4,0.05437,4381,59.54873,7357
112,calebTree,4,0.05437,4385,59.60310,7357
113,dcreado,4,0.05437,4389,59.65747,7357
114,deniojunior-hotmart,4,0.05437,4393,59.71184,7357
115,dgsardina,4,0.05437,4397,59.76621,7357
116,dooferlad,4,0.05437,4401,59.82058,7357
117,EricTendian,4,0.05437,4405,59.87495,7357
118,feniix,4,0.05437,4409,59.92932,7357
119,g-k,4,0.05437,4413,59.98369,7357
120,gleeco,4,0.05437,4417,60.03806,7357
121,haizaar,4,0.05437,4421,60.09243,7357
122,hurzelpurzel,4,0.05437,4425,60.14680,7357
123,kavita1205,4,0.05437,4429,60.20117,7357
124,ljani,4,0.05437,4433,60.25554,7357
125,mccutchen,4,0.05437,4437,60.30991,7357
126,naadev,4,0.05437,4441,60.36428,7357
127,ncjones,4,0.05437,4445,60.41865,7357
128,ninacfgarcia,4,0.05437,4449,60.47302,7357
129,Perdjesk,4,0.05437,4453,60.52739,7357
130,PyvesB,4,0.05437,4457,60.58176,7357
131,schlomo,4,0.05437,4461,60.63613,7357
132,ScottPierce,4,0.05437,4465,60.69050,7357
133,Scrumplex,4,0.05437,4469,60.74487,7357
134,sfrevel,4,0.05437,4473,60.79924,7357
135,steffakasid,4,0.05437,4477,60.85361,7357
136,sw360cab,4,0.05437,4481,60.90798,7357
137,tigertoes,4,0.05437,4485,60.96235,7357
138,wcurrie,4,0.05437,4489,61.01672,7357
139,0anton,3,0.04078,4492,61.05750,7357
140,0xmohit,3,0.04078,4495,61.09827,7357
141,acastle,3,0.04078,4498,61.13905,7357
142,ajsaclayan,3,0.04078,4501,61.17983,7357
143,alexeyauslender,3,0.04078,4504,61.22061,7357
144,almereyda,3,0.04078,4507,61.26138,7357
145,Amod02-prog,3,0.04078,4510,61.30216,7357
146,awwitecki,3,0.04078,4513,61.34294,7357
147,b-dean,3,0.04078,4516,61.38372,7357
148,benjefferies,3,0.04078,4519,61.42449,7357
149,brant4test,3,0.04078,4522,61.46527,7357
150,ceroloy,3,0.04078,4525,61.50605,7357
151,chrisrink10,3,0.04078,4528,61.54683,7357
152,ckuethe,3,0.04078,4531,61.58760,7357
153,cmosetick,3,0.04078,4534,61.62838,7357
154,cpflaume,3,0.04078,4537,61.66916,7357
155,cslocum,3,0.04078,4540,61.70994,7357
156,DamianFekete,3,0.04078,4543,61.75071,7357
157,dani-santos-code,3,0.04078,4546,61.79149,7357
158,dann7387,3,0.04078,4549,61.83227,7357
159,dimrozakis,3,0.04078,4552,61.87305,7357
160,dkotik,3,0.04078,4555,61.91382,7357
161,domhdp,3,0.04078,4558,61.95460,7357
162,dpsi,3,0.04078,4561,61.99538,7357
163,dummys,3,0.04078,4564,62.03616,7357
164,Dwite,3,0.04078,4567,62.07693,7357
165,edofic,3,0.04078,4570,62.11771,7357
166,eduardoaemunoz,3,0.04078,4573,62.15849,7357
167,eswenson1,3,0.04078,4576,62.19927,7357
168,fbongiovanni29,3,0.04078,4579,62.24004,7357
169,fcosta-td,3,0.04078,4582,62.28082,7357
170,felder,3,0.04078,4585,62.32160,7357
171,fifofonix,3,0.04078,4588,62.36238,7357
172,fnpanic,3,0.04078,4591,62.40315,7357
173,Frizlab,3,0.04078,4594,62.44393,7357
174,gdestuynder,3,0.04078,4597,62.48471,7357
175,geota,3,0.04078,4600,62.52549,7357
176,gheibia,3,0.04078,4603,62.56626,7357
177,holiman,3,0.04078,4606,62.60704,7357
178,jarrettprosser,3,0.04078,4609,62.64782,7357
179,jaymefSO,3,0.04078,4612,62.68860,7357
180,jaythamke,3,0.04078,4615,62.72937,7357
181,jgournet,3,0.04078,4618,62.77015,7357
182,jjangga0214,3,0.04078,4621,62.81093,7357
183,jrhoward,3,0.04078,4624,62.85171,7357
184,jzavgok,3,0.04078,4627,62.89248,7357
185,kennyparsons,3,0.04078,4630,62.93326,7357
186,kiwicopple,3,0.04078,4633,62.97404,7357
187,kshpytsya,3,0.04078,4636,63.01482,7357
188,L7R7,3,0.04078,4639,63.05559,7357
189,liu9jian,3,0.04078,4642,63.09637,7357
190,mikonieminen,3,0.04078,4645,63.13715,7357
191,mweinelt,3,0.04078,4648,63.17793,7357
192,mxxcon,3,0.04078,4651,63.21870,7357
193,nolash,3,0.04078,4654,63.25948,7357
194,nphmuller,3,0.04078,4657,63.30026,7357
195,PastNullInfinity,3,0.04078,4660,63.34104,7357
196,paulyeti,3,0.04078,4663,63.38181,7357
197,pysysops,3,0.04078,4666,63.42259,7357
198,renannprado,3,0.04078,4669,63.46337,7357
199,rkhadder,3,0.04078,4672,63.50415,7357
200,romeomorcia-wipro,3,0.04078,4675,63.54492,7357
201,Roxyrob,3,0.04078,4678,63.58570,7357
202,sadikkuzu,3,0.04078,4681,63.62648,7357
203,salmanb,3,0.04078,4684,63.66726,7357
204,SamGallagher95,3,0.04078,4687,63.70803,7357
205,scalen,3,0.04078,4690,63.74881,7357
206,ScrumplexDTAG,3,0.04078,4693,63.78959,7357
207,shouichi,3,0.04078,4696,63.83037,7357
208,sixfeetover,3,0.04078,4699,63.87114,7357
209,skang0601,3,0.04078,4702,63.91192,7357
210,slewsys,3,0.04078,4705,63.95270,7357
211,sochotnicky,3,0.04078,4708,63.99348,7357
212,solacens,3,0.04078,4711,64.03425,7357
213,Tanemahuta,3,0.04078,4714,64.07503,7357
214,thepont,3,0.04078,4717,64.11581,7357
215,tlamr,3,0.04078,4720,64.15659,7357
216,toralf-hlag,3,0.04078,4723,64.19736,7357
217,tswanson-cs,3,0.04078,4726,64.23814,7357
218,typekpb,3,0.04078,4729,64.27892,7357
219,vaibhavk,3,0.04078,4732,64.31970,7357
220,very-doge-wow,3,0.04078,4735,64.36047,7357
221,vojtechmasa,3,0.04078,4738,64.40125,7357
222,while1malloc0,3,0.04078,4741,64.44203,7357
223,wistonk,3,0.04078,4744,64.48281,7357
224,wmedlar,3,0.04078,4747,64.52358,7357
225,wuchunhui,3,0.04078,4750,64.56436,7357
226,xformerfhs,3,0.04078,4753,64.60514,7357
227,yingzong,3,0.04078,4756,64.64592,7357
228,4x0v7,2,0.02718,4758,64.67310,7357
229,abedra,2,0.02718,4760,64.70029,7357
230,aDingil,2,0.02718,4762,64.72747,7357
231,alexanmtz,2,0.02718,4764,64.75466,7357
232,AlexCzar,2,0.02718,4766,64.78184,7357
233,ali-alsabbah,2,0.02718,4768,64.80903,7357
234,alvarogzp,2,0.02718,4770,64.83621,7357
235,amarao,2,0.02718,4772,64.86340,7357
236,ancoron,2,0.02718,4774,64.89058,7357
237,andrei-radulescu,2,0.02718,4776,64.91777,7357
238,AndreLobato,2,0.02718,4778,64.94495,7357
239,andrewtcymmer,2,0.02718,4780,64.97214,7357
240,AndydeCleyre,2,0.02718,4782,64.99932,7357
241,arainho,2,0.02718,4784,65.02651,7357
242,arauchberger,2,0.02718,4786,65.05369,7357
243,archite,2,0.02718,4788,65.08088,7357
244,artm,2,0.02718,4790,65.10806,7357
245,astreter,2,0.02718,4792,65.13525,7357
246,autocracy,2,0.02718,4794,65.16243,7357
247,better-sachin,2,0.02718,4796,65.18962,7357
248,b-meson,2,0.02718,4798,65.21680,7357
249,bmhatfield,2,0.02718,4800,65.24399,7357
250,camlow325,2,0.02718,4802,65.27117,7357
251,chas0amx,2,0.02718,4804,65.29836,7357
252,cloudstarz,2,0.02718,4806,65.32554,7357
253,cowlicks,2,0.02718,4808,65.35273,7357
254,dalibor-aleksic-atomia,2,0.02718,4810,65.37991,7357
255,danielkimuipath,2,0.02718,4812,65.40710,7357
256,deliro,2,0.02718,4814,65.43428,7357
257,drduker,2,0.02718,4816,65.46147,7357
258,DrPhil,2,0.02718,4818,65.48865,7357
259,dry4ng,2,0.02718,4820,65.51584,7357
260,dsalaza4,2,0.02718,4822,65.54302,7357
261,dsclementsen,2,0.02718,4824,65.57021,7357
262,dwillist,2,0.02718,4826,65.59739,7357
263,ede-n,2,0.02718,4828,65.62458,7357
264,EricStG,2,0.02718,4830,65.65176,7357
265,ethnt,2,0.02718,4832,65.67895,7357
266,fzyzcjy,2,0.02718,4834,65.70613,7357
267,gdhameeja,2,0.02718,4836,65.73332,7357
268,glennlawyer,2,0.02718,4838,65.76050,7357
269,heikkilamarko,2,0.02718,4840,65.78769,7357
270,itssimon,2,0.02718,4842,65.81487,7357
271,jamsi,2,0.02718,4844,65.84206,7357
272,jashandeep-sohi,2,0.02718,4846,65.86924,7357
273,JCepedaVillamayor,2,0.02718,4848,65.89643,7357
274,jeffrichiefs,2,0.02718,4850,65.92361,7357
275,jkapdev,2,0.02718,4852,65.95080,7357
276,joshdk,2,0.02718,4854,65.97798,7357
277,jsocol,2,0.02718,4856,66.00517,7357
278,KayEss,2,0.02718,4858,66.03235,7357
279,Kouzukii,2,0.02718,4860,66.05954,7357
280,kumarsiva07,2,0.02718,4862,66.08672,7357
281,kylefossum,2,0.02718,4864,66.11391,7357
282,lavrxxx,2,0.02718,4866,66.14109,7357
283,lewisdrummond1,2,0.02718,4868,66.16828,7357
284,limed,2,0.02718,4870,66.19546,7357
285,maxstreese,2,0.02718,4872,66.22265,7357
286,mazamats,2,0.02718,4874,66.24983,7357
287,mdanzinger,2,0.02718,4876,66.27702,7357
288,mefistofeel,2,0.02718,4878,66.30420,7357
289,mkatychev,2,0.02718,4880,66.33139,7357
290,mloskot,2,0.02718,4882,66.35857,7357
291,musicformellons,2,0.02718,4884,66.38576,7357
292,nateblack,2,0.02718,4886,66.41294,7357
293,overfl0,2,0.02718,4888,66.44013,7357
294,patvdleer,2,0.02718,4890,66.46731,7357
295,PaulWalther,2,0.02718,4892,66.49450,7357
296,petemoore,2,0.02718,4894,66.52168,7357
297,reduxionist,2,0.02718,4896,66.54887,7357
298,roblon,2,0.02718,4898,66.57605,7357
299,ryanhos,2,0.02718,4900,66.60324,7357
300,sahanruwanga,2,0.02718,4902,66.63042,7357
301,SahilMj,2,0.02718,4904,66.65761,7357
302,sami9gag,2,0.02718,4906,66.68479,7357
303,sciurus,2,0.02718,4908,66.71197,7357
304,Shaun-Harrison,2,0.02718,4910,66.73916,7357
305,si14,2,0.02718,4912,66.76634,7357
306,simonklb,2,0.02718,4914,66.79353,7357
307,sirantd,2,0.02718,4916,66.82071,7357
308,SISheogorath,2,0.02718,4918,66.84790,7357
309,slavniyteo,2,0.02718,4920,66.87508,7357
310,slikk66,2,0.02718,4922,66.90227,7357
311,sodul,2,0.02718,4924,66.92945,7357
312,statik,2,0.02718,4926,66.95664,7357
313,sungcheng,2,0.02718,4928,66.98382,7357
314,sushant-115,2,0.02718,4930,67.01101,7357
315,t3h2mas,2,0.02718,4932,67.03819,7357
316,tbenthompson,2,0.02718,4934,67.06538,7357
317,teaglebuilt,2,0.02718,4936,67.09256,7357
318,thatsmypasswd,2,0.02718,4938,67.11975,7357
319,Threnklyn,2,0.02718,4940,67.14693,7357
320,tjolsen-vn,2,0.02718,4942,67.17412,7357
321,tonsV2,2,0.02718,4944,67.20130,7357
322,TuhinNair,2,0.02718,4946,67.22849,7357
323,tvddhi,2,0.02718,4948,67.25567,7357
324,ultramozg,2,0.02718,4950,67.28286,7357
325,valorl,2,0.02718,4952,67.31004,7357
326,warwick-mitchell1,2,0.02718,4954,67.33723,7357
327,WillerWasTaken,2,0.02718,4956,67.36441,7357
328,wiseelf,2,0.02718,4958,67.39160,7357
329,XAMPPRocky,2,0.02718,4960,67.41878,7357
330,yakhyadabo,2,0.02718,4962,67.44597,7357
331,yz89122,2,0.02718,4964,67.47315,7357
332,ZeikuZeta,2,0.02718,4966,67.50034,7357
333,0xClpz,1,0.01359,4967,67.51393,7357
334,64bit,1,0.01359,4968,67.52752,7357
335,aberresch,1,0.01359,4969,67.54112,7357
336,abferm,1,0.01359,4970,67.55471,7357
337,abrenaut,1,0.01359,4971,67.56830,7357
338,acepsaepudin,1,0.01359,4972,67.58189,7357
339,act-mreeves,1,0.01359,4973,67.59549,7357
340,adamhl8,1,0.01359,4974,67.60908,7357
341,adrielp,1,0.01359,4975,67.62267,7357
342,aellwein,1,0.01359,4976,67.63626,7357
343,akanix42,1,0.01359,4977,67.64986,7357
344,akash07k,1,0.01359,4978,67.66345,7357
345,Akiiino,1,0.01359,4979,67.67704,7357
346,akshaypatidar1999,1,0.01359,4980,67.69063,7357
347,alee792,1,0.01359,4981,67.70423,7357
348,alexandr-x-ursul,1,0.01359,4982,67.71782,7357
349,AllenFang,1,0.01359,4983,67.73141,7357
350,alphacc,1,0.01359,4984,67.74500,7357
351,ameihm0912,1,0.01359,4985,67.75860,7357
352,andreas-bradahl,1,0.01359,4986,67.77219,7357
353,andreassiegel,1,0.01359,4987,67.78578,7357
354,andreaswachowski,1,0.01359,4988,67.79937,7357
355,andrew-demb,1,0.01359,4989,67.81297,7357
356,anibal-aguila,1,0.01359,4990,67.82656,7357
357,anutator,1,0.01359,4991,67.84015,7357
358,apiraino,1,0.01359,4992,67.85374,7357
359,arrrght,1,0.01359,4993,67.86734,7357
360,ashokpokharel977,1,0.01359,4994,67.88093,7357
361,atruskie,1,0.01359,4995,67.89452,7357
362,augustfengd,1,0.01359,4996,67.90811,7357
363,austinbutler,1,0.01359,4997,67.92171,7357
364,austinflowspace,1,0.01359,4998,67.93530,7357
365,awilson1801,1,0.01359,4999,67.94889,7357
366,azoom-y-ishii,1,0.01359,5000,67.96248,7357
367,badrow,1,0.01359,5001,67.97608,7357
368,barlik,1,0.01359,5002,67.98967,7357
369,bartmanus,1,0.01359,5003,68.00326,7357
370,beejei,1,0.01359,5004,68.01685,7357
371,bennythejudge,1,0.01359,5005,68.03045,7357
372,BlacCello,1,0.01359,5006,68.04404,7357
373,blinkeye,1,0.01359,5007,68.05763,7357
374,bobmhong,1,0.01359,5008,68.07122,7357
375,bonfire-dev,1,0.01359,5009,68.08482,7357
376,BrendanGalloway,1,0.01359,5010,68.09841,7357
377,brenwell,1,0.01359,5011,68.11200,7357
378,BrokenStandards,1,0.01359,5012,68.12559,7357
379,bugcy013,1,0.01359,5013,68.13919,7357
380,c33s,1,0.01359,5014,68.15278,7357
381,cbcoutinho,1,0.01359,5015,68.16637,7357
382,ccabsolute,1,0.01359,5016,68.17996,7357
383,cdobbyn,1,0.01359,5017,68.19356,7357
384,ChaturvediSulabh,1,0.01359,5018,68.20715,7357
385,ChenTsungYu,1,0.01359,5019,68.22074,7357
386,chncaption,1,0.01359,5020,68.23433,7357
387,Chocobo1,1,0.01359,5021,68.24793,7357
388,chrischildresssg,1,0.01359,5022,68.26152,7357
389,christhegrand,1,0.01359,5023,68.27511,7357
390,claudijd,1,0.01359,5024,68.28870,7357
391,codecatalysts,1,0.01359,5025,68.30230,7357
392,CodingAnarchy,1,0.01359,5026,68.31589,7357
393,colundrum,1,0.01359,5027,68.32948,7357
394,coretemp,1,0.01359,5028,68.34307,7357
395,corinz,1,0.01359,5029,68.35667,7357
396,cpdeethree,1,0.01359,5030,68.37026,7357
397,crazyzelot,1,0.01359,5031,68.38385,7357
398,Crysis73,1,0.01359,5032,68.39744,7357
399,cuotos,1,0.01359,5033,68.41104,7357
400,CuriousLearner,1,0.01359,5034,68.42463,7357
401,cyphermaster,1,0.01359,5035,68.43822,7357
402,D3vl0per,1,0.01359,5036,68.45181,7357
403,dali99,1,0.01359,5037,68.46541,7357
404,danielnazer,1,0.01359,5038,68.47900,7357
405,danielwoodz,1,0.01359,5039,68.49259,7357
406,danmanners,1,0.01359,5040,68.50618,7357
407,davidpinhas,1,0.01359,5041,68.51978,7357
408,dbartholomae,1,0.01359,5042,68.53337,7357
409,dcadolph,1,0.01359,5043,68.54696,7357
410,dekarl,1,0.01359,5044,68.56055,7357
411,deniojunior,1,0.01359,5045,68.57415,7357
412,denisaka1,1,0.01359,5046,68.58774,7357
413,dick9gag,1,0.01359,5047,68.60133,7357
414,diepes,1,0.01359,5048,68.61492,7357
415,DjHippieSon15,1,0.01359,5049,68.62852,7357
416,dkade,1,0.01359,5050,68.64211,7357
417,dlovitch,1,0.01359,5051,68.65570,7357
418,dmedvinsky,1,0.01359,5052,68.66929,7357
419,dmgk,1,0.01359,5053,68.68289,7357
420,dnicholas2001,1,0.01359,5054,68.69648,7357
421,dnoach,1,0.01359,5055,68.71007,7357
422,dol,1,0.01359,5056,68.72366,7357
423,dot-mike,1,0.01359,5057,68.73726,7357
424,drogus,1,0.01359,5058,68.75085,7357
425,dt-darren,1,0.01359,5059,68.76444,7357
426,duckie,1,0.01359,5060,68.77803,7357
427,duythinht,1,0.01359,5061,68.79163,7357
428,dvonessen,1,0.01359,5062,68.80522,7357
429,DYNXTSX,1,0.01359,5063,68.81881,7357
430,eamonnotoole,1,0.01359,5064,68.83240,7357
431,ebiscaia,1,0.01359,5065,68.84600,7357
432,EduardoFLima,1,0.01359,5066,68.85959,7357
433,eLRuLL,1,0.01359,5067,68.87318,7357
434,elvarondelacerveza,1,0.01359,5068,68.88677,7357
435,emmahsax,1,0.01359,5069,68.90037,7357
436,emoshaya,1,0.01359,5070,68.91396,7357
437,emper0r,1,0.01359,5071,68.92755,7357
438,emper0r-cu,1,0.01359,5072,68.94114,7357
439,en7h,1,0.01359,5073,68.95474,7357
440,Enva2712,1,0.01359,5074,68.96833,7357
441,eravindar12,1,0.01359,5075,68.98192,7357
442,erezhazan1,1,0.01359,5076,68.99551,7357
443,ericrini,1,0.01359,5077,69.00911,7357
444,ethierhager,1,0.01359,5078,69.02270,7357
445,EvertonSA,1,0.01359,5079,69.03629,7357
446,farant,1,0.01359,5080,69.04988,7357
447,fetahokey,1,0.01359,5081,69.06348,7357
448,filippobuletto,1,0.01359,5082,69.07707,7357
449,filip-zyzniewski,1,0.01359,5083,69.09066,7357
450,finalxcode,1,0.01359,5084,69.10425,7357
451,fischerscode,1,0.01359,5085,69.11785,7357
452,flx5,1,0.01359,5086,69.13144,7357
453,foray1010,1,0.01359,5087,69.14503,7357
454,fredericrous,1,0.01359,5088,69.15862,7357
455,FWest98,1,0.01359,5089,69.17222,7357
456,gabatwork,1,0.01359,5090,69.18581,7357
457,gasmick,1,0.01359,5091,69.19940,7357
458,gavriguy,1,0.01359,5092,69.21299,7357
459,gdrudy,1,0.01359,5093,69.22659,7357
460,giannisbetas,1,0.01359,5094,69.24018,7357
461,Gitlit1010,1,0.01359,5095,69.25377,7357
462,gitpaybot,1,0.01359,5096,69.26736,7357
463,gl-ahiggins,1,0.01359,5097,69.28096,7357
464,gnommer,1,0.01359,5098,69.29455,7357
465,golaneduard,1,0.01359,5099,69.30814,7357
466,growse,1,0.01359,5100,69.32173,7357
467,gwilton,1,0.01359,5101,69.33533,7357
468,gzm55,1,0.01359,5102,69.34892,7357
469,habnabit,1,0.01359,5103,69.36251,7357
470,hartfordfive,1,0.01359,5104,69.37610,7357
471,herzogf,1,0.01359,5105,69.38970,7357
472,hjoukl,1,0.01359,5106,69.40329,7357
473,holmesb,1,0.01359,5107,69.41688,7357
474,hoonetorg,1,0.01359,5108,69.43047,7357
475,hramberger,1,0.01359,5109,69.44407,7357
476,http403,1,0.01359,5110,69.45766,7357
477,HugoRh,1,0.01359,5111,69.47125,7357
478,iamd3vil,1,0.01359,5112,69.48484,7357
479,iamkalyanreddy,1,0.01359,5113,69.49844,7357
480,iilei,1,0.01359,5114,69.51203,7357
481,InAnimaTe,1,0.01359,5115,69.52562,7357
482,inletfetch,1,0.01359,5116,69.53921,7357
483,isaacsanders,1,0.01359,5117,69.55281,7357
484,isavl,1,0.01359,5118,69.56640,7357
485,JarleB,1,0.01359,5119,69.57999,7357
486,javierjulio,1,0.01359,5120,69.59358,7357
487,jay-bhambhani,1,0.01359,5121,69.60718,7357
488,j-bro,1,0.01359,5122,69.62077,7357
489,JCount,1,0.01359,5123,69.63436,7357
490,jdauphney,1,0.01359,5124,69.64795,7357
491,jecepeda,1,0.01359,5125,69.66155,7357
492,jesalves,1,0.01359,5126,69.67514,7357
493,jgmoss,1,0.01359,5127,69.68873,7357
494,jhelbling,1,0.01359,5128,69.70232,7357
495,jimmythedog,1,0.01359,5129,69.71592,7357
496,jinnko,1,0.01359,5130,69.72951,7357
497,jlongtine,1,0.01359,5131,69.74310,7357
498,jmklix,1,0.01359,5132,69.75669,7357
499,jmpolom,1,0.01359,5133,69.77029,7357
500,joerayme,1,0.01359,5134,69.78388,7357
501,JohannGelhorn,1,0.01359,5135,69.79747,7357
502,johngriffinbd,1,0.01359,5136,69.81106,7357
503,jpadilla,1,0.01359,5137,69.82466,7357
504,jrwhite17,1,0.01359,5138,69.83825,7357
505,jubel-han,1,0.01359,5139,69.85184,7357
506,julianguinard,1,0.01359,5140,69.86543,7357
507,karlroberts,1,0.01359,5141,69.87903,7357
508,karsten-wagner,1,0.01359,5142,69.89262,7357
509,kaustav-mondal,1,0.01359,5143,69.90621,7357
510,kennethredler,1,0.01359,5144,69.91980,7357
511,knfoo,1,0.01359,5145,69.93340,7357
512,knoppi,1,0.01359,5146,69.94699,7357
513,koki-sato,1,0.01359,5147,69.96058,7357
514,komlow,1,0.01359,5148,69.97417,7357
515,kosta,1,0.01359,5149,69.98777,7357
516,kowalczykp,1,0.01359,5150,70.00136,7357
517,kpocius,1,0.01359,5151,70.01495,7357
518,kraxx,1,0.01359,5152,70.02854,7357
519,kristaxox,1,0.01359,5153,70.04214,7357
520,krzema12,1,0.01359,5154,70.05573,7357
521,kyusu,1,0.01359,5155,70.06932,7357
522,l0nax,1,0.01359,5156,70.08291,7357
523,labaq,1,0.01359,5157,70.09651,7357
524,lakano,1,0.01359,5158,70.11010,7357
525,lastthyme,1,0.01359,5159,70.12369,7357
526,Legomaniac,1,0.01359,5160,70.13728,7357
527,lelandsindttouchnet,1,0.01359,5161,70.15088,7357
528,lewispeckover,1,0.01359,5162,70.16447,7357
529,llbbl,1,0.01359,5163,70.17806,7357
530,lmolas,1,0.01359,5164,70.19165,7357
531,LP0101,1,0.01359,5165,70.20525,7357
532,lucabello,1,0.01359,5166,70.21884,7357
533,lucasfcnunes,1,0.01359,5167,70.23243,7357
534,LucasVanHaaren,1,0.01359,5168,70.24602,7357
535,lucendio,1,0.01359,5169,70.25962,7357
536,m1racoli,1,0.01359,5170,70.27321,7357
537,MaltronCraft,1,0.01359,5171,70.28680,7357
538,marijus-ravickas,1,0.01359,5172,70.30039,7357
539,marumari,1,0.01359,5173,70.31399,7357
540,MasatoshiMizumoto,1,0.01359,5174,70.32758,7357
541,mathew-fleisch,1,0.01359,5175,70.34117,7357
542,mattgen88,1,0.01359,5176,70.35476,7357
543,mattgstevens,1,0.01359,5177,70.36836,7357
544,mattiaforc,1,0.01359,5178,70.38195,7357
545,mattparkes,1,0.01359,5179,70.39554,7357
546,matt-simons,1,0.01359,5180,70.40913,7357
547,maximrybalov,1,0.01359,5181,70.42273,7357
548,mazdack,1,0.01359,5182,70.43632,7357
549,mcoret,1,0.01359,5183,70.44991,7357
550,mdutton3,1,0.01359,5184,70.46350,7357
551,mgmorcos,1,0.01359,5185,70.47710,7357
552,michaeldelago,1,0.01359,5186,70.49069,7357
553,michaelsatish,1,0.01359,5187,70.50428,7357
554,mikeblakeuk,1,0.01359,5188,70.51787,7357
555,MikeSchlosser16,1,0.01359,5189,70.53147,7357
556,misak113,1,0.01359,5190,70.54506,7357
557,mistakenot,1,0.01359,5191,70.55865,7357
558,mkanna,1,0.01359,5192,70.57224,7357
559,mmalyska,1,0.01359,5193,70.58584,7357
560,Mozilla-GitHub-Standards,1,0.01359,5194,70.59943,7357
561,mrkschan,1,0.01359,5195,70.61302,7357
562,mshkrebtan,1,0.01359,5196,70.62661,7357
563,mszabo,1,0.01359,5197,70.64021,7357
564,mthbrown,1,0.01359,5198,70.65380,7357
565,mtoohey31,1,0.01359,5199,70.66739,7357
566,muhendees,1,0.01359,5200,70.68098,7357
567,mwasilew2,1,0.01359,5201,70.69458,7357
568,nakatsuchi,1,0.01359,5202,70.70817,7357
569,narroyog,1,0.01359,5203,70.72176,7357
570,neerajagarwalacko,1,0.01359,5204,70.73535,7357
571,nekonata,1,0.01359,5205,70.74895,7357
572,nelsonwellsredis,1,0.01359,5206,70.76254,7357
573,ni-binada,1,0.01359,5207,70.77613,7357
574,niksauer,1,0.01359,5208,70.78972,7357
575,Nils98Ar,1,0.01359,5209,70.80332,7357
576,nitrocode,1,0.01359,5210,70.81691,7357
577,Northburns,1,0.01359,5211,70.83050,7357
578,notriddle,1,0.01359,5212,70.84409,7357
579,oblogic7,1,0.01359,5213,70.85769,7357
580,OctavioCore,1,0.01359,5214,70.87128,7357
581,parkwart,1,0.01359,5215,70.88487,7357
582,parwejmetroag,1,0.01359,5216,70.89846,7357
583,patiln,1,0.01359,5217,70.91206,7357
584,pauln415,1,0.01359,5218,70.92565,7357
585,pcn,1,0.01359,5219,70.93924,7357
586,pefeigl,1,0.01359,5220,70.95283,7357
587,pelme,1,0.01359,5221,70.96643,7357
588,perry123456,1,0.01359,5222,70.98002,7357
589,PeterJCLaw,1,0.01359,5223,70.99361,7357
590,philicious,1,0.01359,5224,71.00720,7357
591,piotrminkina,1,0.01359,5225,71.02080,7357
592,piotrzarycki,1,0.01359,5226,71.03439,7357
593,pnguyen-okta,1,0.01359,5227,71.04798,7357
594,p-null,1,0.01359,5228,71.06157,7357
595,pogobanane,1,0.01359,5229,71.07517,7357
596,politician,1,0.01359,5230,71.08876,7357
597,portno12,1,0.01359,5231,71.10235,7357
598,pruiz,1,0.01359,5232,71.11594,7357
599,pshanoop,1,0.01359,5233,71.12954,7357
600,pythops,1,0.01359,5234,71.14313,7357
601,rafzei,1,0.01359,5235,71.15672,7357
602,raunyoliveira-hotmart,1,0.01359,5236,71.17031,7357
603,rbabyuk,1,0.01359,5237,71.18391,7357
604,rbrondgeest,1,0.01359,5238,71.19750,7357
605,rcleere,1,0.01359,5239,71.21109,7357
606,readall,1,0.01359,5240,71.22468,7357
607,renedupont,1,0.01359,5241,71.23828,7357
608,ricmatsui,1,0.01359,5242,71.25187,7357
609,rileyai-dev,1,0.01359,5243,71.26546,7357
610,rindeastwood,1,0.01359,5244,71.27905,7357
611,rkusler-intermedia,1,0.01359,5245,71.29265,7357
612,rnijveld,1,0.01359,5246,71.30624,7357
613,robertwe,1,0.01359,5247,71.31983,7357
614,robotblake,1,0.01359,5248,71.33342,7357
615,roger-rainey,1,0.01359,5249,71.34702,7357
616,roshan1988,1,0.01359,5250,71.36061,7357
617,rubber-ant,1,0.01359,5251,71.37420,7357
618,Rvanmech,1,0.01359,5252,71.38779,7357
619,ry1015,1,0.01359,5253,71.40139,7357
620,saadansari93,1,0.01359,5254,71.41498,7357
621,saimonn,1,0.01359,5255,71.42857,7357
622,samrees,1,0.01359,5256,71.44216,7357
623,sandip-j,1,0.01359,5257,71.45576,7357
624,sbaildon,1,0.01359,5258,71.46935,7357
625,schlichtanders,1,0.01359,5259,71.48294,7357
626,sdhibit,1,0.01359,5260,71.49653,7357
627,sdouche,1,0.01359,5261,71.51013,7357
628,sean-morris,1,0.01359,5262,71.52372,7357
629,sebastiangaiser,1,0.01359,5263,71.53731,7357
630,secret104278,1,0.01359,5264,71.55090,7357
631,sham126,1,0.01359,5265,71.56450,7357
632,sheab,1,0.01359,5266,71.57809,7357
633,shyukri,1,0.01359,5267,71.59168,7357
634,SiegfredRodriguez,1,0.01359,5268,71.60527,7357
635,silvpol,1,0.01359,5269,71.61887,7357
636,simonfxr,1,0.01359,5270,71.63246,7357
637,simon-michaud,1,0.01359,5271,71.64605,7357
638,SKalt,1,0.01359,5272,71.65964,7357
639,skrese,1,0.01359,5273,71.67324,7357
640,slukes,1,0.01359,5274,71.68683,7357
641,smnbbrv,1,0.01359,5275,71.70042,7357
642,smoyer64,1,0.01359,5276,71.71401,7357
643,soggycactus,1,0.01359,5277,71.72761,7357
644,ssetti,1,0.01359,5278,71.74120,7357
645,starkers,1,0.01359,5279,71.75479,7357
646,starkpl,1,0.01359,5280,71.76838,7357
647,stawii,1,0.01359,5281,71.78198,7357
648,stmps,1,0.01359,5282,71.79557,7357
649,stoned,1,0.01359,5283,71.80916,7357
650,strowk,1,0.01359,5284,71.82275,7357
651,sunib,1,0.01359,5285,71.83635,7357
652,sylvainmetayer,1,0.01359,5286,71.84994,7357
653,Tacsiazuma,1,0.01359,5287,71.86353,7357
654,tapanhalani,1,0.01359,5288,71.87712,7357
655,tcbtcb,1,0.01359,5289,71.89072,7357
656,teneon,1,0.01359,5290,71.90431,7357
657,teto,1,0.01359,5291,71.91790,7357
658,TheoGthr,1,0.01359,5292,71.93149,7357
659,thetoothpick,1,0.01359,5293,71.94509,7357
660,thewilli,1,0.01359,5294,71.95868,7357
661,TobiTh,1,0.01359,5295,71.97227,7357
662,todoryakimov,1,0.01359,5296,71.98586,7357
663,tomcoppensucll,1,0.01359,5297,71.99946,7357
664,tonybenchsci,1,0.01359,5298,72.01305,7357
665,toraritte,1,0.01359,5299,72.02664,7357
666,trjate,1,0.01359,5300,72.04023,7357
667,tschaible,1,0.01359,5301,72.05383,7357
668,tw1nk,1,0.01359,5302,72.06742,7357
669,udayruddarraju,1,0.01359,5303,72.08101,7357
670,urz9999,1,0.01359,5304,72.09460,7357
671,VanCoding,1,0.01359,5305,72.10820,7357
672,VanKosiara,1,0.01359,5306,72.12179,7357
673,veenarm,1,0.01359,5307,72.13538,7357
674,vinisman,1,0.01359,5308,72.14897,7357
675,vishalkuo,1,0.01359,5309,72.16257,7357
676,voidspooks,1,0.01359,5310,72.17616,7357
677,vsramalwan,1,0.01359,5311,72.18975,7357
678,whalehub,1,0.01359,5312,72.20334,7357
679,willjschmitt,1,0.01359,5313,72.21694,7357
680,withernet,1,0.01359,5314,72.23053,7357
681,wjl110,1,0.01359,5315,72.24412,7357
682,wokoman,1,0.01359,5316,72.25771,7357
683,WolfangAukang,1,0.01359,5317,72.27131,7357
684,xtrasolver,1,0.01359,5318,72.28490,7357
685,yanxke,1,0.01359,5319,72.29849,7357
686,yashkhandelwal123,1,0.01359,5320,72.31208,7357
687,yoadey,1,0.01359,5321,72.32568,7357
688,YoungJinJung,1,0.01359,5322,72.33927,7357
689,zstern,1,0.01359,5323,72.35286,7357
